Code,NumberOfHouseholds,HouseholdMedianIncome,HouseholdMeanIncome,NumberOfFamilies,FamilyMedianIncome,FamilyMeanIncome,NonFamilyHousehold,NonFamilyHouseholdMediumIncome,NonFamilyHouseholdMeanIncome
99929,988,58542,74917,644,67976,86215,344,36250,48894
99927,0,0,0,0,0,0,0,0,0
99926,440,58000,69587,348,70147,75490,92,32083,42926
99925,365,63125,77633,217,80139,90028,148,21500,46980
99923,12,0,0,0,0,0,12,0,0
99922,128,38750,53080,87,44250,57791,41,33250,36307
99921,827,54549,72102,470,67000,82343,357,44922,53762
99919,264,47059,56944,168,58000,70369,96,26429,32581
99918,115,53942,71667,63,40375,60629,52,0,85040
99903,1,0,0,0,0,0,1,0,0
99901,5299,74678,95227,3501,91797,109083,1798,42289,59888
99841,62,44250,64290,27,75781,98596,35,39107,37829
99840,411,71875,80986,196,87500,101818,215,48583,58826
99836,31,49688,55261,24,44643,54421,7,0,0
99835,3572,81708,93666,2214,93977,112078,1358,46702,57398
99833,1204,68667,85919,790,76731,103247,414,33472,50442
99832,47,100250,87921,22,108571,100173,25,0,77140
99830,171,56250,69646,120,58333,79716,51,34688,44255
99829,271,63250,80696,163,70781,92131,108,42813,58509
99827,946,62134,73692,545,84191,83810,401,39250,57533
99826,185,64792,80472,98,86111,98490,87,35938,53587
99825,16,0,133731,7,0,0,9,0,0
99824,1028,72632,87108,482,96538,104777,546,62292,65426
99820,145,42250,66739,108,46042,59007,37,22813,88346
99801,11850,89004,105707,7006,106800,124819,4844,63947,72531
99791,36,93750,90239,31,58750,71710,5,88125,80180
99790,12,0,112742,9,0,0,3,0,0
99789,109,67361,86952,96,67500,84330,13,0,62108
99788,40,0,37430,17,23750,22359,23,48583,48048
99786,80,34750,51436,59,45288,51964,21,18250,37114
99785,127,42813,50568,114,30694,43404,13,0,26315
99784,61,51875,49272,38,54000,57613,23,0,33691
99783,66,28571,40450,48,28571,35969,18,20000,21517
99782,126,69167,73278,88,81667,86256,38,0,30055
99781,39,50938,48385,28,55833,56032,11,8125,20364
99780,675,52250,73453,470,63438,84974,205,23906,41905
99778,75,28958,36689,64,29643,37367,11,5417,5855
99777,67,37188,66400,38,75000,88834,29,15625,28069
99776,30,53750,61073,22,70833,75555,8,22500,21150
99775,113,45386,41632,47,0,0,66,46455,48530
99774,4,26250,22000,2,0,0,2,0,0
99773,40,60000,73068,33,49583,68464,7,28750,25857
99772,138,51111,60308,112,45833,52541,26,46250,45627
99771,76,60417,69468,67,61458,72503,9,0,19956
99770,155,33438,41066,125,37875,42952,30,6250,9987
99769,172,48000,56570,150,47813,54911,22,0,42309
99768,65,32188,47531,34,53750,58394,31,23750,34410
99767,17,51875,58935,10,0,60210,7,34375,30386
99766,165,59375,77131,136,61000,78389,29,20750,37072
99765,86,48077,54735,71,45250,54085,15,29063,38100
99764,85,64750,75378,66,115577,86314,19,0,32974
99763,96,65000,69005,81,67083,74989,15,15625,25567
99762,1419,84391,102943,932,96667,109716,487,57279,65382
99761,90,55000,70957,79,54688,70243,11,19375,60736
99760,224,55500,67050,143,73594,84785,81,21528,33304
99759,45,60250,77364,35,61094,80100,10,28333,33340
99758,51,0,55516,30,48750,64133,21,0,26548
99757,18,0,59111,7,58125,42257,11,0,69836
99756,22,0,102018,13,118125,92862,9,0,115244
99755,108,75938,71609,21,101875,116914,87,53295,60674
99754,36,18889,32722,9,0,66878,27,17917,19770
99753,82,29167,39737,63,22708,37495,19,18250,17837
99752,922,87000,104297,590,94167,108147,332,76250,90898
99751,32,38125,44513,23,55625,50565,9,26875,27744
99750,137,55938,69440,115,53542,70205,22,17500,35718
99749,78,54375,73224,70,53333,68344,8,0,27363
99748,71,28750,48111,41,56250,66639,30,18182,19913
99747,61,75625,93177,50,66667,76014,11,59375,106700
99746,84,40000,45732,57,37917,46060,27,27813,31893
99745,29,23125,25572,18,28750,31594,11,6250,9645
99744,61,103125,99367,27,119375,120296,34,74375,82176
99743,421,92969,101822,243,122708,135939,178,47500,54213
99742,126,45714,54507,100,46458,59434,26,0,14642
99741,192,76111,97988,135,82321,113028,57,55625,53867
99740,200,40833,55236,99,72083,73026,101,26042,35430
99739,55,58125,52358,47,41250,49806,8,0,20863
99738,75,41250,56997,21,0,94167,54,28500,42543
99737,1490,73456,81608,939,87072,94732,551,32228,55363
99736,36,40000,46558,27,48125,53896,9,15625,17378
99734,0,0,0,0,0,0,0,0,0
99733,17,27188,33071,6,0,18733,11,25625,30900
99732,9,0,0,9,0,0,0,0,0
99730,32,16094,18863,5,60938,53340,27,15703,12478
99729,114,30500,47996,31,85625,73942,83,21654,38145
99727,129,49063,74223,111,53750,80354,18,24167,29672
99726,16,77500,76644,2,0,0,14,0,76479
99724,47,27083,30345,13,42917,38831,34,15833,21312
99723,1360,87870,97428,958,92721,105658,402,54213,55926
99722,70,27500,34014,50,16765,30830,20,0,32425
99721,61,79063,83021,49,79583,79149,12,0,48783
99720,58,24375,39690,42,35000,46876,16,10000,14750
99714,466,63786,76659,330,63448,77693,136,65417,71659
99712,5413,89688,112780,3765,110893,131505,1648,56250,64833
99709,11969,77756,100803,7182,93958,117994,4787,55989,69731
99706,3,0,22733,1,0,0,2,0,0
99705,8350,85739,111632,5842,98676,121861,2508,58608,80545
99704,0,0,0,0,0,0,0,0,0
99703,1964,56792,72209,1954,56026,70940,10,0,0
99702,1011,71655,81929,789,70268,85872,222,62000,64469
99701,6903,64153,81161,3952,79828,92521,2951,42161,63219
99695,0,0,0,0,0,0,0,0,0
99694,525,53942,73527,328,69479,94600,197,26250,36558
99693,96,59167,68342,52,62500,76575,44,51250,55116
99692,62,71250,89669,38,56667,85463,24,90000,96329
99691,57,32083,43949,27,0,67441,30,0,19390
99690,30,48333,45697,26,48333,51119,4,0,0
99689,221,59517,72258,144,58571,72189,77,53375,57312
99688,1054,47500,64600,659,63625,76233,395,32928,43913
99686,1523,93237,94048,968,98415,103060,555,45893,73321
99685,1045,91652,110757,624,100000,114937,421,81845,100923
99684,158,83750,81035,129,91250,88332,29,20750,30272
99683,172,46818,70172,82,85313,93915,90,31000,46696
99682,131,38125,61029,72,49167,75732,59,36042,35029
99681,63,33125,47054,60,32917,46608,3,0,0
99680,122,39250,46489,98,39444,46145,24,25000,36358
99679,61,0,46651,45,0,47509,16,0,31450
99678,260,43750,55021,212,45357,56099,48,21500,39873
99677,11,64375,66409,9,53750,57056,2,0,0
99676,557,68450,75172,322,80227,89317,235,28843,45902
99674,532,47625,63422,277,69583,79016,255,33068,45884
99672,1305,72372,94229,820,108194,125440,485,27708,40731
99671,155,50625,53174,129,46875,49857,26,0,58631
99670,17,45417,69841,7,0,96700,10,38750,44960
99669,6345,80888,106461,4363,95901,124460,1982,46316,62200
99668,25,53750,64900,17,31250,39671,8,119000,108625
99667,44,0,88705,24,0,74600,20,0,105625
99666,28,31667,31043,26,26875,27565,2,0,0
99665,18,0,27372,7,0,54514,11,0,7345
99664,1485,71875,79453,862,103633,101453,623,37182,44709
99663,153,75417,83212,99,82813,102452,54,34000,44885
99662,96,35625,43833,83,33125,45237,13,20250,21462
99661,422,85833,99423,311,111250,108801,111,42917,52858
99660,104,67500,74523,53,68750,66449,51,59583,78467
99659,67,42813,52934,62,40833,50518,5,11563,13300
99658,197,42083,53297,140,36389,52188,57,26563,30442
99657,25,0,45088,25,0,44988,0,0,0
99656,6,90833,84267,2,0,0,4,0,0
99655,186,34667,48954,145,46563,56552,41,15625,14868
99654,19203,80092,97021,13894,94568,109940,5309,40938,57357
99653,31,89688,103587,23,96875,119561,8,0,45625
99652,1151,53168,68339,738,75750,83654,413,30083,39178
99651,4,0,51275,2,0,0,2,0,0
99650,93,25750,49976,88,26000,41199,5,0,0
99649,30,45000,64540,17,73750,75406,13,42917,47085
99648,19,28750,36958,13,24063,33177,6,36250,43000
99647,12,53125,48392,4,63750,61475,8,48750,41850
99645,8726,80526,99861,6357,95988,111458,2369,41086,58415
99644,62,29167,51287,36,39167,66797,26,16250,19335
99643,90,35313,43174,57,26250,46282,33,16250,26491
99641,143,38705,52114,123,39420,57635,20,6667,9720
99640,51,56042,62698,33,44583,50991,18,61250,80289
99639,490,51765,69235,349,64219,84474,141,19250,28843
99638,6,35000,46683,3,41250,61167,3,0,0
99637,172,42500,55976,149,42875,59819,23,13194,21017
99636,148,42857,51880,122,46250,56601,26,20000,22758
99634,196,28929,33172,158,34167,34132,38,18750,27255
99633,133,69583,91162,74,87500,102715,59,57083,75473
99632,236,31339,43692,191,32396,45179,45,28125,23780
99631,86,79063,89084,52,0,91796,34,0,0
99630,92,28750,43988,61,48438,57487,31,16635,16806
99628,158,42143,54285,138,43750,53991,20,25000,27035
99627,112,47500,57262,71,55313,61370,41,36719,38222
99626,65,33250,43931,56,34500,44309,9,26875,34433
99625,26,22917,33046,14,24167,41529,12,0,23150
99624,21,84583,70305,5,0,0,16,0,59794
99622,82,55000,58560,77,54583,58053,5,0,60580
99621,99,43250,50981,82,48750,56585,17,0,16806
99620,245,47844,46484,209,48219,45447,36,15000,35986
99615,3990,84104,93675,2766,96118,98768,1224,56970,74026
99614,96,36563,39739,79,40781,45659,17,0,11782
99613,154,88750,100442,114,92500,106672,40,56250,75858
99612,335,71875,75635,167,79583,79366,168,52258,64497
99611,5360,64157,84095,3239,89967,97022,2121,37074,59561
99610,774,73125,82002,444,85750,104860,330,40950,51057
99609,72,38750,46217,59,42188,50142,13,8125,11554
99607,55,41250,53698,43,58750,61188,12,13750,15000
99606,99,42321,58344,76,41667,59418,23,17188,35791
99605,62,0,89274,16,119583,104013,46,0,84148
99604,146,30938,42876,133,30469,38579,13,0,64469
99603,4243,66150,83219,2591,84184,98487,1652,48198,55565
99602,90,25833,39709,49,44792,52396,41,16250,17824
99591,29,64583,66807,15,88750,83427,14,45000,46621
99590,66,30000,37470,35,48750,49026,31,11458,18765
99589,33,0,59924,30,46250,65570,3,0,0
99588,463,76250,91725,316,101563,104017,147,58490,63538
99587,894,98026,119128,427,141645,152558,467,69663,76586
99586,151,51458,65781,75,97656,99220,76,14712,32222
99585,41,22188,32634,31,0,29687,10,30000,28440
99583,35,50417,58866,10,61500,74260,25,38125,48244
99581,275,43533,53418,202,40147,53984,73,48344,43162
99580,26,32917,40181,17,34375,48629,9,22083,24222
99579,7,93750,94943,4,0,0,3,0,0
99578,119,46875,61194,108,48750,64067,11,0,30145
99577,9649,111388,126943,7117,122186,142248,2532,67188,76609
99576,776,72857,84828,537,76250,87302,239,53750,62723
99575,20,0,30195,11,0,27609,9,0,33356
99574,680,90577,108484,548,110227,118153,132,53333,57386
99573,341,63601,97540,246,89500,123397,95,0,30585
99572,85,61875,70340,68,60357,62162,17,0,0
99571,127,104861,91301,62,80833,77535,65,120694,102406
99569,14,18000,23386,5,0,22300,9,15625,18311
99568,161,44750,73270,65,69583,105545,96,43393,50867
99567,3062,110625,125905,2667,120953,131223,395,55602,89777
99566,28,0,56857,14,0,30807,14,0,71057
99565,13,45625,51354,12,43750,50283,1,0,0
99564,16,58750,62800,12,70500,63983,4,42500,50850
99563,140,41667,48493,102,40833,50810,38,0,31503
99561,75,44375,55029,69,45625,56646,6,21250,19700
99559,2322,80698,92720,1571,80742,94618,751,61921,80950
99558,33,46875,50900,19,55625,69479,14,15000,19300
99557,196,56667,81185,147,58250,87444,49,39583,52908
99556,1101,54152,70553,651,73472,88453,450,33627,43256
99555,48,44167,67098,32,51250,69141,16,30625,49531
99554,228,36071,51892,218,35278,47662,10,23750,30740
99553,69,34583,48364,43,36750,57721,26,22500,30935
99552,57,54375,59098,55,54063,57562,2,0,0
99551,106,38750,46329,83,52750,51617,23,4792,10004
99550,68,43750,63204,36,76250,83603,32,34643,40256
99549,22,46250,54955,16,57500,62550,6,20000,31850
99548,20,33333,42315,14,33750,48036,6,26250,27883
99547,9,0,101656,8,0,93800,1,0,0
99546,51,51250,72118,19,63750,76816,32,48750,60406
99540,157,80938,106657,83,156094,151998,74,53667,55803
99519,0,0,0,0,0,0,0,0,0
99518,4172,84045,94295,2369,87417,106317,1803,63378,73882
99517,6892,82619,111971,3866,101591,131065,3026,55395,82685
99516,7117,148108,191131,5602,158955,205106,1515,91917,117927
99515,7624,106755,124110,5397,111288,131463,2227,69427,91008
99513,0,0,0,0,0,0,0,0,0
99510,0,0,0,0,0,0,0,0,0
99508,12815,65430,80703,7732,73171,88692,5083,51678,61314
99507,13485,88485,115895,9166,104351,130234,4319,64023,78815
99506,2133,50685,61437,1647,61656,67956,486,35417,39323
99505,1023,70757,83605,971,71283,85090,52,0,53194
99504,15522,75956,91364,10230,89247,101983,5292,56913,63559
99503,6167,63338,73025,2999,76026,85128,3168,50318,58358
99502,8994,94355,118867,6350,109400,134240,2644,62462,77261
99501,7256,61509,87836,2940,89494,117534,4316,46806,65106
99403,8534,53663,72773,5217,66321,88130,3317,36624,44809
99402,659,54250,84317,446,68750,96065,213,24464,54869
99401,120,68672,79551,55,0,0,65,59875,54731
99371,133,56607,61780,91,61250,67922,42,40833,48469
99363,69,0,31428,51,19271,25647,18,44375,47806
99362,15734,60413,78762,9901,75091,97625,5833,34076,43440
99361,733,68125,86408,518,76250,97821,215,43523,53084
99360,536,81029,108529,429,86080,100360,107,36534,140373
99359,91,43438,62103,60,0,83643,31,16607,20413
99357,1144,53654,67551,1059,46635,65732,85,25694,40664
99356,61,61042,67410,31,62292,70348,30,0,51173
99354,9354,71546,87239,5778,85500,98495,3576,53992,64698
99353,5173,105115,120145,4008,115933,132982,1165,59759,70823
99352,12814,81471,110006,8332,108114,130000,4482,54545,64839
99350,4941,59536,75945,3720,62241,82822,1221,35956,40261
99349,2642,60500,71529,2276,61557,71078,366,26954,54895
99348,479,64243,88958,419,65972,92178,60,36250,35497
99347,1009,56298,62956,697,67566,72950,312,30893,40212
99346,199,63229,53861,120,68750,64856,79,0,34457
99345,80,92500,85340,56,110000,106652,24,25000,27896
99344,5093,53328,69622,4261,56190,72746,832,33846,40424
99343,763,55828,77653,635,56537,80387,128,45846,50859
99341,271,58482,58850,170,58393,64912,101,0,41729
99338,6027,117286,147956,4992,129667,163309,1035,50995,68341
99337,11094,77854,92417,8621,84781,99169,2473,49551,59551
99336,19569,52158,66250,12146,61292,75409,7423,32110,46528
99335,72,51250,61872,50,52083,62974,22,0,52905
99333,25,80804,76368,17,81518,105047,8,0,0
99330,274,65735,70208,236,70972,73136,38,0,0
99329,42,0,49067,29,0,50390,13,43750,46115
99328,1629,65260,90330,1076,91791,117241,553,22337,36093
99326,1520,72959,69936,1230,74464,73869,290,33077,51450
99324,3865,52403,74311,2434,81453,91581,1431,36512,44381
99323,1356,69828,86754,1048,89750,96069,308,37262,49641
99322,226,0,93626,102,72500,92340,124,19066,94683
99321,67,0,0,67,0,0,0,0,0
99320,3511,64547,76319,2455,74894,83320,1056,46474,53665
99301,24402,66678,86197,18800,74485,93218,5602,37451,49800
99224,9314,66936,94741,6002,91484,116659,3312,37452,52296
99223,13950,75933,106385,8825,99954,135527,5125,39153,52676
99218,6490,53125,78905,3711,77976,100584,2779,30604,48042
99217,7111,62906,80628,4618,73067,97112,2493,40282,46057
99216,11013,50586,64639,6439,63783,75187,4574,33036,44794
99212,8786,59643,75877,5268,76936,91315,3518,34886,50706
99208,22139,65647,84713,14866,82478,100911,7273,34415,46366
99207,12623,42913,51883,6565,47300,56721,6058,35846,41592
99206,16205,61615,77040,10777,74146,87884,5428,34668,49105
99205,17926,56467,67105,11184,65574,76501,6742,37745,45296
99204,3716,41678,57309,1441,54426,68387,2275,35910,49429
99203,9183,78655,110984,5980,101351,136671,3203,41645,60755
99202,7852,47102,59135,3952,56277,68384,3900,33021,46397
99201,7360,27398,50463,2036,56739,74346,5324,20116,40195
99185,526,71477,81269,418,83286,92536,108,20833,31623
99181,801,52802,64769,516,60750,73434,285,35417,47939
99180,433,47583,71623,329,53229,83833,104,30000,28920
99179,170,71375,109584,118,95000,138214,52,29853,42612
99176,71,44821,81587,49,65417,97704,22,37292,45695
99174,21,0,62110,15,86875,79360,6,18750,18983
99173,608,43627,48883,417,44141,50415,191,41319,44958
99171,443,57917,63389,297,68750,73973,146,33571,40092
99170,402,54063,67772,259,71250,74011,143,36875,56403
99169,1157,52827,63709,639,68661,76935,518,27763,43926
99167,322,56818,72627,257,58342,82719,65,21336,32091
99166,1300,43730,67777,784,61316,86150,516,18068,37577
99164,0,0,0,0,0,0,0,0,0
99163,12864,33977,59197,5014,75386,97071,7850,20511,33350
99161,603,76625,85815,388,108426,103031,215,37417,53443
99160,71,22639,29454,31,45417,39874,40,0,21378
99159,654,53242,62971,384,57500,73856,270,32404,45140
99158,220,58846,76552,174,69583,86794,46,29318,37448
99157,301,36131,45554,143,59875,65370,158,26364,27618
99156,3694,59333,70745,2683,71109,79387,1011,29659,42122
99155,467,30956,54329,336,41111,58409,131,19148,32298
99154,11,104375,116555,9,165417,139456,2,0,0
99153,251,37098,57206,92,98750,94448,159,27452,35508
99152,55,57188,72031,27,57188,64859,28,53750,76329
99151,83,41058,38695,66,41731,40073,17,0,29812
99150,141,36125,48758,113,36625,54651,28,0,24975
99149,85,37917,45878,59,39792,47527,26,0,42135
99148,947,60195,84955,642,72857,99779,305,26047,51337
99147,87,70208,86292,61,100179,97754,26,65000,59400
99146,22,17292,28827,4,0,0,18,0,0
99144,9,34583,43611,7,0,0,2,0,0
99143,333,33229,51770,230,36250,58209,103,30625,35899
99141,2471,54957,70661,1528,78690,92082,943,23169,32279
99140,214,33958,51806,113,63352,70677,101,27829,30057
99139,561,65673,86531,410,89800,94484,151,37361,52158
99138,409,39107,55014,252,50625,66812,157,21250,30281
99137,178,36250,49487,124,46250,53850,54,31875,39469
99136,12,32500,35342,3,0,0,9,37750,30767
99135,166,60000,61276,106,63125,64822,60,0,53560
99134,260,35333,51850,162,0,64603,98,28500,30768
99133,803,41319,56809,418,56944,79749,385,18580,30005
99131,117,60179,71678,64,82500,99198,53,31573,38445
99130,342,59444,60379,236,72727,71701,106,22708,32308
99129,283,37019,46014,181,48875,48634,102,15833,37901
99128,164,0,94284,117,103875,123449,47,20250,21681
99126,288,62672,55365,205,34564,47030,83,55917,55348
99125,247,44875,57576,164,47333,65402,83,26250,41552
99124,138,46875,58485,79,54271,62461,59,43646,46869
99123,423,54493,65042,292,66667,67504,131,39861,50096
99122,1722,58482,71660,1259,61769,81875,463,32806,40649
99121,112,0,87556,92,0,102088,20,0,20715
99119,556,54565,75806,411,77875,87298,145,29107,34445
99118,363,46563,54078,200,75833,72528,163,21328,30737
99117,230,77643,81859,163,79148,95344,67,37083,44488
99116,775,58819,73573,425,72589,83088,350,48056,59458
99115,506,54722,56698,372,60086,66492,134,25938,27696
99114,5050,51875,68783,3316,68194,84641,1734,25893,34822
99113,264,62308,69427,192,73409,80179,72,38125,40757
99111,1656,55696,70722,956,76818,83928,700,33587,51757
99110,617,55341,67055,475,64973,81106,142,0,13818
99109,2075,50953,67124,1404,67083,80149,671,28708,36226
99105,21,0,51300,11,54375,67455,10,21250,33520
99103,194,80357,88543,142,94167,102243,52,41250,48119
99102,220,73800,73303,112,88571,90475,108,48750,53003
99101,586,58125,81463,386,66250,87451,200,23250,69908
99040,369,34076,49016,208,43250,63629,161,23750,28690
99039,58,55769,61353,42,0,70610,16,33750,35931
99037,5703,67189,90116,3853,90028,107519,1850,41941,48695
99036,709,123664,126624,525,136304,153462,184,47361,50051
99034,72,0,0,13,0,0,59,0,0
99033,355,60368,69408,235,62426,68855,120,37273,66913
99032,313,61484,74951,227,65365,84824,86,32292,41187
99031,503,75653,87337,357,88750,103981,146,41500,46511
99030,409,66375,85410,229,90938,119530,180,35139,41738
99029,494,77500,78112,334,96638,100975,160,35714,30385
99027,2350,63750,91190,1796,74914,105293,554,36000,40737
99026,3241,81701,93457,2515,91175,101363,726,39400,51633
99025,2075,73021,87781,1640,84583,95579,435,46033,55017
99023,199,119107,188933,168,106591,166386,31,164018,311129
99022,3230,76775,80382,2473,86442,89949,757,25885,42506
99021,3441,72160,91986,2662,86477,108156,779,28688,32720
99020,0,0,0,0,0,0,0,0,0
99019,4344,98453,136403,3335,106050,144669,1009,56135,98279
99018,116,50000,53424,71,47321,52097,45,0,54404
99017,61,33750,35015,48,0,32585,13,46250,43985
99016,6549,70635,92482,4335,98051,112114,2214,37500,49564
99013,646,47500,53317,453,57625,59698,193,0,31758
99012,308,59375,77088,229,76375,82407,79,46042,56672
99011,826,60133,63756,800,60479,64727,26,26250,31362
99009,1816,60469,69616,1277,50727,63869,539,42586,49753
99008,191,45208,101223,120,45417,130625,71,0,48931
99006,5063,59400,72853,3515,67334,86084,1548,29962,40028
99005,3290,103420,116173,2873,103930,119696,417,53036,82097
99004,8007,58343,77274,4808,83929,99416,3199,28940,36556
99003,1670,62477,87181,1360,74219,96456,310,36328,41399
99001,1623,54489,62373,1049,57179,65825,574,43261,49370
98953,2211,70689,76772,1517,77292,89705,694,35205,40650
98952,569,47837,55489,473,43036,52619,96,39583,34863
98951,3637,49238,70713,3037,51619,73906,600,22039,33777
98950,9,0,0,0,0,0,9,0,0
98948,3484,53108,59330,2792,56216,62225,692,27292,36095
98947,894,51776,60609,733,49964,62507,161,29375,41894
98946,210,59000,107824,143,115670,118202,67,41125,85675
98944,6751,48041,62062,5245,55895,64838,1506,24161,40274
98943,455,47697,61989,237,61458,69522,218,28790,49993
98942,6936,70660,88152,4950,84411,93877,1986,41218,48032
98941,297,54917,60594,167,67917,77001,130,0,39519
98940,192,0,177552,101,0,0,91,0,0
98939,28,33750,0,28,33750,0,0,0,0
98938,523,60199,79017,497,60710,77855,26,23269,50192
98937,1760,67170,74935,1244,75761,83473,516,40098,51194
98936,1996,78920,89514,1833,78781,89538,163,51607,54424
98935,1102,50956,60067,1010,47589,58696,92,23750,45111
98934,416,51364,65469,250,54444,64255,166,38750,66467
98933,354,63194,81734,281,63558,81568,73,42188,64266
98932,1395,59208,99654,1206,61250,104750,189,28393,45193
98930,4627,52145,63672,3761,51985,63736,866,34750,38497
98929,0,0,0,0,0,0,0,0,0
98926,13851,59415,75795,7468,84440,99680,6383,32461,46409
98925,263,57031,104914,164,116250,135287,99,48750,54599
98923,501,40888,48322,218,64375,66386,283,40691,34407
98922,3242,61071,82658,2059,87614,96615,1183,35302,54492
98921,78,0,0,78,0,0,0,0,0
98908,14444,67016,86599,9799,76832,97941,4645,43230,59642
98903,5711,56754,72665,3976,67807,83758,1735,35969,42801
98902,16484,47283,61669,10374,58358,68869,6110,32485,45072
98901,10648,45062,63586,7613,50124,73028,3035,24181,34682
98862,1264,59349,81201,804,83548,103658,460,34278,41210
98860,105,29583,48171,61,42083,41128,44,18750,36455
98859,60,85500,76452,54,86000,83824,6,0,0
98858,802,62645,72865,532,76500,88567,270,37841,38169
98857,1195,42591,59218,892,51080,67924,303,20871,28790
98856,1141,50625,75287,870,60761,83106,271,24267,42807
98855,2616,38933,50336,1554,56262,66077,1062,21990,26505
98853,7,0,0,7,0,0,0,0,0
98852,7,0,0,7,0,0,0,0,0
98851,1781,47643,62724,1068,60769,69214,713,26509,48727
98850,587,52094,56385,412,57237,63383,175,33053,33862
98849,559,44632,49178,409,50335,54964,150,19554,30979
98848,3439,64893,77930,2838,71636,82835,601,32569,50076
98847,698,52442,71557,522,76484,84828,176,21422,29718
98846,464,66622,82309,352,75192,95225,112,26964,40083
98845,101,46875,58264,86,51071,64656,15,23542,21627
98844,2062,43306,51067,1299,52574,61018,763,26433,33527
98843,807,56168,77485,581,64375,93600,226,25833,32840
98841,3879,48829,62942,2822,50168,67172,1057,20859,34691
98840,1902,50788,59791,1273,55341,66166,629,29618,41479
98837,15238,60793,75311,10267,73104,85067,4971,38447,48252
98836,315,40653,59597,315,40653,59597,0,0,0
98834,86,61111,141817,82,61667,145895,4,0,0
98833,68,69615,68688,68,69615,67584,0,0,0
98832,87,50625,65025,79,51875,68015,8,0,35488
98831,1334,52070,69228,879,56827,78428,455,33589,49785
98830,259,51771,57654,147,59107,66839,112,31136,43545
98829,135,36607,46713,119,41719,47630,16,0,0
98828,777,69362,81403,562,82778,93262,215,39306,50402
98827,184,65110,54224,96,39688,48913,88,66066,60019
98826,3273,61470,82822,2224,83700,99918,1049,34338,43595
98824,142,40313,56762,134,39167,56646,8,0,0
98823,4027,70472,83081,2973,80102,91440,1054,40663,46824
98822,744,47000,66732,476,67273,82265,268,23466,33800
98821,332,112318,133578,332,0,111859,0,0,0
98819,140,28333,40631,74,0,45845,66,26250,33797
98817,88,71279,67372,88,71279,67372,0,0,0
98816,2295,56582,78175,1456,66890,89563,839,40977,57592
98815,2709,61672,81695,1872,73152,94816,837,43059,49243
98814,400,53298,56890,253,54539,52348,147,42361,64707
98813,898,48500,53178,747,46595,52265,151,43194,47121
98812,1771,47717,50029,1264,50461,53488,507,31370,37330
98811,59,89609,93580,27,104276,109467,32,0,0
98802,11530,71093,100063,8565,80578,103715,2965,44478,76466
98801,16754,62595,83854,10906,73209,97898,5848,36519,52587
98686,7393,86543,101021,5323,101181,115025,2070,48793,60616
98685,11502,106059,126213,8394,114979,143058,3108,49082,77542
98684,11566,71667,88526,8033,80236,94319,3533,54679,68035
98683,13361,71835,94251,8130,87780,106449,5231,56330,70510
98682,22017,76299,92051,16017,86293,100713,6000,45993,58799
98675,2127,78047,108464,1782,85179,112882,345,40524,73194
98674,5052,75487,91880,3711,82231,103503,1341,37962,48224
98673,227,31250,45242,126,42857,56415,101,0,29162
98672,2893,68594,94219,1934,80321,105838,959,41595,69060
98671,8423,91505,116115,6246,100347,128098,2177,59029,76063
98670,19,25417,39505,12,0,50917,7,13750,19943
98665,10566,69524,85956,7231,74116,93996,3335,47380,62561
98664,9174,67007,86493,5996,71286,93258,3178,51667,67877
98663,6304,62835,78295,3590,71708,90581,2714,43533,59029
98662,12479,71059,84052,7973,79375,94641,4506,47199,57717
98661,19463,59466,81396,11488,68110,91650,7975,44600,60015
98660,5492,50407,76699,2384,81366,107421,3108,34829,52647
98651,455,107188,127426,335,126902,154876,120,0,49867
98650,482,61964,78860,331,68365,87474,151,47120,59824
98649,315,54087,69473,224,71154,84566,91,16125,29132
98648,1275,63750,75991,843,80972,86812,432,33030,54272
98647,162,0,31720,128,0,37882,34,0,0
98645,679,79821,87842,531,96169,102561,148,29500,35033
98644,278,24821,42985,142,0,67015,136,13468,17895
98643,139,86458,84790,103,79583,94442,36,0,45392
98642,7419,97288,117979,5698,108558,133635,1721,55527,62866
98641,10,0,0,10,0,0,0,0,0
98640,2372,49600,60813,1498,67083,76615,874,23715,33339
98639,370,73145,79664,210,87727,85569,160,72661,70534
98638,607,49929,68821,435,73490,80307,172,33750,39773
98635,715,50134,64477,425,71125,80597,290,41919,40809
98632,20842,51188,70972,12681,70377,87224,8161,27797,40721
98631,1543,46186,54011,749,54536,66695,794,29500,40674
98629,2879,100275,115884,2500,103542,122332,379,47841,61071
98628,127,35125,48643,81,0,59910,46,29167,28804
98626,9991,59058,73049,7006,67464,83820,2985,32270,41903
98625,2736,92770,107179,1896,103409,125926,840,33750,58362
98624,682,51786,76935,491,67950,86453,191,21397,28936
98621,151,61979,83819,97,68750,74680,54,51184,100233
98620,3299,48522,61525,1840,63125,67592,1459,31736,52026
98619,264,48889,67815,201,51250,72758,63,45083,48154
98617,505,57772,74203,228,61000,70138,277,55759,63179
98616,45,64250,70842,44,64500,71691,1,0,0
98614,112,40323,40638,0,0,0,112,40323,40638
98613,154,68500,80553,108,81000,91780,46,45625,50276
98612,1332,56250,71792,956,66714,82133,376,31500,42696
98611,3211,64829,76062,2380,67036,81805,831,36997,49504
98610,1245,58574,67811,972,64048,71899,273,20191,41397
98607,11186,109621,136847,9042,125392,151314,2144,44853,68557
98606,3338,105417,124404,2549,114006,133716,789,67898,87418
98605,472,71458,74311,309,85096,88235,163,42589,47575
98604,12728,86980,102913,10300,93660,107547,2428,49000,71699
98603,451,61875,64984,291,73365,72134,160,53500,50740
98602,76,36250,38493,64,36369,37588,12,0,0
98601,1098,85000,86005,885,89205,93526,213,0,41365
98597,9052,73664,82174,6481,82317,90713,2571,42586,52567
98596,2628,64896,103462,1994,70565,115814,634,34888,50751
98595,1172,53750,65509,757,75931,75853,415,28542,42157
98593,413,46850,57387,348,47206,60759,65,21875,26726
98592,731,68371,71186,555,69238,79134,176,56000,46124
98591,1476,64919,77594,1031,75707,91268,445,34196,41004
98590,244,90898,87894,206,91117,97132,38,22500,27371
98589,2681,70040,82468,1809,83966,94978,872,34286,53236
98588,784,60781,83282,493,87530,101385,291,23384,52612
98587,269,39821,54113,198,58750,61385,71,13942,25304
98586,725,45446,53606,454,61786,67350,271,23295,30063
98585,347,53125,59733,143,92969,103529,204,23818,29033
98584,13761,60388,73690,8977,71919,82451,4784,39580,52010
98583,43,41964,52737,31,40536,54619,12,46429,47875
98582,50,0,70320,21,106042,115924,29,0,37297
98581,268,29960,36821,139,47150,50728,129,19632,21836
98580,4474,80864,101098,3311,85725,113511,1163,43661,54353
98579,4988,77108,81662,3372,81740,88732,1616,43627,61831
98577,2753,59603,69800,1880,70366,79721,873,31313,45118
98576,1947,69033,79671,1323,88640,94318,624,24310,40469
98575,55,63958,60142,42,70278,69736,13,33594,29154
98572,343,63523,66699,230,70303,73179,113,50104,49905
98571,95,0,0,28,0,0,67,0,0
98570,1531,65161,74407,1261,67346,79526,270,33421,39726
98569,3413,47399,55776,2094,56510,65421,1319,28523,39398
98568,1093,60179,68570,762,77625,79559,331,30069,35455
98565,238,58611,74396,192,60208,77559,46,0,33328
98564,1110,45109,62080,652,60608,69994,458,32748,48512
98563,3149,63328,85143,2328,74026,89805,821,38668,69814
98562,49,0,0,0,0,0,49,0,0
98560,51,86467,108757,24,175000,140458,27,86033,78293
98559,0,0,0,0,0,0,0,0,0
98558,0,0,0,0,0,0,0,0,0
98557,1324,57589,64151,893,64347,73700,431,32813,39371
98555,166,56000,63414,66,57357,58642,100,0,0
98552,202,48947,67565,124,59444,94923,78,17500,20132
98550,4914,46622,62110,2880,59167,74654,2034,28804,35810
98548,1045,51198,55473,504,53717,63612,541,39173,47882
98547,751,42532,54591,307,44552,77424,444,26116,36384
98546,1494,75707,87649,876,100417,104337,618,41438,60172
98544,22,0,0,14,0,0,8,0,0
98542,316,53250,61239,308,35795,58160,8,0,0
98541,4048,52029,69078,2750,69805,82629,1298,29947,37234
98538,133,52813,66884,103,59375,71340,30,42083,48573
98537,942,60735,71528,649,74861,82437,293,31219,44467
98536,40,0,0,21,0,0,19,0,0
98535,319,0,47922,188,72838,57155,131,0,14550
98533,229,53894,56782,135,54279,61393,94,39677,50160
98532,9543,66685,77778,6754,79397,88029,2789,30594,48269
98531,10553,45972,61592,6285,62868,74453,4268,27415,39054
98530,211,50417,53023,163,50250,53725,48,0,36113
98528,4805,60415,75485,3263,62215,81557,1542,44334,53479
98527,127,39375,43498,70,45682,58154,57,15625,25498
98526,80,55417,53900,38,55833,56289,42,0,51024
98524,1625,93894,95035,1239,103005,109052,386,0,46712
98520,8644,50022,66121,5345,62222,80434,3299,29132,38092
98516,9771,83249,100842,7225,91934,109951,2546,50625,70503
98513,13461,87145,102753,10006,96667,109341,3455,57207,70950
98512,12370,78845,95878,8331,97921,110866,4039,47094,60414
98506,8443,76835,90434,4728,103267,113839,3715,42282,56049
98503,17131,66021,76987,10371,83068,88027,6760,44527,53870
98502,13914,74031,93287,8515,93501,112429,5399,45219,57416
98501,17697,78324,93545,11072,98298,110860,6625,46641,60659
98499,13123,50037,66847,7984,55396,75504,5139,30063,45537
98498,11400,72711,87719,7004,83376,101640,4396,48343,59174
98467,6113,76904,97330,4377,92418,113304,1736,39849,54399
98466,11924,74179,98706,7552,90170,117085,4372,52470,63397
98465,3217,59163,89448,1606,99650,123324,1611,34940,50119
98447,0,0,0,0,0,0,0,0,0
98446,4116,85875,100046,2645,88231,109417,1471,64514,66786
98445,11546,70241,81364,8383,82170,88309,3163,47571,52599
98444,13011,52589,61694,8092,54057,65452,4919,41542,49336
98443,2124,95851,109301,1469,112132,127639,655,51776,62478
98439,2151,38415,47895,1361,44631,55584,790,33750,30586
98438,3,0,0,3,0,0,0,0,0
98433,4399,44064,52496,4125,44112,53072,274,42067,40216
98430,0,0,0,0,0,0,0,0,0
98424,4221,78243,89058,2701,89871,99757,1520,52963,62706
98422,7905,97106,116313,5812,112757,127779,2093,67945,76635
98421,0,0,0,0,0,0,0,0,0
98418,4047,60649,73252,2342,69713,74570,1705,38242,66261
98416,0,0,0,0,0,0,0,0,0
98409,11116,57922,71478,6429,67535,77267,4687,47572,53759
98408,7980,58961,74807,4841,70931,76721,3139,44067,64165
98407,9533,86594,113185,5853,105094,131542,3680,56446,80157
98406,10004,82732,102646,5379,117588,139139,4625,43617,57160
98405,9882,60255,72268,4938,80745,88328,4944,39605,51936
98404,12534,57813,69682,8609,60711,72186,3925,41671,54079
98403,4197,61863,83587,1543,108854,132030,2654,50385,54572
98402,3737,57083,70235,909,92964,98985,2828,50000,60800
98396,297,82031,104122,217,102188,119259,80,53900,56286
98394,476,106190,137930,378,106667,127929,98,0,176502
98392,1341,69583,83127,772,76635,96907,569,52250,58612
98391,18003,104406,128705,14003,109950,139756,4000,60571,80797
98390,4669,70374,86856,2833,79147,100242,1836,54467,59328
98388,2585,85083,97808,1815,106372,107513,770,48250,63369
98387,16353,80272,93719,12527,86183,101433,3826,45250,55499
98385,157,88625,83869,100,102083,91805,57,50417,69946
98383,9053,88893,112529,6125,113750,128922,2928,61136,69969
98382,13487,56392,76451,8582,73441,91890,4905,33903,45849
98381,110,80952,80384,86,81786,86042,24,32500,60108
98380,1623,95443,99843,1138,96337,105884,485,57938,83684
98377,891,39229,46673,555,45579,56393,336,21019,30319
98376,926,67773,79398,630,76618,95050,296,0,45221
98375,10179,89202,95548,8114,90038,98100,2065,71157,76669
98374,14951,88882,108648,11428,99766,118935,3523,43560,64948
98373,9663,79943,101980,6868,98163,113774,2795,50015,67007
98372,10483,81776,96224,6790,99350,111839,3693,56060,62412
98371,8454,81699,99982,5598,101659,118146,2856,43318,56792
98370,13063,85299,104030,8957,103567,122333,4106,44868,59762
98368,8018,56141,79219,4417,69083,95037,3601,42972,58372
98367,11736,88722,100367,8804,96809,106360,2932,54729,70489
98366,13838,70330,86217,9347,81520,98428,4491,43961,54643
98365,2385,74818,95643,1779,94476,109618,606,41875,53064
98364,40,0,0,20,0,0,20,0,0
98363,5955,60147,70442,3827,70146,80155,2128,30625,45861
98362,10715,53743,69333,6326,70970,85469,4389,30094,43088
98361,381,41763,50044,222,50227,54366,159,29289,32915
98360,4898,89732,103737,3566,93854,108014,1332,71898,77743
98359,1888,82870,98060,1509,91629,103677,379,43942,65348
98358,445,57083,97373,270,100556,129086,175,0,46293
98357,539,48250,60612,367,56477,66024,172,18654,37842
98356,811,42386,48787,554,48409,54791,257,22969,33502
98355,339,0,61407,198,0,76205,141,18563,16991
98354,2902,76582,91661,1801,98438,107613,1101,51715,58631
98353,18,0,0,0,0,0,18,0,0
98351,673,51109,86672,517,60486,103224,156,18917,29656
98350,136,35000,59143,99,36250,66557,37,0,34989
98349,2060,73308,82867,1408,74810,91642,652,58594,57980
98346,3881,95103,110304,2891,101135,124857,990,54324,63694
98345,205,47650,67520,120,0,76681,85,44954,54587
98342,600,72955,90911,385,89688,109589,215,43438,54143
98340,1708,64750,89802,1217,85640,102386,491,53125,54073
98339,1441,53239,63684,896,70104,76024,545,24340,38074
98338,10136,83394,97946,7651,91620,104569,2485,60203,72467
98337,3513,55433,68122,1623,66994,77688,1890,41532,50382
98336,307,64712,61237,234,78333,68521,73,0,37890
98335,10604,109031,139032,7555,129614,161716,3049,51563,82097
98333,1368,125547,158476,1053,142434,180212,315,66250,74450
98332,7088,102352,152914,5217,116172,176204,1871,55017,84728
98331,2395,40513,60315,1408,56923,72067,987,24568,37526
98330,61,0,0,15,0,0,46,0,0
98329,3988,95769,108376,3083,110956,120194,905,46128,63467
98328,3778,90636,103403,2715,98449,102367,1063,59948,94232
98327,3906,93405,113773,2520,96200,128652,1386,90691,84850
98326,360,40753,51316,189,42127,56792,171,26068,39281
98325,557,49313,64118,404,66389,76115,153,35273,32440
98323,272,84038,103976,221,94063,107587,51,58250,63376
98321,5840,102135,118157,4179,108560,130637,1661,61849,75774
98320,625,50711,62430,384,69643,72298,241,27951,44715
98315,1201,66736,65255,1153,68821,66034,48,52778,42554
98314,21,0,0,18,0,0,3,0,0
98312,12593,68195,80927,7537,76523,94163,5056,48168,56992
98311,10436,80439,91433,7466,88204,101461,2970,48542,57414
98310,8785,58636,73139,4892,63560,80578,3893,40621,56645
98305,154,0,47421,92,59583,60499,62,0,27387
98304,436,55556,61261,301,56319,64556,135,11985,35420
98303,803,62440,77502,561,80764,83133,242,50893,64448
98297,40,31875,41785,19,60417,60611,21,0,24752
98296,10043,143106,157711,8243,152825,165734,1800,86071,107125
98295,1012,80121,73253,789,80850,79563,223,43594,46278
98294,2813,69458,79189,1809,71763,80489,1004,50556,62601
98292,8642,84489,109898,6010,100500,128479,2632,38011,62495
98290,13592,104091,120834,9976,122571,136611,3616,46965,66943
98288,100,50625,82660,38,46250,99834,62,39375,60313
98286,98,66667,121474,68,71250,93332,30,0,185267
98284,9565,69994,86469,6339,76123,96359,3226,52684,59951
98283,155,75165,59202,59,71750,72483,96,0,51040
98282,7344,85811,111364,5591,91167,116405,1753,56250,82151
98281,608,52692,93646,321,112656,138239,287,32467,43770
98280,206,62500,81835,121,93472,101150,85,55536,54339
98279,371,54107,79770,239,65125,95342,132,35500,43648
98278,0,0,0,0,0,0,0,0,0
98277,15975,61373,79132,10862,69259,90338,5113,41844,52499
98276,219,73583,76474,182,74333,80584,37,0,20330
98275,8270,102818,135237,5839,133653,154982,2431,64696,77785
98274,6852,79127,101593,5068,87166,112033,1784,45755,59239
98273,11548,64699,77020,7679,78926,88051,3869,38479,49767
98272,9282,95190,111223,7203,100488,117479,2079,62658,79533
98271,10598,83047,101613,7662,92140,109567,2936,59836,72964
98270,18803,84957,95420,13489,96268,104743,5314,51078,63752
98267,113,0,41462,54,80357,62191,59,8419,8629
98266,1358,35274,47608,877,50516,54078,481,25890,29931
98264,7847,72397,88732,5482,88557,102434,2365,41049,52883
98263,21,97813,91052,19,98438,91400,2,0,0
98262,474,75294,99289,264,113438,132013,210,50000,53262
98261,1452,63143,85583,908,76774,103060,544,38750,48216
98260,2894,86027,96870,1896,98239,113001,998,39773,63747
98258,11405,96165,107772,9014,105383,115419,2391,49992,68609
98257,2020,70278,91746,1238,83839,111288,782,41000,57738
98256,169,0,62162,87,94688,85793,82,20000,33539
98255,97,29375,35562,53,0,38615,44,27500,28720
98253,847,81165,84853,572,89559,98218,275,49528,57053
98252,3793,84257,96458,2727,102278,111190,1066,41552,50611
98251,1793,73293,77733,1109,84623,89729,684,45750,53294
98250,4001,71567,111419,2482,94107,137948,1519,42645,62816
98249,2244,76614,108916,1249,114107,147969,995,42847,58747
98248,9405,71164,87173,7239,86994,96975,2166,44206,50185
98247,3167,61213,75152,2368,74929,86018,799,33064,37578
98245,1899,55160,95858,1119,67768,115136,780,33611,65000
98244,1388,42324,64895,774,71845,81122,614,31759,41871
98243,287,72560,76721,177,57292,77195,110,80357,75958
98241,863,45089,60266,537,67669,74789,326,28175,36320
98240,1091,80474,95445,847,68992,91167,244,46429,57001
98239,3505,71121,86760,2319,83047,100404,1186,41852,54365
98238,40,0,0,0,0,0,40,0,0
98237,1833,58063,75194,1412,66800,85298,421,19983,34995
98236,2517,85943,107353,1668,107656,125040,849,53711,66888
98235,29,0,48207,18,0,0,11,0,0
98233,6284,65336,83464,4202,80714,90045,2082,41410,65119
98232,1719,88551,113717,1278,97969,126931,441,79083,72256
98230,7506,69060,87044,5070,76078,99288,2436,37365,57184
98229,13265,75099,94968,8640,92933,114908,4625,41016,54606
98226,18733,67142,84017,11904,82155,96405,6829,46631,56280
98225,21812,53093,69554,8226,90729,105181,13586,34331,46370
98224,132,46250,59451,58,63000,64386,74,33611,55582
98223,17601,83116,99533,12237,100029,114683,5364,41602,58442
98222,49,96458,123053,38,86250,126805,11,101406,110091
98221,9760,77036,100495,6324,95089,117925,3436,44622,65204
98220,249,88446,97399,147,0,68315,102,140410,113364
98208,21072,90844,103537,15140,103674,112912,5932,59329,70581
98207,0,0,0,0,0,0,0,0,0
98205,5369,97009,108169,4059,102509,114576,1310,67283,71600
98204,16982,57318,69857,9869,59943,76077,7113,45843,54502
98203,13844,80556,94711,8739,90173,104912,5105,53005,70487
98201,13138,59357,77442,6370,79677,101476,6768,40366,49231
98199,10296,134709,172243,6202,155610,209722,4094,87717,111277
98198,14423,66938,90330,9185,77923,98304,5238,51694,68836
98195,0,0,0,0,0,0,0,0,0
98188,10018,64206,85131,5517,77593,99380,4501,45513,60141
98178,9760,84820,111015,6365,94558,119339,3395,56329,86657
98177,8178,125036,162366,5534,155094,191356,2644,62845,97480
98174,0,0,0,0,0,0,0,0,0
98168,11464,66237,83229,7377,71275,84564,4087,54627,71792
98166,8887,87882,124377,5512,109221,146011,3375,51738,81610
98164,126,240573,204634,83,241693,272102,43,0,74402
98158,0,0,0,0,0,0,0,0,0
98155,13422,107109,124083,9116,123446,140878,4306,61930,81675
98154,0,0,0,0,0,0,0,0,0
98148,4504,70050,91154,2615,74375,101650,1889,43984,71806
98146,10336,80633,98981,7010,91857,110215,3326,52129,67201
98144,14263,87098,135912,7646,105719,171006,6617,63763,89901
98136,7855,123042,147330,4307,146393,176990,3548,79080,106098
98134,215,71607,93611,28,0,113386,187,71607,90650
98133,22212,73702,95334,11031,100745,124684,11181,50529,63270
98126,10437,84934,111563,5318,115352,132066,5119,59130,87587
98125,19643,78263,103336,10141,104633,132231,9502,55534,68538
98122,21237,81308,120396,6180,133320,172211,15057,69563,96875
98121,13511,118270,141701,4104,185380,215871,9407,93015,109324
98119,13762,93014,148337,5265,170224,230864,8497,67917,94895
98118,18077,85541,115645,11170,100417,129533,6907,56756,87031
98117,15301,131508,166123,9554,164909,206287,5747,77107,95236
98116,13120,121967,151980,7051,161757,192644,6069,78728,100290
98115,23430,117038,154113,12844,167117,200349,10586,68179,92828
98112,11846,122388,216581,5998,202092,299387,5848,68902,127309
98110,10170,125861,161748,7396,151630,187886,2774,50867,72809
98109,18617,107330,138804,4772,171186,218808,13845,98454,109552
98108,8595,62530,95557,5388,73712,101095,3207,51806,76853
98107,14846,102436,136986,5506,150852,194617,9340,81448,101477
98106,11354,74608,97035,6435,87436,108573,4919,60337,77030
98105,17332,67449,133295,6816,174195,234100,10516,39468,65925
98104,8637,58018,90725,2076,103500,129885,6561,46880,77996
98103,26314,105480,134281,10168,151164,185071,16146,80725,98980
98102,16219,97374,131801,4086,182281,214954,12133,77007,102802
98101,9870,91550,124205,1990,155222,204436,7880,75284,103943
98092,16799,96121,116946,12503,107390,128965,4296,65135,73214
98087,15132,87320,97649,9645,94116,103164,5487,70206,81068
98077,4856,160441,221698,4263,174617,236442,593,90943,111148
98075,7814,188500,232234,7182,191739,236232,632,101974,147848
98074,9567,196146,225217,8374,209785,239763,1193,97138,114295
98072,9646,127724,160771,6953,156083,184534,2693,71224,92061
98070,4665,78368,114785,2842,114615,148841,1823,34519,57123
98068,251,97607,115761,144,134000,141557,107,88977,81045
98065,5415,150015,169105,4590,163435,182888,825,51799,79168
98059,14016,109565,146436,10847,128583,162258,3169,64419,85749
98058,15798,92216,106748,11297,102246,119395,4501,53886,65267
98057,5711,57598,80233,2256,66198,94014,3455,49139,69911
98056,14560,95074,132379,9534,111382,144237,5026,61075,79950
98055,9337,80586,93734,5698,86420,101658,3639,65896,75632
98053,8572,151525,205610,6588,185915,236441,1984,71136,99215
98052,28404,136208,165241,19054,158959,189288,9350,85692,109106
98051,1621,94453,106648,1148,111250,126965,473,31992,51622
98050,173,142316,210549,173,142316,210549,0,0,0
98047,2380,64942,77373,1762,63576,77241,618,49375,48668
98045,5718,111767,138706,4157,127535,152348,1561,54848,95356
98043,8554,80738,98605,5410,89903,113765,3144,56630,68098
98042,16810,105166,127396,13234,108989,132928,3576,67563,88835
98040,10128,150506,241738,7132,213675,299491,2996,60233,98645
98039,1213,185163,336340,958,"250,000+",374397,255,78036,191540
98038,12308,114804,134178,9980,126639,145865,2328,59182,76582
98037,11036,82667,94567,7104,95387,105304,3932,42558,63940
98036,14821,82684,106289,10064,101234,124874,4757,51485,60410
98034,18126,100955,127177,11569,119021,149612,6557,66120,83900
98033,16701,137378,189220,10153,178339,241346,6548,78346,104856
98032,13942,62620,82428,8262,68056,88356,5680,52953,68213
98031,12646,82241,96642,9618,90668,103719,3028,49865,62361
98030,12608,71014,86624,8986,73758,89639,3622,58071,72231
98029,11853,134424,173740,8194,160179,190268,3659,90717,133464
98028,9296,115093,138209,6129,138199,161774,3167,62217,88221
98027,12074,121620,158050,8307,149451,179622,3767,77207,104220
98026,14864,98415,126738,10072,114230,150305,4792,58042,71491
98024,2293,158168,170052,1923,157651,170102,370,141071,136089
98023,17466,82566,100910,12960,92107,109615,4506,54091,64517
98022,8484,90223,112118,5724,109977,127998,2760,43225,75529
98021,11534,129215,158593,8826,150397,179861,2708,66200,84690
98020,8590,95682,147323,5475,126686,188456,3115,53205,72451
98019,4042,142064,165136,3293,158947,182471,749,70956,86614
98014,2773,118808,150458,2231,132452,168241,542,62222,74406
98012,24755,118544,134098,18737,132333,146776,6018,70616,86580
98011,13318,103421,120952,8846,123346,138332,4472,70322,80255
98010,2286,125652,139437,1677,131283,158694,609,63477,70711
98008,9125,131952,174696,6561,154688,197385,2564,68000,106388
98007,11578,101847,130345,7205,106489,149755,4373,76038,89055
98006,13030,156382,198704,10558,170481,220132,2472,72127,100107
98005,8590,135225,186020,5551,158443,223219,3039,75943,110056
98004,17460,142173,210129,9660,191151,261415,7800,101029,143679
98003,18515,59560,76753,10942,67822,89003,7573,40363,53131
98002,13162,59097,70945,8042,68949,79445,5120,34375,48448
98001,11648,88962,102586,8543,96106,111781,3105,56438,70380
97920,19,22188,75395,15,0,92993,4,0,0
97918,1652,40469,61265,1183,58819,70531,469,31440,30678
97914,5945,42582,57263,3708,49977,67883,2237,23544,35644
97913,1777,48556,54046,1264,55333,59729,513,30542,39359
97911,60,52222,56423,33,0,70076,27,0,32578
97910,214,52813,56393,161,53281,60220,53,30938,29506
97909,0,0,0,0,0,0,0,0,0
97908,17,26250,45959,9,0,59022,8,30833,31263
97907,238,31250,52847,139,39750,57471,99,24107,45708
97906,95,51607,77854,75,58750,91669,20,17500,26045
97905,44,115300,80875,41,115450,86190,3,0,0
97904,117,43750,67481,95,44215,77837,22,17045,22764
97903,10,0,0,10,0,0,0,0,0
97901,269,44063,63772,202,45833,65939,67,0,57239
97886,348,52500,66100,277,73750,75401,71,20179,25269
97885,519,50990,64550,342,65833,72030,177,42426,49276
97884,62,40000,49634,33,47083,65073,29,28393,32066
97883,974,54130,61353,615,58945,74426,359,22583,35504
97882,2258,48491,55166,1416,51852,60404,842,35272,41961
97880,167,0,44229,57,70865,80182,110,13421,25600
97877,203,20826,32237,107,0,47788,96,9122,14902
97876,357,86635,84893,312,92857,89242,45,21875,39658
97875,1059,60032,68366,895,62768,71122,164,29079,38922
97874,184,40938,47316,129,47292,52803,55,25250,33816
97873,140,48500,63044,97,66250,75114,43,22292,34370
97870,318,50417,55255,194,56500,64976,124,23000,39118
97869,448,53200,60531,259,70083,81790,189,0,28963
97868,676,61292,83389,466,73929,96363,210,31389,54120
97867,368,68553,72340,288,70781,79102,80,35000,46546
97865,680,56080,79093,456,55938,88066,224,56346,59219
97864,168,32414,49506,52,75556,66860,116,31806,39472
97862,4462,45294,63133,2882,62818,76222,1580,20281,33484
97859,72,0,58564,49,103512,74482,23,0,24652
97857,246,47206,55653,172,58409,63030,74,28500,30593
97856,205,45750,54237,64,61500,78681,141,31736,42977
97850,7071,51230,68319,4534,64541,80534,2537,28969,41415
97848,90,52500,77060,77,53750,82303,13,48750,44477
97846,947,59985,80448,604,72672,97199,343,41563,49600
97845,1062,42051,58123,544,61500,67604,518,28286,46214
97844,1274,63387,68805,1020,67674,68375,254,45417,57907
97843,312,70833,102428,223,93073,125889,89,34250,37625
97842,54,38000,47600,33,40938,54630,21,23625,36557
97841,195,73750,102122,150,81944,116760,45,29125,53327
97840,48,135500,123050,48,135500,120783,0,0,0
97839,128,38542,57764,85,50781,70586,43,24583,30291
97838,8938,64579,78360,6681,71301,84027,2257,40033,57854
97837,57,0,24635,13,80179,69054,44,25000,11511
97836,914,42647,75765,623,66641,87907,291,36658,38733
97835,180,95833,97425,116,109688,116771,64,26071,57241
97834,571,37725,49716,362,37813,53201,209,31510,42633
97833,338,60500,64082,240,63269,70623,98,23500,35126
97830,342,45488,51230,176,47500,64214,166,41818,37240
97828,1429,46108,77723,798,73542,97140,631,26506,51467
97827,1109,47980,56654,737,53924,67188,372,26351,33291
97826,452,34806,60802,320,45417,70306,132,23500,34796
97825,170,49375,46665,100,53864,52753,70,35000,37967
97824,722,62353,73706,490,71000,86489,232,36548,43471
97823,539,33994,46496,232,60882,70013,307,16969,28232
97820,443,43958,58279,319,49750,64434,124,35278,42106
97819,12,50833,44167,8,0,0,4,0,0
97818,1433,57422,66231,1067,62027,72860,366,25938,34765
97817,7,0,0,7,0,0,0,0,0
97814,5275,49961,68667,3216,57184,82465,2059,32582,43863
97813,553,65428,86999,391,71128,106464,162,0,37519
97812,340,56154,66821,215,73393,78356,125,31705,44937
97810,444,50250,76868,348,54211,82327,96,40455,42583
97801,7247,60830,71122,4578,72758,85951,2669,32077,42366
97761,1030,35333,51127,859,38705,52885,171,16414,26468
97760,3076,64722,91083,2290,73538,101731,786,37353,50166
97759,3258,77351,106997,2447,90896,123681,811,36862,50766
97758,32,25625,46841,21,0,63243,11,0,15527
97756,15252,66120,74345,10470,72958,83535,4782,36713,47586
97754,8913,56035,63255,6027,66769,71227,2886,32570,39342
97753,1021,106641,127734,907,101509,130228,114,118500,98804
97752,0,0,0,0,0,0,0,0,0
97751,27,39063,40796,21,0,0,6,0,0
97750,157,48207,55531,106,55000,68616,51,23958,27600
97741,4430,52400,69474,2822,66205,83611,1608,26414,38121
97739,5416,48415,60857,4128,49828,64621,1288,26333,39299
97738,823,62367,77652,642,65521,84620,181,29083,45130
97737,236,34875,41420,190,40217,44894,46,0,0
97736,36,86250,83211,27,97188,96648,9,38250,42889
97735,37,0,60168,13,0,0,24,0,0
97734,1157,60795,81771,891,70341,92209,266,36875,42065
97733,239,0,48832,126,0,64791,113,0,30140
97732,46,28750,29365,21,30625,37800,25,25000,22280
97731,208,30625,48955,132,0,63002,76,21000,21837
97730,116,77917,90292,99,95625,98357,17,0,43335
97722,25,63125,72076,24,63750,74996,1,0,0
97721,100,33929,62270,57,34750,67158,43,0,55791
97720,1944,36652,53575,1227,50552,64919,717,25054,32368
97712,20,0,0,15,0,0,5,0,0
97711,16,0,91731,11,0,87545,5,0,0
97710,52,0,64873,43,0,62519,9,0,76122
97707,2643,69775,83513,1696,77031,95186,947,52617,55816
97702,20316,69140,95495,13508,79406,112898,6808,42723,55090
97701,29648,74338,103507,19204,93155,123989,10444,43338,57779
97641,783,33472,44219,549,34034,49496,234,28409,30073
97640,94,50455,55445,36,75833,76611,58,30893,42307
97639,177,31366,52516,136,21667,31624,41,0,0
97638,188,53971,60685,166,58409,59624,22,39286,31782
97637,54,0,45157,22,65833,54327,32,0,38853
97636,220,52500,52005,146,55250,60275,74,26786,32422
97635,94,0,73435,77,0,86644,17,0,0
97634,98,55208,57503,78,56250,58156,20,0,0
97633,545,45933,60802,377,48047,73361,168,27865,28642
97632,531,57198,72119,435,75515,80312,96,26563,30463
97630,2009,51311,63825,1206,71691,79993,803,23482,38424
97627,206,64397,69569,188,64569,73240,18,0,0
97626,58,0,28643,0,0,0,58,0,28643
97625,100,74333,95780,63,0,112135,37,0,62946
97624,1591,45771,58286,890,55333,67392,701,29391,44916
97623,1161,45703,61892,792,46136,67376,369,29375,47468
97622,166,45238,40607,104,45238,42733,62,0,33208
97621,126,0,218456,69,0,31126,57,0,0
97620,75,26354,48677,27,64583,86881,48,24853,27185
97604,0,0,0,0,0,0,0,0,0
97603,12200,51790,62090,7874,58963,71007,4326,24808,40476
97601,10107,45392,63135,5699,59431,77465,4408,27606,41721
97544,1066,53190,63837,638,76250,78103,428,32778,38479
97543,198,0,73328,146,96250,88482,52,24722,27650
97541,691,40694,53437,504,65167,67333,187,8927,14338
97540,3886,44012,58721,1949,63109,74796,1937,27301,39780
97539,1522,43824,59292,952,63689,71311,570,18446,37643
97538,719,48995,64664,510,49531,74396,209,0,33169
97537,2879,52960,73386,1957,59468,86505,922,32500,37926
97536,511,36065,48262,308,47644,55878,203,23456,34685
97535,2289,38427,48036,1204,52667,62882,1085,21698,27893
97534,458,21269,24989,218,23889,35553,240,18085,15393
97532,1105,56272,64840,925,55685,66560,180,37917,43292
97531,134,45813,61355,134,45813,61355,0,0,0
97530,3451,87254,101995,2228,100061,115725,1223,49297,72503
97527,15275,49744,67270,10743,58381,76849,4532,25749,39681
97526,14783,49906,67954,9685,61002,77007,5098,31759,45697
97525,1909,57823,72609,1282,61014,74702,627,35375,59312
97524,6002,69825,90341,4447,76879,95665,1555,34539,59155
97523,2771,35792,50502,1629,41597,51291,1142,24625,46430
97522,270,40833,53796,181,46771,57487,89,18906,38815
97520,11717,58590,91888,5979,92271,127474,5738,32084,49848
97504,19656,62219,83029,12647,79223,100975,7009,37526,46893
97503,4364,54204,56470,3255,56675,60075,1109,24406,34971
97502,11211,72650,94996,8168,80402,105760,3043,35992,60995
97501,18685,48865,58721,11601,55264,67281,7084,31240,40392
97499,821,50527,53310,552,53276,60541,269,26359,30130
97498,868,54167,67389,430,63750,90179,438,38158,43420
97497,744,33333,57388,425,56940,76271,319,22212,32108
97496,2967,46488,66056,1978,56425,68851,989,33149,56432
97495,681,92132,97870,555,94598,106569,126,51518,59456
97494,51,0,0,0,0,0,51,0,0
97493,125,53750,66226,93,53977,68959,32,51667,51216
97492,509,26849,36839,165,44844,50793,344,26307,30037
97490,132,88750,86877,111,89375,84873,21,0,69748
97489,384,80667,102228,293,86250,118391,91,42188,50187
97488,474,75878,91717,325,83583,105770,149,41927,58782
97487,3581,52435,70583,2453,59141,80916,1128,29028,45770
97486,324,56136,149170,291,50288,145891,33,0,0
97484,69,36806,43725,30,37222,51697,39,24531,30751
97481,346,80577,88786,218,58106,66558,128,0,0
97480,137,33125,51350,75,34712,60777,62,24722,38894
97479,4410,49549,59857,2678,64412,72997,1732,22018,34660
97478,14735,64536,76135,10557,72432,85964,4178,34267,43580
97477,16194,48644,61041,9452,57622,68428,6742,31104,46838
97476,148,55526,60495,148,55526,60495,0,0,0
97473,143,47083,56408,113,54625,63444,30,23125,29907
97471,12946,54821,75846,8834,67708,85850,4112,28851,49236
97470,8589,46032,57667,5069,54211,68247,3520,32518,40164
97469,1076,51037,55715,766,56016,61521,310,0,39174
97467,2242,41317,56990,1305,54073,64813,937,22411,44308
97466,450,40682,45028,278,40000,47231,172,0,32900
97465,1055,32236,50301,598,46591,66838,457,14844,28660
97463,1658,32583,41574,947,40531,46867,711,29738,30063
97462,1669,49459,68055,1152,63558,82867,517,30886,35003
97461,372,97188,98491,324,98690,101229,48,0,77892
97459,5737,64608,83980,4178,83631,96136,1559,30666,46393
97458,2072,40179,54738,1263,56938,68818,809,20967,30869
97457,4100,47788,57244,2728,59868,66243,1372,25426,35096
97456,1200,49855,88520,858,68929,101479,342,38889,39693
97455,991,83750,85330,768,96719,101897,223,21172,20522
97454,411,83688,89355,298,83375,96356,113,68125,62685
97453,378,37813,49671,243,45990,57533,135,22875,28690
97452,594,70600,84044,423,72150,82265,171,47344,85369
97451,167,118958,120443,156,132500,124818,11,0,0
97450,272,52577,47721,185,48920,42783,87,0,47014
97449,1004,42143,49887,570,49183,61267,434,28516,34294
97448,5255,62953,90396,3688,79221,92471,1567,34421,80148
97447,210,47794,62654,125,73262,86925,85,33320,26962
97446,1991,46597,65295,1381,60411,73751,610,38510,41000
97444,2691,56813,73222,1782,70484,88060,909,31734,41504
97443,1006,62222,63565,730,65164,65707,276,37000,51021
97442,1052,47518,51909,736,48440,59249,316,19079,28297
97441,155,44904,46687,146,48438,44301,9,0,0
97439,7552,52194,69538,4333,65077,80284,3219,36424,52174
97438,424,60000,95890,301,82625,117695,123,30375,36703
97437,928,71554,77069,638,76667,86730,290,50500,53620
97436,338,56250,77610,218,73864,90978,120,38833,49348
97435,934,54583,72094,695,67545,83068,239,36083,33587
97434,296,36806,51138,187,40391,55421,109,31186,37244
97431,745,55150,80375,642,56700,75797,103,0,83861
97430,160,46458,69588,122,57500,81982,38,25500,29795
97429,355,44375,54027,271,44861,59755,84,29792,31954
97426,3758,62845,79361,2787,80592,90790,971,25338,43229
97424,7310,54104,64924,4548,62467,75614,2762,34003,42272
97423,3006,41818,59498,1650,52731,72655,1356,28389,37056
97420,12092,52447,70133,6830,68353,87703,5262,29481,44043
97419,385,45893,52791,263,61875,65722,122,18984,20232
97417,1093,35211,41145,581,36661,42984,512,27727,37997
97416,404,54750,67113,316,71439,70043,88,53256,44681
97415,6462,54842,71205,3882,70730,81223,2580,30980,54330
97414,73,0,22289,15,0,0,58,0,0
97413,475,54172,66092,245,54078,70363,230,46500,55616
97412,230,57000,90513,138,68750,94306,92,0,66887
97411,3411,38054,57372,2221,55080,73579,1190,20090,26126
97410,278,43833,65115,200,70667,71900,78,0,38977
97408,5787,70931,106575,3515,100297,124838,2272,42778,76905
97406,162,18658,18981,62,0,0,100,0,0
97405,19350,72425,97674,11571,93109,121415,7779,41958,52320
97404,13222,66731,79850,9248,76842,88554,3974,40944,53287
97403,4261,44540,74194,1626,101419,123731,2635,27467,42482
97402,21782,46504,59355,11828,61728,70781,9954,32163,40051
97401,21770,41502,65032,8088,77917,98435,13682,28925,43494
97396,1363,45163,66184,1002,54063,75517,361,28750,36773
97394,2423,49559,62157,1398,65850,75480,1025,26725,42963
97392,1974,92568,96731,1659,97257,104497,315,31964,47276
97391,2447,49265,63473,1678,62336,76440,769,19228,29172
97390,614,60846,55150,491,61257,62003,123,26908,27016
97389,699,70688,75231,533,77602,81082,166,33382,47834
97388,460,59150,97830,248,59296,77955,212,0,121081
97386,5878,52333,63773,4082,63183,74651,1796,26167,36282
97385,1355,81359,91953,917,100866,116633,438,30455,38334
97384,34,0,0,34,0,0,0,0,0
97383,3859,63610,75258,2858,72123,83302,1001,27558,42037
97381,5739,76026,98246,4181,82844,110620,1558,41530,60936
97380,818,53523,77853,540,70625,91787,278,44034,42155
97378,3349,62595,75461,2222,73060,91046,1127,29656,41538
97377,297,73125,82773,233,85972,84302,64,43333,45755
97376,515,54226,65375,333,56528,64889,182,51912,60589
97375,395,71422,77934,327,73068,82930,68,0,49218
97374,1817,70362,75896,1309,70625,82182,508,62059,58717
97373,0,0,0,0,0,0,0,0,0
97371,304,0,100575,158,139211,169957,146,0,25490
97370,3314,85000,100171,2462,91154,113137,852,46250,58794
97369,67,53194,104869,36,0,160575,31,42969,40177
97368,1388,43594,55447,868,47742,60183,520,27113,37559
97367,4514,46563,69784,2538,54756,91523,1976,29707,40862
97366,880,70497,80037,549,70942,81476,331,60885,75872
97365,4766,49529,65209,2737,67760,79694,2029,33138,42071
97364,277,87613,65641,179,88788,80259,98,31538,36744
97362,1540,63372,71160,985,82614,90093,555,20625,33306
97361,3985,56058,72346,2579,78661,88543,1406,21319,33962
97360,901,52075,53957,631,58554,64884,270,15667,25962
97358,1106,68704,77963,813,85813,90438,293,29875,41440
97357,120,53333,52228,47,54345,67549,73,0,41864
97355,12014,54799,68389,8261,66839,77753,3753,27052,43090
97352,2037,73850,85988,1777,78173,89016,260,38438,45353
97351,3511,55772,68004,2465,66210,74821,1046,35234,41426
97350,54,65625,61707,43,67188,68642,11,0,33091
97348,587,81219,93987,401,84750,100622,186,63125,64324
97347,653,39214,54584,407,42829,67021,246,23750,30131
97346,393,71250,66658,320,71667,71396,73,0,41625
97345,192,34219,39577,129,45792,46966,63,0,24448
97344,567,43385,62357,409,49250,69097,158,22500,41097
97343,135,0,106382,67,87386,192900,68,0,14176
97342,49,54375,80567,32,86667,106550,17,26563,31659
97341,1398,48250,70958,837,59514,88895,561,19547,37274
97338,8517,61745,78871,5782,80010,86926,2735,38730,57096
97333,9775,56466,76451,4725,83575,106627,5050,30470,45542
97331,0,0,0,0,0,0,0,0,0
97330,17954,59600,84986,9659,87492,115215,8295,35999,47859
97329,56,0,33880,31,0,0,25,0,0
97327,1373,69637,97876,843,90074,99231,530,46500,90503
97326,489,65139,76167,394,72500,78942,95,0,59544
97325,2296,64387,87051,1831,78397,96093,465,43828,44685
97324,632,57500,77640,501,68281,85617,131,22159,31475
97322,13743,60148,71799,9191,68492,82710,4552,37965,46093
97321,10407,76107,90951,7306,92885,103972,3101,41387,54145
97317,8043,70838,85716,5851,75994,92912,2192,46744,57370
97306,12387,71775,93058,8402,85918,105723,3985,50244,62216
97305,14176,56787,67318,10340,59510,72218,3836,36975,45625
97304,12593,74583,100927,8517,93768,111298,4076,39612,74735
97303,15214,64369,78657,10289,76026,86029,4925,41995,58005
97302,17021,67270,89500,10459,81794,109517,6562,44153,54814
97301,19310,45959,58127,11189,52504,67411,8121,31043,41577
97267,13886,70170,85929,8801,83657,100594,5085,49159,57594
97266,13439,59062,74418,7818,65370,76920,5621,46799,66595
97239,9249,93594,130573,3959,161379,182487,5290,76702,89889
97236,12817,52428,69998,9110,55660,76050,3707,33168,42970
97233,13657,46433,58121,8879,48306,62391,4778,33000,43132
97232,7996,59109,87464,2408,121318,155117,5588,43998,56384
97231,1675,101850,161621,1137,132474,196665,538,66535,82335
97230,15326,58276,76745,9288,70821,88416,6038,38973,53710
97229,25804,123522,155336,19328,149931,179747,6476,54343,75055
97227,3150,75805,109494,770,108810,138007,2380,68879,96827
97225,11736,91786,118799,6707,124964,153873,5029,54443,70284
97224,14893,80419,105065,9255,103460,128951,5638,48579,61508
97223,20246,90883,104461,13283,112852,121811,6963,50049,66612
97222,16090,64905,79481,8511,84257,94269,7579,43886,56357
97221,4997,124983,186288,3332,158750,230908,1665,65509,92617
97220,11615,56040,69069,6346,71476,83754,5269,41639,49596
97219,17694,104392,143475,10928,136388,176358,6766,65469,86316
97218,5500,67436,75978,3180,69537,80473,2320,63056,64115
97217,14838,88017,103943,7550,99316,117395,7288,70417,85843
97216,7001,55795,70982,4345,62849,77428,2656,41905,52583
97215,7356,85368,112734,3978,113333,132114,3378,55274,86157
97214,14052,74871,96678,5261,122153,139854,8791,55677,69389
97213,14667,80916,104868,7820,105882,130976,6847,54332,69486
97212,11547,108305,146186,7171,135325,175815,4376,66325,91736
97211,14336,86976,107669,7629,112172,128582,6707,62774,79492
97210,6325,79097,133214,2389,179125,224310,3936,49327,75430
97209,13633,65746,100830,2979,131492,182961,10654,52500,77665
97208,0,0,0,0,0,0,0,0,0
97206,21211,72463,87404,11867,86587,99273,9344,53910,67118
97205,5286,41940,79657,1091,136417,167165,4195,31067,56489
97204,512,0,24876,29,0,0,483,0,18293
97203,12805,67229,82238,6827,78181,90257,5978,53280,69410
97202,18194,86351,113578,9274,121765,147884,8920,57052,75138
97201,9310,58850,101606,2389,141331,197978,6921,42355,68176
97149,211,76055,74927,130,76641,84887,81,0,58943
97148,1096,98320,122938,910,100735,129975,186,64265,80216
97147,179,43125,45935,71,61750,61558,108,33750,34918
97146,2595,76750,81213,1737,78948,86876,858,54583,62848
97145,186,96848,103630,122,120375,123911,64,0,64967
97144,74,88352,74949,31,88828,77448,43,88080,73147
97141,5295,54424,69685,3564,65819,83089,1731,30570,38409
97140,8739,108865,127500,6760,122173,145710,1979,50881,61453
97138,4700,47575,68568,2383,73750,93117,2317,31237,39204
97137,357,95938,114367,278,107000,122456,79,55156,72077
97136,823,52083,74439,537,56675,89247,286,31762,42418
97135,408,67750,63057,310,80179,70912,98,19950,38209
97134,67,0,100437,15,0,0,52,0,90315
97133,1813,105938,138826,1301,132321,163926,512,59500,72831
97132,10602,80541,102329,7683,92058,113725,2919,43028,61932
97131,1329,59063,82605,786,66940,106925,543,34931,42311
97130,297,55757,69633,186,60208,80260,111,49375,51824
97128,14389,54983,82134,9229,72575,97925,5160,36113,50345
97127,1377,77662,83237,1098,78412,88355,279,40795,54534
97125,25,168750,141000,25,141250,112380,0,0,0
97124,20864,95068,114264,14094,101227,125786,6770,72021,82632
97123,16231,84052,102215,12431,89262,107095,3800,52619,74063
97122,166,63958,59795,140,64688,66446,26,0,23985
97121,553,51691,61646,354,54615,69337,199,45529,42989
97119,1749,101314,113906,1449,103994,118353,300,64146,86258
97118,325,48750,83505,182,58167,69843,143,32228,99944
97117,255,79821,115561,219,85368,126237,36,0,41350
97116,9534,71397,87386,6206,90205,103859,3328,38571,52157
97115,1384,81747,93944,1117,81291,94927,267,0,65791
97114,1473,70256,90307,1115,80809,99971,358,47000,53561
97113,4919,73365,90626,3604,73611,85847,1315,64407,93794
97112,767,42740,52479,445,46712,61101,322,24500,38464
97111,1222,79722,85454,1005,86250,89444,217,38750,49330
97110,577,51699,72972,219,69583,126133,358,0,40451
97109,220,85000,95211,167,87159,101600,53,0,67425
97108,221,53897,51712,137,60060,57590,84,35893,39680
97107,922,62759,67998,601,67153,74465,321,31838,54271
97106,1656,106250,122873,1384,111724,131921,272,47500,67735
97103,6910,58426,74733,4152,76792,88639,2758,37633,50391
97102,183,101713,124499,117,106750,153811,66,0,0
97101,1390,82826,90048,1077,97813,99689,313,35625,50708
97089,4562,98031,116132,3795,106950,125979,767,46146,52794
97086,11689,91343,119895,7885,116185,142259,3804,51310,67424
97080,15745,78579,97765,11755,90889,106451,3990,45995,63377
97071,10001,55279,75768,7226,60441,86171,2775,28376,39771
97070,10007,73998,105897,6063,98446,123760,3944,53223,76488
97068,11267,125898,159411,8496,142249,182612,2771,46642,82922
97067,1058,59293,69984,554,74600,89935,504,50603,47977
97065,275,50063,85371,168,51667,106901,107,36094,47181
97064,1357,56094,69819,938,73523,81664,419,29021,39024
97063,374,46987,106048,212,55833,143123,162,44545,56271
97062,11007,95482,113680,7627,108300,131908,3380,51173,66894
97060,6933,77535,89749,4918,87370,100273,2015,47255,57134
97058,8101,54133,75629,5158,62465,91831,2943,33567,40321
97057,6,0,0,2,0,0,4,0,0
97056,4672,77784,96063,3197,97700,112626,1475,37080,51576
97055,6831,82456,94638,5143,90448,104408,1688,47857,57175
97054,603,59729,70155,444,70306,80688,159,28523,39965
97053,1307,95260,120855,994,124773,143465,313,39599,45029
97051,6360,65710,74967,4249,78311,85385,2111,35982,48471
97050,109,51875,54925,63,49583,58165,46,36500,45485
97049,809,76858,86232,431,86607,100673,378,75976,67327
97048,2737,61031,74533,1879,76520,84296,858,31920,46532
97045,20332,83254,100617,14568,94856,112323,5764,44507,63244
97042,1023,75378,97548,848,77035,101354,175,63594,58378
97041,882,56875,78418,654,70341,85735,228,44070,51058
97040,616,77961,88697,453,79306,93449,163,64219,69891
97039,202,58500,79496,125,72750,100661,77,31420,42983
97038,5522,72432,83860,3968,82932,91652,1554,49656,56826
97037,399,42596,66820,247,69583,89930,152,19000,29266
97035,10962,103299,140650,7366,128438,172426,3596,56080,72755
97034,8155,129435,194490,5886,163027,233616,2269,55299,88429
97033,26,0,60958,8,0,0,18,0,0
97032,1808,76725,88468,1349,83523,100123,459,31914,43491
97031,7331,76434,98664,4831,90372,114584,2500,46409,61603
97030,14978,53700,64612,9178,63492,71530,5800,38376,47665
97029,115,52232,56527,67,71023,64010,48,0,37115
97028,127,63807,56652,32,0,0,95,0,0
97027,4928,70677,92998,3369,86804,103397,1559,36492,62141
97026,951,70329,92014,750,77069,91635,201,50179,75676
97024,4565,60434,75069,2529,83845,94929,2036,40035,48922
97023,4065,62073,82423,2851,72605,95380,1214,40093,47681
97022,1532,83664,95327,1283,84332,97612,249,62569,63113
97021,553,64861,76100,340,74896,95193,213,26696,44740
97020,418,73125,82263,351,73281,81170,67,44327,74004
97019,1198,87760,99528,879,99076,115036,319,42169,56665
97018,715,82137,90959,492,85625,96738,223,62946,77584
97017,1245,67969,82998,809,98381,108861,436,22419,31388
97016,2615,52807,72720,1735,72730,85782,880,27115,44212
97015,9403,77720,93965,6058,94040,111307,3345,45907,53544
97014,710,52632,67394,499,53750,79554,211,27708,32995
97013,8505,77002,91968,6260,89214,104148,2245,43468,51213
97011,370,71000,102955,165,84076,81623,205,45767,118418
97009,2919,79599,98745,2374,92976,102257,545,41513,76917
97008,12581,74082,91244,7289,93472,106759,5292,49554,62998
97007,26407,87360,108969,18847,97647,120164,7560,58957,74415
97006,27309,83955,98207,17692,89196,106158,9617,63096,76860
97005,11850,56821,73178,6390,70542,84115,5460,37004,56605
97004,1651,93388,108677,1099,100344,116821,552,61818,89504
97002,2270,73462,100091,1680,81905,104372,590,44432,79057
97001,82,0,43751,34,57500,43482,48,0,43942
96863,0,0,0,0,0,0,0,0,0
96860,0,0,0,0,0,0,0,0,0
96859,0,0,0,0,0,0,0,0,0
96857,0,0,0,0,0,0,0,0,0
96853,0,0,0,0,0,0,0,0,0
96850,0,0,0,0,0,0,0,0,0
96826,14901,56701,72808,6690,75073,90545,8211,39035,54291
96825,10128,129292,158292,7996,144042,174041,2132,65083,87079
96822,18600,78787,113423,10092,104094,145801,8508,57059,70155
96821,6470,154545,192296,4968,166408,209391,1502,82452,122497
96819,11719,83457,113042,9403,90272,114660,2316,50750,69357
96818,18766,80753,98645,14881,88117,105182,3885,54498,63382
96817,19033,65413,96787,11463,80389,116494,7570,42153,59268
96816,17646,91014,120582,11572,111949,141619,6074,55039,72185
96815,13953,64977,88906,5374,96623,122246,8579,53590,66743
96814,10706,62500,84281,5036,85500,105183,5670,43943,63683
96813,11265,76147,101231,5966,94849,124103,5299,45136,72051
96797,19049,92749,110399,14863,100452,117607,4186,57394,65758
96796,679,57781,78102,354,92143,103636,325,37917,50162
96795,2166,107115,125530,1853,109464,126525,313,39306,67504
96793,10376,92033,103502,7577,103248,114502,2799,38946,62242
96792,12316,71989,86441,9497,84186,92449,2819,30905,50116
96791,2336,81912,102361,1601,85438,102167,735,53050,87048
96790,3321,79358,124574,2317,95919,134636,1004,45592,89635
96789,17717,106263,123148,13865,118897,134900,3852,60197,68310
96786,12762,69212,84446,9920,73797,87104,2842,45237,67336
96785,1802,58000,69781,970,68864,82740,832,47632,52772
96783,649,51875,73096,435,74861,89936,214,26750,31385
96782,11673,93357,115311,8547,111990,132442,3126,48010,58466
96781,371,59567,99829,261,73194,84800,110,0,128472
96780,233,0,81408,135,0,108177,98,27381,33637
96779,789,107292,135808,590,106667,146184,199,68250,79161
96778,5964,38244,54708,3800,49929,65895,2164,18717,29496
96777,601,50273,80960,304,90341,130783,297,20711,26241
96776,493,42175,56593,326,47813,60226,167,35234,45190
96774,83,73281,67530,68,81000,71046,15,0,0
96773,53,0,38940,30,0,55080,23,0,0
96772,1056,55469,70071,676,73472,83177,380,38125,44846
96771,2779,41652,59149,1906,48591,63297,873,22813,43194
96770,226,33125,37373,108,45500,47933,118,18333,26586
96769,127,44438,57243,103,46339,67453,24,15000,13425
96768,6436,96175,115704,4703,101074,119862,1733,54058,83639
96766,5129,85843,101779,3873,94526,108132,1256,50655,62168
96765,121,54850,60138,69,53050,54432,52,71452,67710
96764,276,60250,76389,181,75625,84556,95,53403,51132
96763,1265,59053,81206,815,95956,95527,450,41146,47612
96762,953,99453,112650,754,113750,124264,199,43910,61819
96761,7461,85137,121135,5004,96121,135644,2457,53612,75269
96760,1165,62196,66662,733,67614,74815,432,41520,49377
96759,324,62794,66143,324,62794,66143,0,0,0
96757,213,54583,74122,177,70547,78674,36,39318,38169
96756,2228,76064,104263,1454,92273,116746,774,39519,72894
96755,1227,80614,110729,795,98693,143890,432,29167,45243
96754,1212,82500,117671,809,87792,111069,403,64375,121238
96753,10988,81918,115089,7125,94479,126184,3863,58040,83478
96752,1020,88182,87402,838,96154,95627,182,31538,38686
96751,73,49450,54432,24,0,0,49,0,0
96750,1216,66646,87956,805,74149,103351,411,45724,50861
96749,6301,66697,78871,4569,78227,81490,1732,35373,58371
96748,1474,52991,66188,961,64688,73814,513,45444,46958
96747,268,73430,85434,250,46250,67634,18,0,0
96746,6647,92150,103752,4315,100923,116358,2332,44530,66821
96744,16156,116157,134989,12421,127022,145794,3735,65176,85005
96743,4636,97686,124497,3329,114257,147999,1307,33338,56970
96742,306,76465,74680,164,76274,77724,142,77895,71164
96741,2191,83315,96491,1648,95682,108924,543,29400,49955
96740,14640,78895,108393,10393,83448,110521,4247,51696,86997
96738,2810,77577,85883,1869,90886,96785,941,53285,58648
96737,1781,24818,35761,966,32656,44116,815,20154,25579
96734,15760,109186,142091,12330,120636,151951,3430,63547,91496
96732,8354,81129,96394,6785,88157,101167,1569,32212,47782
96731,825,83994,110431,658,87381,119379,167,38523,64816
96730,489,102875,108406,330,116071,128011,159,52946,62989
96729,369,37135,56193,307,39583,58181,62,20000,34835
96728,166,71000,100849,122,80000,105731,44,36250,79161
96727,1506,59612,68514,1124,65000,73330,382,40690,42153
96726,110,63000,79382,61,140625,113956,49,0,36341
96725,1292,76484,92581,828,84461,108646,464,53676,58500
96722,848,76250,95787,581,88144,101611,267,52708,83114
96720,17101,65551,83351,11250,77935,94310,5851,33750,54418
96719,520,82188,100644,228,67100,84771,292,119659,105187
96717,1265,92750,99447,900,101148,101091,365,52750,68887
96716,902,83214,93841,720,89363,103173,182,38235,45775
96714,438,69038,94343,308,65833,97950,130,45000,73472
96713,390,44449,70159,199,90250,94425,191,42702,44572
96712,2467,90554,121158,1443,116793,139385,1024,63289,90963
96710,102,0,84545,71,153009,119052,31,0,0
96708,3958,84789,104598,2964,83700,107375,994,57857,78054
96707,13811,109800,130646,11022,116828,138700,2789,59135,85232
96706,20356,106015,119241,16839,108645,122989,3517,65656,76379
96705,746,89531,91037,536,108472,102880,210,49545,52881
96704,2814,59063,98187,1957,79350,101297,857,25188,46997
96703,702,61667,80734,510,80625,91975,192,25833,44499
96701,13316,96987,119741,9494,112303,132938,3822,59836,73405
96161,6975,100205,148847,5236,115436,166444,1739,58942,88547
96155,0,0,0,0,0,0,0,0,0
96150,12647,62541,95949,6936,82407,119749,5711,38478,63075
96148,232,81833,106323,134,105729,124074,98,80250,82051
96146,454,78409,161758,234,148438,235674,220,66296,83139
96145,1103,84648,113998,647,110101,135293,456,61346,83215
96143,1444,51500,67917,746,47344,66745,698,42500,60787
96142,356,70278,75662,215,79531,80650,141,42589,58244
96141,196,69688,141083,121,104904,182509,75,67734,74247
96140,639,88920,126507,358,117045,163148,281,54886,78690
96137,1615,47697,66775,1023,63277,79627,592,32500,44363
96136,7,0,0,7,0,0,0,0,0
96135,111,0,55004,80,0,0,31,0,0
96134,713,44550,61941,507,44688,60470,206,25833,58963
96133,72,0,0,60,0,0,12,0,0
96132,28,30714,30436,16,28750,32113,12,33750,28200
96130,4814,56458,70478,3183,66922,82264,1631,29583,43210
96129,89,0,84006,89,0,84006,0,0,0
96128,354,76902,80245,290,81071,86589,64,46429,51498
96126,77,0,46288,39,57396,59985,38,0,0
96125,45,96406,103776,37,0,105243,8,0,0
96124,136,0,61960,72,73500,96546,64,0,0
96123,13,0,49723,10,68750,55040,3,0,0
96122,1668,49167,66100,886,61875,83662,782,26667,44977
96121,117,73150,69070,97,74150,79136,20,0,0
96120,311,68250,93217,241,87813,99946,70,32344,68014
96119,8,0,0,8,0,0,0,0,0
96118,658,53986,84007,531,55197,89635,127,16588,50916
96117,141,53125,44321,109,53894,46719,32,0,34494
96116,98,54301,67349,30,0,0,68,0,0
96115,97,0,43741,64,0,54734,33,16875,22421
96114,1357,73319,83408,991,75679,89955,366,63478,61142
96113,439,49287,57826,243,49861,57700,196,48669,49572
96112,83,31406,44296,26,0,47558,57,24750,42809
96111,68,0,71504,32,113333,110166,36,0,37139
96110,37,61875,66141,29,61458,65593,8,82500,68125
96109,355,63218,75697,269,61118,67024,86,0,61816
96108,61,81250,76097,36,83333,92339,25,0,0
96107,400,43750,86362,246,62000,106140,154,38963,53223
96106,206,0,64845,127,72386,78939,79,28856,42187
96105,225,41563,56282,70,0,0,155,0,22967
96104,386,41184,57681,233,58977,70621,153,22366,37582
96103,626,68526,90061,415,82721,107981,211,40078,54305
96101,2109,50845,57112,1396,62177,64826,713,28507,38433
96097,4227,42559,59958,2388,51681,68383,1839,33438,45044
96096,283,54844,86780,215,68523,100996,68,26429,40026
96094,2930,54451,86165,1792,63846,113742,1138,25750,41167
96093,1720,45208,54421,917,46741,62467,803,39280,42043
96092,93,62375,92344,55,92969,119416,38,0,0
96091,359,44922,55184,156,51667,58024,203,42031,51508
96090,213,45625,62588,138,72045,77338,75,26875,33233
96088,2326,53654,67577,1460,77637,81106,866,29296,44457
96087,257,41875,70830,191,64896,86548,66,21806,22305
96086,131,41917,51803,59,53750,67451,72,40192,36915
96085,15,53125,86100,11,0,98355,4,0,0
96084,194,31563,46418,149,34375,50562,45,24896,32696
96080,12084,49259,84140,7819,64155,105734,4265,29533,41503
96076,88,27619,36825,35,28512,30743,53,0,40840
96075,157,0,39046,66,0,63326,91,14568,21436
96074,27,45625,68015,10,0,105210,17,31250,46135
96073,1619,101576,119109,1379,111953,130309,240,36538,49929
96071,11,0,0,0,0,0,11,0,0
96069,471,65417,78717,350,81111,87735,121,0,50062
96068,49,0,28696,28,16389,18068,21,41023,32829
96067,3602,49324,74353,1989,59135,75777,1613,37176,70800
96065,126,0,90879,77,0,126416,49,25341,31941
96064,1833,50191,65749,1205,59205,75126,628,35000,42719
96063,99,51250,65014,33,138646,110370,66,0,42338
96062,486,78684,95888,342,94500,108878,144,26250,64689
96061,0,0,0,0,0,0,0,0,0
96059,209,108102,82156,156,112679,95551,53,0,42725
96058,176,39821,59006,84,69044,93111,92,24792,27867
96057,537,43487,63425,302,54464,81028,235,27557,40803
96056,791,59650,136958,549,63424,178914,242,40714,41539
96055,1582,61864,74077,1082,70694,85893,500,28476,42614
96054,129,42386,53256,91,52083,60746,38,0,31995
96052,691,50729,66309,506,62097,72113,185,28051,36429
96051,563,55966,63697,374,56711,61536,189,0,66902
96050,234,28438,47622,100,37500,52170,134,24318,42409
96049,21,0,27971,11,0,0,10,0,0
96048,415,52950,58163,248,56042,77591,167,26458,28879
96047,352,60000,118414,273,89191,145932,79,17813,22520
96046,59,0,0,33,0,0,26,0,0
96044,476,51786,54513,272,58462,65042,204,24667,36749
96041,1179,29198,44417,620,39125,61690,559,15893,24327
96040,33,80875,77033,15,0,0,18,0,0
96039,435,33523,48091,230,37917,49161,205,19583,45832
96038,279,52375,59686,196,58176,70770,83,26367,32770
96037,96,83723,69954,46,0,0,50,0,53052
96035,1528,33750,53131,913,47932,71496,615,17425,25446
96034,140,43750,61126,83,53438,77760,57,29688,34940
96033,202,44167,53356,134,49375,60376,68,27500,35101
96032,1129,51380,63217,754,61250,70211,375,29879,42533
96031,46,23500,31717,27,31250,37419,19,14107,23616
96029,65,44327,59466,55,44712,64560,10,18750,20780
96028,411,40688,62498,249,86250,84342,162,20543,28923
96027,925,56801,69272,671,58625,77825,254,40625,45600
96025,998,36538,47589,548,50703,57043,450,24333,32958
96024,401,48125,70021,200,56875,93169,201,46042,46988
96023,507,33403,45155,310,42143,48703,197,27875,36559
96022,5850,63606,81125,3952,75859,96774,1898,26120,41858
96021,5262,45455,61187,3811,50770,66845,1451,26217,39941
96020,1183,67208,89303,755,83859,116393,428,37333,41515
96019,3949,48586,60451,2659,58175,67826,1290,19338,33019
96017,105,35208,56151,62,35417,42955,43,32250,75026
96016,166,0,50257,116,0,65069,50,0,0
96015,46,0,73443,38,0,0,8,0,0
96014,90,34125,32862,58,45978,43184,32,0,14153
96013,1779,47138,59027,1249,56452,71566,530,17541,26242
96011,87,25089,38755,52,26364,40783,35,18036,30017
96010,36,35278,34967,33,34821,34679,3,0,0
96009,143,47153,78707,91,76250,97155,52,40694,46423
96008,529,64131,75055,393,64368,81988,136,62813,55019
96007,9366,48996,65765,6275,62982,80398,3091,23765,32538
96006,256,51964,61458,152,70781,73951,104,0,43198
96003,18329,57301,76049,10976,74122,90791,7353,37265,50405
96002,12443,60102,78042,8825,65567,84030,3618,38983,54122
96001,13410,58673,83521,8686,75891,100501,4724,33230,46576
95993,12651,74188,104184,9402,84947,116833,3249,45086,63116
95991,14200,54564,71707,9868,60792,79100,4332,32656,46736
95988,3255,53855,65233,2078,70926,80420,1177,23542,36042
95987,1738,72500,90741,1318,79000,96787,420,58000,66846
95986,47,63750,73521,34,0,0,13,0,43300
95984,123,0,38675,68,0,0,55,13125,13896
95983,152,47321,57573,106,65743,63620,46,40625,43639
95982,1164,84500,89219,935,91384,98711,229,48717,48772
95981,10,0,0,10,0,0,0,0,0
95979,170,31667,59875,86,55313,93224,84,13333,25268
95978,62,0,49106,27,30795,43211,35,0,16100
95977,729,62830,68999,391,74375,91292,338,40850,43209
95975,722,68172,63067,490,62069,72506,232,0,28204
95974,0,0,0,0,0,0,0,0,0
95973,13845,73817,100204,9412,86786,114880,4433,40315,63238
95971,2219,58523,78632,1454,86346,93937,765,39316,41270
95970,234,65625,107393,167,0,115490,67,42917,87209
95969,8544,49681,70078,5029,72725,88663,3515,24432,40547
95968,437,31375,45775,298,31333,54168,139,21544,20167
95966,11290,48228,64336,7386,57896,74973,3904,29119,39610
95965,7002,35668,56220,4203,44792,61598,2799,26695,44688
95963,5608,49937,64317,4321,58863,71897,1287,27250,36744
95962,457,0,92249,332,101184,99798,125,0,72197
95961,9171,60348,75194,6660,66040,81427,2511,33539,45035
95960,305,33910,48085,122,80000,61525,183,0,38264
95959,7377,70975,100264,4490,91338,121579,2887,41650,61759
95957,260,60625,78300,184,66250,89441,76,29375,40593
95956,177,0,90741,85,128839,117447,92,63571,66066
95955,549,47083,76866,391,56563,88834,158,0,46332
95954,4533,53547,65367,3021,64247,73057,1512,35965,47695
95953,3236,59875,81110,2624,63320,87245,612,27341,50020
95951,917,51890,55137,681,55069,61669,236,0,35022
95950,187,33309,35712,95,0,45586,92,0,20372
95949,8113,80216,98622,5640,95757,115855,2473,37676,55990
95948,3702,56667,78861,2857,64284,88508,845,36069,43159
95947,811,43194,64113,449,94375,89725,362,25930,32347
95946,3574,68242,84174,2572,82817,94938,1002,29333,48046
95945,11825,51530,74243,6337,65425,90020,5488,32171,52521
95944,70,0,0,12,0,0,58,0,0
95943,260,71250,107035,171,87656,131991,89,44779,52548
95942,709,174028,262244,527,173102,300139,182,0,152513
95941,312,58654,59778,203,59952,59217,109,0,33890
95939,191,46125,58714,119,52875,69248,72,23810,39282
95938,1413,83606,102587,1046,104663,111548,367,44934,72675
95937,622,41125,76765,319,60625,108154,303,23983,41174
95936,56,0,69509,33,0,0,23,0,0
95935,78,0,0,13,0,0,65,0,0
95934,57,0,29421,11,0,0,46,38333,33498
95932,2986,55284,69226,1865,63586,84198,1121,24989,42412
95930,55,0,0,55,0,0,0,0,0
95928,14483,56204,84427,7586,83088,110775,6897,33507,50301
95926,15724,51838,76493,7829,74720,99855,7895,33776,50441
95925,114,21786,29081,65,0,32269,49,0,0
95923,15,0,45107,11,0,53391,4,0,0
95922,231,75795,78212,125,97566,90324,106,59063,63928
95920,129,46875,80452,69,0,102204,60,0,55435
95919,579,78625,77232,412,83819,84917,167,57601,58271
95918,1082,73977,89020,683,92157,108960,399,42781,53872
95917,1135,67730,87506,950,72143,88902,185,47750,57143
95916,505,34050,52898,301,45924,70997,204,17875,22422
95915,0,0,0,0,0,0,0,0,0
95914,278,0,70914,173,0,86899,105,0,44575
95912,1545,64923,84943,1086,73545,102230,459,33827,41846
95910,65,0,45345,42,0,0,23,0,0
95903,321,51940,64339,281,53125,67512,40,0,38198
95901,12260,55128,68098,8147,64469,76748,4113,28145,44182
95864,9767,107115,151969,6998,121440,179359,2769,54253,75145
95843,14602,82000,94304,11867,84665,96869,2735,58059,69451
95842,11367,54146,65635,7993,57087,67487,3374,37200,52999
95841,8067,53866,66691,4896,66316,77072,3171,37044,44416
95838,11233,50161,66335,8773,52528,69902,2460,35857,45839
95837,104,145833,180953,85,157938,209154,19,26771,53989
95835,13900,104404,125371,9994,114833,138708,3906,75129,84216
95834,10771,77404,92930,7156,84951,99148,3615,49470,75507
95833,15179,69798,88150,9890,72766,92868,5289,56390,74904
95832,3241,55734,63251,2669,53135,63525,572,33152,43915
95831,18496,81626,107162,11452,104347,126678,7044,59672,70371
95830,211,116838,177364,161,104635,146318,50,0,277330
95829,8606,97009,107864,6971,104087,114231,1635,61302,72602
95828,17629,56190,71909,13094,59871,71992,4535,31579,62194
95827,7335,63936,81311,4863,70075,87784,2472,55669,63990
95826,15629,65967,81363,9148,75952,94021,6481,44387,58446
95825,15921,45248,59695,7153,41778,62062,8768,43944,54718
95824,8947,40979,53542,6591,41278,56666,2356,27708,36766
95823,23538,50832,67343,17704,54378,72011,5834,31466,42137
95822,16134,61988,79864,10002,72398,93218,6132,41371,53595
95821,15470,47056,73020,8807,62879,85759,6663,35070,53502
95820,13187,55003,69903,7686,56506,75925,5501,49346,55832
95819,8104,113879,135357,4769,148828,160053,3335,75928,97275
95818,9885,88101,117234,5250,118421,145377,4635,67566,83832
95817,6448,52323,63870,2645,62629,79999,3803,31315,50506
95816,9915,70448,94922,2625,130865,157370,7290,57357,71480
95815,9335,42276,58113,5381,44535,59060,3954,32556,49839
95814,7029,37595,61012,1191,59692,82499,5838,32326,55772
95811,3687,69560,89257,824,98929,117788,2863,68054,80500
95776,7763,84856,103282,6042,88720,111131,1721,47688,66790
95765,13136,107776,131583,9898,131040,148274,3238,52729,76447
95762,14987,136203,175355,12353,152069,190314,2634,59242,97098
95758,21946,92222,105509,16401,103824,113323,5545,65193,74161
95757,14415,108507,126759,12293,113760,129109,2122,61601,94535
95747,24318,113991,130719,18544,132384,146091,5774,52083,74082
95746,8019,171325,214164,6574,187124,236857,1445,50028,102892
95742,3727,133710,141363,3102,133542,143781,625,130295,115044
95736,63,56845,80143,63,0,71675,0,0,0
95735,18,91731,115661,12,0,0,6,0,0
95728,152,96310,84201,117,96845,90291,35,0,63837
95726,3391,75213,88007,2296,85417,96401,1095,57386,64621
95724,0,0,0,0,0,0,0,0,0
95722,1964,88125,116501,1507,107571,135813,457,39949,51046
95721,0,0,0,0,0,0,0,0,0
95720,49,0,102308,30,0,146887,19,28854,31921
95717,77,49583,51130,30,82188,98627,47,0,20811
95715,29,0,136407,19,180313,154153,10,28125,31260
95714,174,57500,69240,103,66063,79064,71,33646,48551
95713,4040,75369,88777,2726,94412,103049,1314,37169,57164
95709,2274,71659,97683,1680,83214,109074,594,50263,63843
95703,401,83657,87761,315,83688,93091,86,77308,68238
95701,416,85294,140724,335,100650,160645,81,35852,46511
95699,6,0,0,0,0,0,6,0,0
95698,118,0,153308,53,0,0,65,25677,37466
95697,90,0,55422,53,81544,72385,37,0,31124
95695,14361,68158,93000,10377,74467,101848,3984,45313,57474
95694,3511,87097,127287,2666,100479,136253,845,63229,84623
95693,2305,100479,113906,1720,106000,125196,585,48603,72439
95692,1662,76071,95539,1285,79479,93560,377,54492,90780
95691,13637,80916,105952,9765,97137,116363,3872,53417,72144
95690,689,65742,130590,611,67188,139814,78,54792,57891
95689,588,73864,131355,432,125500,167046,156,32273,32519
95688,13703,98579,124779,10501,114627,138147,3202,61083,68623
95687,22193,92653,109777,15688,105306,121759,6505,58546,72318
95686,368,40333,51418,246,39643,55324,122,31563,35982
95685,2002,56599,85745,1191,71250,112071,811,37667,40612
95684,1208,66702,90110,788,88088,108535,420,22045,51944
95683,2489,111865,129036,1821,131347,145371,668,65938,81626
95682,11227,87974,114665,8112,102530,132850,3115,47147,62520
95681,311,49948,66410,227,59750,78180,84,38152,34602
95680,0,0,0,0,0,0,0,0,0
95679,25,0,0,18,0,0,7,0,0
95678,16677,77437,94941,10716,99515,111050,5961,49254,60849
95677,9706,88897,107541,6593,105352,126679,3113,44805,62951
95675,130,41607,43219,111,42821,46306,19,0,0
95674,278,94722,132231,214,120278,145583,64,61250,74997
95673,4994,72438,85862,3915,80323,92301,1079,38393,49260
95672,2183,111034,145374,1633,138615,167907,550,46384,69089
95670,20765,71732,94061,13874,78772,101398,6891,53585,74385
95669,830,85758,94221,605,96369,109088,225,31328,47375
95668,208,75667,91206,142,95000,109960,66,36667,46297
95667,14053,74324,92397,9317,94436,110514,4736,40074,53259
95666,2023,71648,81815,1262,85167,96929,761,32774,51556
95665,1409,62688,87932,1067,82260,105514,342,24457,32494
95664,534,79375,90411,416,81339,102169,118,32446,42297
95663,1033,120742,146456,803,145101,159045,230,61125,96335
95662,12424,76079,92612,8421,86753,101035,4003,50896,63990
95661,12273,88966,115468,8177,111042,136542,4096,53724,67647
95660,11252,50541,63063,8067,50826,64176,3185,42057,51484
95659,320,54833,87113,184,75714,115304,136,45114,48501
95658,2504,108871,137121,1744,134013,152543,760,39853,94868
95655,1395,94028,106913,1040,116394,126866,355,0,41141
95653,182,42985,36836,156,43470,40929,26,0,0
95652,190,33125,53856,135,32604,57097,55,52784,45900
95651,171,0,133335,115,136964,153015,56,0,0
95650,5570,103669,161688,3870,136436,204457,1700,0,62532
95648,20056,88167,110261,14341,101208,122823,5715,50728,74295
95646,46,124167,103598,23,0,0,23,0,74283
95645,566,44297,58479,428,48000,63205,138,0,27079
95642,2947,63453,77425,1867,76447,91152,1080,25292,48726
95641,730,42174,58448,484,61333,74271,246,19167,27315
95640,4665,69648,84278,3175,85485,100049,1490,26080,46357
95639,108,59167,56356,36,85700,78625,72,0,44169
95638,845,70313,93107,606,108971,116594,239,0,33382
95637,56,52115,85070,43,0,94605,13,0,0
95636,568,52639,63359,438,67647,70995,130,27344,37633
95635,406,62308,64852,216,83455,94760,190,21000,30851
95634,1720,68672,71765,961,75008,79901,759,0,54528
95633,1529,75276,92665,1218,85700,105884,311,0,38359
95632,10358,77351,95578,8252,90346,104118,2106,41435,58812
95631,2668,84265,96955,1943,84779,99371,725,77321,88683
95630,27717,118006,137832,20000,141437,157793,7717,58416,81389
95629,208,0,68617,149,79141,76056,59,35580,49832
95628,15996,89923,116492,10749,109741,136097,5247,55691,72261
95627,1277,81563,107467,1011,82109,114678,266,48750,44785
95626,1848,76607,89141,1474,79500,94304,374,38571,47633
95625,140,85532,85458,0,0,0,140,85532,85458
95624,20006,100453,120651,16507,106635,127541,3499,52932,74012
95623,1515,67961,91524,1095,85268,94439,420,29848,72027
95621,16469,66280,80285,10276,75086,90937,6193,41757,58311
95620,7521,80080,102541,5732,79933,107278,1789,65335,69620
95619,2555,57052,71086,1695,77636,87774,860,24576,34567
95618,9660,100876,136525,6007,143727,172021,3653,49549,75028
95616,17999,61213,97677,7848,135469,160387,10151,32043,47060
95615,295,58909,73195,254,59167,77633,41,0,36602
95614,1675,105919,109205,1175,122755,123352,500,59688,70620
95612,523,117694,119562,403,158750,140506,120,37031,49224
95610,17717,65972,82250,11338,78194,90154,6379,50732,62138
95608,25581,67766,97993,15516,82200,116900,10065,47373,64776
95607,133,76726,134277,115,0,143186,18,0,0
95606,126,56413,79394,91,0,61909,35,0,124860
95605,4749,60309,77700,3178,67787,84694,1571,30175,60825
95604,42,79773,84388,21,0,0,21,0,0
95603,12196,72571,98616,7790,92340,116693,4406,39974,64858
95602,7218,85662,104583,5065,99720,120981,2153,42560,59790
95601,51,42250,90524,34,0,98106,17,0,75359
95595,69,0,223777,50,0,306120,19,0,7079
95589,615,39665,42915,233,62310,67577,382,0,26979
95587,32,0,0,32,0,0,0,0,0
95585,180,21875,40486,105,0,52598,75,15781,17799
95573,549,73051,65594,278,95865,97599,271,21205,32762
95571,57,0,54235,46,0,0,11,0,0
95570,1075,51458,81671,689,72750,97210,386,30625,44724
95569,130,0,105553,71,32465,132651,59,0,72942
95568,60,0,56570,32,41250,57725,28,0,55250
95567,752,84302,107669,553,82645,120546,199,53594,54945
95565,264,32955,51706,158,44375,58516,106,0,34871
95564,210,41875,61896,119,65987,75239,91,36875,44260
95563,298,48864,71909,126,65526,127289,172,30800,29637
95562,1482,39073,57306,815,51108,78677,667,26458,31194
95560,627,63464,76132,376,83835,81812,251,26643,60248
95559,71,25000,0,18,0,0,53,0,0
95558,189,65875,85228,94,77083,109579,95,35469,55389
95556,274,51552,63746,221,0,71251,53,0,30213
95555,138,33333,49088,82,38000,55250,56,25313,33423
95554,152,48409,60626,139,0,62033,13,0,0
95553,395,0,60954,152,121011,112799,243,14538,28524
95552,387,19750,41449,239,0,52146,148,19250,23566
95551,623,61902,88917,332,97222,125116,291,26250,46285
95550,79,86156,77872,16,0,57494,63,86594,83048
95549,366,74931,95547,252,93553,112954,114,51250,51304
95548,439,38092,50565,247,57961,64927,192,16932,31313
95547,451,55521,77942,285,85893,96701,166,31111,43294
95546,1107,28083,52055,737,52731,59997,370,11866,17905
95545,29,0,63910,8,0,0,21,24821,50324
95543,250,32500,39881,153,48403,47884,97,13789,27259
95542,1029,27534,47253,470,36638,42787,559,21354,48517
95540,5481,47392,63562,3419,62102,77792,2062,25058,35256
95537,99,0,0,50,0,0,49,0,0
95536,1169,61081,91040,830,79821,110523,339,31336,42995
95531,8364,48635,65357,5394,63161,75065,2970,29320,45866
95528,629,65096,92973,467,73229,101664,162,41806,62591
95527,241,41328,56445,148,49167,73502,93,33688,29300
95526,130,32500,68683,54,45000,114300,76,28500,36271
95525,672,50833,73828,348,73889,96497,324,37639,46067
95524,761,61792,107616,495,94472,121911,266,26339,74195
95521,8149,42636,65893,3317,74441,89789,4832,26867,47846
95519,7314,56422,74282,4140,71702,91851,3174,37662,46297
95514,45,60450,50771,25,0,0,20,0,37690
95511,77,64954,73709,25,0,0,52,63796,67031
95503,9974,57565,75699,6056,73051,92312,3918,35447,46180
95501,9766,43932,71301,4484,61713,89805,5282,29189,53293
95497,646,78125,101855,365,81763,112456,281,70417,85221
95494,59,0,121275,39,0,111331,20,0,0
95493,63,66838,55495,32,68750,71456,31,0,37084
95492,9915,118773,128386,7787,130481,140006,2128,56288,74506
95490,5533,52406,64544,3094,64097,77302,2439,30461,45337
95488,113,0,71130,36,0,143494,77,0,33471
95486,29,0,0,15,0,0,14,0,0
95485,1131,55276,72295,581,77630,86880,550,26071,46891
95482,11282,56556,81105,7496,67576,89189,3786,30506,59725
95476,15591,87374,125265,9009,102466,141223,6582,60293,99742
95472,12171,95417,120021,7826,110507,138335,4345,53265,78443
95471,265,0,75678,145,31094,49672,120,0,39254
95470,2008,63969,89438,1549,71925,88495,459,28359,87968
95469,578,53000,62084,370,58583,73778,208,28333,41282
95468,594,71563,76249,387,79583,83590,207,36010,61079
95467,2240,67756,82190,1595,79597,93908,645,38580,49155
95466,290,40625,81581,205,0,93748,85,31146,38232
95465,890,65357,94134,398,77083,106738,492,55714,82671
95464,935,50764,52896,574,53837,59070,361,30243,39230
95463,58,61447,68807,21,0,0,37,0,0
95462,639,45417,68883,295,76078,87299,344,27679,52013
95461,1281,52314,82923,697,0,107820,584,41163,52131
95460,1087,58705,83006,604,85294,88425,483,43155,75628
95459,323,52415,80922,186,65714,91051,137,42426,57107
95458,1279,49137,93510,629,53482,62376,650,42321,122060
95457,1325,39875,82242,629,78373,98273,696,26774,66816
95456,390,26127,49943,140,42159,51662,250,22138,44544
95454,1028,35947,42384,565,40496,44740,463,31672,36600
95453,4623,55625,86191,2603,91577,117672,2020,27202,43405
95452,447,92094,103682,150,143333,161126,297,0,74637
95451,4432,54189,82572,2694,67280,99496,1738,41648,52608
95450,119,62679,92249,57,170417,134344,62,38167,45881
95449,508,60192,99102,360,83400,118506,148,38750,48392
95448,6899,95938,139747,4550,116133,168715,2349,57315,77415
95446,2443,75035,99209,1058,105500,131201,1385,53340,73953
95445,968,59109,71206,564,71250,83995,404,52982,51852
95444,168,63396,62990,126,63679,68840,42,0,34626
95443,73,0,30481,18,0,0,55,0,35335
95442,1365,144129,256748,643,161127,235716,722,0,274994
95441,659,111198,141612,447,123523,158650,212,79000,102798
95439,132,0,91283,104,0,100897,28,0,0
95437,6430,46491,65824,3561,58618,76148,2869,35122,48771
95436,2655,75417,101493,1558,97806,115390,1097,55651,71931
95435,88,0,0,73,0,0,15,0,0
95432,278,0,77562,170,0,91434,108,0,55726
95431,0,0,0,0,0,0,0,0,0
95430,13,0,0,0,0,0,13,0,0
95429,45,0,107811,32,86346,139809,13,0,0
95428,1017,41096,49932,645,46587,52066,372,22212,41465
95427,200,45722,72372,171,36607,73280,29,0,0
95426,474,95369,85975,331,97734,102724,143,0,28537
95425,4394,81905,111779,3067,97011,128092,1327,40282,70881
95423,1584,46833,68127,1014,57279,81968,570,34630,40153
95422,5970,36623,47453,3413,43165,54491,2557,26568,33329
95421,700,61691,85495,339,88750,109359,361,48750,62490
95420,91,132992,188578,91,132992,188578,0,0,0
95417,89,65875,73807,37,0,0,52,57031,64481
95415,402,43864,78065,282,53125,87894,120,0,53976
95412,189,69375,74835,114,70781,77050,75,0,71469
95410,393,70972,112835,169,98698,146604,224,37708,85240
95409,12031,77849,112960,6872,108950,137535,5159,48417,77072
95407,12851,68720,81767,9365,73572,84190,3486,46367,64737
95405,8955,94411,114468,5913,113375,134050,3042,62355,71756
95404,15647,86555,118799,9364,108986,144615,6283,58750,74455
95403,15871,79990,97436,10108,95940,112338,5763,48432,62955
95401,13817,80164,100301,8603,91292,112034,5214,52903,71377
95391,5328,160902,164452,4807,152228,163078,521,107591,108118
95389,341,39097,58962,81,57026,72591,260,35921,54717
95388,4091,48750,64202,3310,51599,67698,781,29718,41018
95387,161,53229,53330,161,53229,53330,0,0,0
95386,2988,59833,79464,2408,68289,84559,580,50603,45728
95385,165,70189,62423,81,71250,76637,84,30978,42712
95383,1842,75313,115451,1092,74716,101217,750,74875,133148
95382,13215,75333,93076,9397,84236,103872,3818,41648,55823
95380,15269,48137,66168,10615,53708,73345,4654,27091,44131
95379,1762,56625,67237,1085,62334,81489,677,33680,40286
95377,8861,119614,135084,7607,125785,140321,1254,90871,89203
95376,16916,84670,98897,13004,88636,102914,3912,50385,71048
95375,0,0,0,0,0,0,0,0,0
95374,507,51845,135096,427,57750,153966,80,11932,21073
95372,627,82979,86288,456,113906,103077,171,45865,39892
95370,12286,62578,83665,7318,84275,102479,4968,36672,53551
95369,458,68000,65842,251,68125,76315,207,65781,52368
95368,4268,82752,93391,3467,87078,99527,801,52660,59041
95367,7425,70248,86370,6014,76408,92481,1411,36203,46470
95366,6663,86116,106485,5161,99768,119126,1502,39219,57553
95365,1149,45640,51844,913,46472,55396,236,0,25510
95364,0,0,0,0,0,0,0,0,0
95363,7847,72898,89980,6608,76403,92314,1239,51750,65959
95361,12420,75138,100728,9002,88827,114522,3418,31299,54679
95360,4121,64036,83537,3425,66603,87759,696,39662,53789
95358,8479,62244,78114,7185,63080,79685,1294,50779,58421
95357,4073,82886,104711,3331,97957,114129,742,45000,56196
95356,10951,76225,105809,7906,88707,118295,3045,48567,66322
95355,20828,67205,89168,14841,79471,101478,5987,41202,52960
95354,8701,52352,67389,5673,60904,73550,3028,39118,50975
95351,13441,44517,56473,10810,48170,59121,2631,21509,32163
95350,19488,57291,75779,12835,64073,84472,6653,37134,55391
95348,10889,51340,64254,7175,58160,68477,3714,38320,49128
95346,529,77557,88240,312,116500,110203,217,55814,56663
95345,426,33889,43568,212,0,51325,214,0,35106
95341,9005,46547,67285,7562,47750,68984,1443,27269,38030
95340,12120,56941,83529,8142,68995,94312,3978,31734,51813
95338,4781,52280,68346,3229,62528,78290,1552,27206,44481
95337,12304,86414,103772,9569,93419,113359,2735,49283,63685
95336,15490,70084,86861,11387,77039,92754,4103,45987,61621
95335,69,0,0,31,0,0,38,0,0
95334,4306,59412,70286,3496,65495,74250,810,32026,48624
95333,771,53125,80965,622,59886,89131,149,0,40848
95330,5904,89653,101641,5104,91473,103502,800,47500,67405
95329,1109,57058,75605,693,83472,94831,416,27125,40325
95328,1103,46277,58190,916,50880,65663,187,13877,21312
95327,2675,43313,77571,1359,70246,90079,1316,22681,61529
95326,3875,75388,87363,2744,76864,92735,1131,70545,70966
95325,33,0,0,33,0,0,0,0,0
95324,2811,70045,92453,2070,63986,95638,741,40852,68936
95323,449,75197,84813,373,77054,92370,76,0,46174
95322,3287,60478,74829,2466,52899,78960,821,40432,39706
95321,1702,55966,86068,927,73098,98019,775,30750,68572
95320,4728,64508,102601,3297,86088,121807,1431,55620,56531
95319,590,34784,42942,334,45700,54189,256,0,28268
95318,169,45988,52463,30,86618,93797,139,45544,43542
95317,302,47109,83258,277,52656,88219,25,25000,0
95316,2542,82275,102322,2045,83897,106084,497,81966,86027
95315,3777,62533,76891,3229,64812,76702,548,35000,70386
95314,0,0,0,0,0,0,0,0,0
95313,468,41071,73390,256,68971,75638,212,28750,67877
95312,54,66429,67335,41,51875,69820,13,35938,44992
95311,982,40577,56779,524,58182,75584,458,24455,32958
95310,872,34958,54697,475,55966,78104,397,22232,25579
95307,12681,61287,73885,10278,64782,78433,2403,26454,39296
95306,413,39353,52872,253,47396,62966,160,0,36911
95305,0,0,0,0,0,0,0,0,0
95304,4147,92721,130624,3117,108045,146524,1030,54605,67644
95303,354,115500,206217,248,117500,229377,106,0,147031
95301,12719,60993,82815,9911,67544,89916,2808,36416,47820
95258,1465,94464,117035,1132,111005,133982,333,54107,58980
95257,155,72014,82189,123,88417,88298,32,54100,58706
95255,685,42083,53080,426,44444,66028,259,23477,27164
95254,277,101745,114403,189,105432,119476,88,101250,103509
95252,4959,81289,94065,3893,89859,102991,1066,44219,52727
95251,254,61316,89473,174,100288,113826,80,0,33258
95250,14,0,0,14,0,0,0,0,0
95249,1856,33138,54138,1473,36008,59262,383,12422,23416
95248,57,0,39721,49,0,30790,8,0,0
95247,1640,56313,80964,1026,85571,97828,614,38750,51685
95246,511,72841,85329,409,94519,97967,102,37083,34654
95245,745,70325,77776,470,71883,96888,275,28828,45112
95242,10077,75491,110359,7377,93393,129781,2700,42391,52317
95240,16499,55933,73487,11385,61794,80786,5114,36282,52137
95237,1346,71979,85015,1024,81563,94889,322,37000,49227
95236,1643,74613,102880,1209,72359,107555,434,59167,76895
95234,0,0,0,0,0,0,0,0,0
95233,118,114861,126335,82,120952,146821,36,0,79672
95232,49,62361,81680,16,0,0,33,0,93561
95231,808,54615,71984,631,78657,80865,177,26016,36121
95230,231,90417,111029,177,102841,131446,54,25948,33822
95228,1682,84885,106521,1302,86056,109067,380,63017,91624
95227,241,99671,141039,210,137143,147528,31,85375,74410
95226,0,0,0,0,0,0,0,0,0
95225,257,85532,77767,213,85904,79676,44,0,0
95224,98,0,74857,61,0,95128,37,33750,41438
95223,1311,61331,88379,745,84811,112142,566,32464,55681
95222,2345,53674,79952,1553,81326,99597,792,27653,38332
95220,2596,94740,113988,1896,100842,122683,700,54677,88169
95219,10720,82078,115213,7650,90903,128047,3070,58667,80402
95215,6828,49758,69481,5325,52623,76348,1503,24797,36356
95212,7411,97775,120796,6267,104588,129811,1144,0,49999
95211,0,0,0,0,0,0,0,0,0
95210,11709,48614,62670,9096,51660,64948,2613,28107,40364
95209,12948,84387,100730,10329,87698,105713,2619,55378,70541
95207,18401,54951,73705,12209,62434,81569,6192,35687,50601
95206,17384,53830,69687,14026,58071,73011,3358,30271,42061
95205,10415,39013,54050,7794,45236,58841,2621,21353,31430
95204,10965,56041,78920,6848,64720,92556,4117,35225,49998
95203,5357,46892,60568,3340,51285,63967,2017,36775,49345
95202,2912,17270,36931,1024,27362,58691,1888,12242,22952
95148,12269,143641,162601,10972,145562,163462,1297,102622,109338
95140,45,0,68869,12,0,0,33,0,31852
95139,2136,157500,156742,1790,163269,163280,346,61184,87051
95138,5773,166895,232835,5041,182205,244763,732,99118,126463
95136,15687,119081,144240,11791,126276,152975,3896,90538,106115
95135,7735,160901,192944,5998,197019,225084,1737,57806,76502
95134,13171,153719,171370,7145,158552,176494,6026,140076,159630
95133,8480,98386,123618,6540,98017,125404,1940,71439,98511
95132,12183,130078,156061,10090,142099,164212,2093,62044,90584
95131,9869,139427,166227,7603,144797,171800,2266,113636,134675
95130,4714,143125,176469,3720,171310,195719,994,65615,99358
95129,13956,157747,193669,10602,182908,217516,3354,68700,108527
95128,13771,100198,133920,8172,120341,152514,5599,70417,99988
95127,15787,104518,125203,13139,107134,129641,2648,46975,71968
95126,14843,108503,148402,8166,128300,172191,6677,87512,114291
95125,21335,121428,181865,13665,161979,220976,7670,66294,106958
95124,17445,158484,193498,14021,173175,213100,3424,64808,104161
95123,23446,121404,140056,17210,135712,151602,6236,76481,98522
95122,12010,84335,104931,9916,87045,102246,2094,50785,76635
95121,9823,111105,132306,8589,114488,136918,1234,54625,69677
95120,12714,207959,243160,10764,228627,264580,1950,65952,116525
95119,3429,122944,151296,2606,126705,160346,823,104961,118226
95118,11277,123250,156462,8458,145903,170765,2819,73702,104594
95117,10946,104160,145782,7611,115374,164250,3335,64772,88925
95116,14072,70656,90428,10674,73759,94951,3398,40044,63405
95113,1426,131094,174008,605,193224,231803,821,101719,125342
95112,20607,74019,102761,9612,84038,113178,10995,58811,88520
95111,15760,77009,102605,12863,79864,107732,2897,38815,62239
95110,6456,98209,135188,3796,94692,119142,2660,84938,149129
95076,23451,76010,100749,18632,79063,102329,4819,53285,81527
95075,130,128750,154645,113,129375,162040,17,0,105488
95073,4104,96052,130349,2615,117229,151528,1489,58270,82952
95070,11187,201279,274968,9338,231828,298404,1849,81750,146780
95066,5975,109894,150159,4072,152944,174487,1903,53750,89241
95065,3055,116208,149192,2030,124531,166642,1025,65804,100506
95064,518,86250,89341,270,106563,96482,248,0,81449
95062,15250,88204,117539,7922,114394,140186,7328,58312,87881
95060,19030,87159,124654,9526,143654,169876,9504,40095,73018
95054,8136,158212,185715,5700,158250,197457,2436,149571,153785
95053,0,0,0,0,0,0,0,0,0
95051,21613,150094,183107,15125,163034,200604,6488,106658,137435
95050,14160,102000,131331,8633,118681,146714,5527,69861,97959
95046,1789,123818,147573,1424,131953,153405,365,59479,107385
95045,1473,81886,107307,1140,94688,120045,333,54547,60105
95043,290,105625,179453,185,107125,233670,105,82188,83930
95041,98,57734,50313,69,58086,57210,29,0,33903
95039,316,41154,61648,239,50433,49109,77,34583,64048
95037,16586,128381,159410,13271,140796,172324,3315,75210,96585
95035,22207,136966,162133,17641,139951,169404,4566,94576,116023
95033,3777,168723,216876,2803,207361,243152,974,104886,126724
95032,9868,153214,220673,7157,185229,259676,2711,96484,109660
95030,5239,199063,313351,3811,"250,000+",378075,1428,90909,124457
95023,15932,86047,106234,12889,95642,111816,3043,51725,67492
95020,18154,108494,136348,14383,119786,147419,3771,58463,80653
95019,2296,59256,67905,1740,63407,76270,556,18287,27621
95018,2684,109467,131388,1677,119547,154169,1007,78177,84580
95017,271,59609,103423,152,70556,122051,119,0,75117
95014,21199,179702,217920,16219,212071,252541,4980,68779,98404
95013,16,0,0,16,0,0,0,0,0
95012,2359,69528,81835,2040,67429,75931,319,52961,75529
95010,4133,81095,102400,2213,98613,133500,1920,61189,64901
95008,18038,121231,160128,11724,142500,185337,6314,82754,105376
95007,145,0,69139,145,0,69139,0,0,0
95006,3803,111792,131877,2573,125334,143403,1230,51489,98650
95005,2825,87860,125280,1821,106382,127567,1004,61842,91364
95004,1240,114063,150634,1078,131579,160821,162,40227,58474
95003,10028,115633,155261,6996,139365,177294,3032,67747,96154
95002,558,100000,130474,428,94848,124688,130,0,125878
94973,709,120825,134071,404,201316,184282,305,46738,67561
94972,56,0,0,43,0,0,13,0,0
94971,87,109063,234246,61,177813,316044,26,0,0
94970,337,122721,132674,98,134219,178430,239,97829,113913
94965,6157,108901,165879,2700,150000,204623,3457,93750,133853
94964,134,97932,76404,40,0,0,94,0,0
94963,80,146563,175684,64,163158,211142,16,0,0
94960,6381,148163,219696,4472,192857,263224,1909,68369,111116
94957,410,"250,000+",312914,333,"250,000+",335600,77,0,145891
94956,632,76818,117209,307,132865,165282,325,53092,69692
94954,13878,95724,117619,10075,117991,135243,3803,46738,62068
94952,13834,92314,131389,8848,113063,154471,4986,57292,84013
94951,1639,96155,113137,1071,109154,134994,568,54474,64926
94950,57,153220,139467,57,100720,109191,0,0,0
94949,7233,96356,138362,4195,145352,173860,3038,60787,86660
94947,9882,111285,142513,7006,132500,159370,2876,71806,93395
94946,306,112083,239034,214,172143,289137,92,74750,119192
94945,7282,120692,149509,5175,137449,167433,2107,58551,98533
94941,12991,166934,246206,8616,224052,301357,4375,83640,130043
94940,81,0,261521,73,0,269759,8,0,0
94939,3205,136604,200429,1753,192321,263074,1452,92879,116697
94938,394,110789,123114,193,141250,134917,201,76771,111781
94937,480,74500,115988,255,108854,156040,225,51554,67672
94933,380,109953,122142,206,91768,129019,174,109792,100045
94931,3400,85698,100991,2073,99867,122871,1327,42476,56819
94930,3736,109044,127765,2287,133072,156490,1449,53443,69202
94929,118,171477,198446,100,172500,221993,18,0,0
94928,16241,78181,98961,9628,92788,112333,6613,53874,72210
94925,3823,153101,209935,2675,207829,256029,1148,69203,98591
94924,580,86806,131556,269,128922,138262,311,44007,108476
94923,545,66975,134882,282,153947,219845,263,50030,43781
94922,187,112244,168801,163,112244,176499,24,0,0
94920,5026,197000,329223,3751,247768,385605,1275,85038,151390
94904,5599,135972,243181,3551,222467,320684,2048,64364,105618
94903,12582,106919,147301,7493,141769,179663,5089,58469,97095
94901,15784,99136,148419,9451,129208,179811,6333,67578,93082
94850,0,0,0,0,0,0,0,0,0
94806,19732,68012,82221,14357,74718,88432,5375,43684,57186
94805,5450,89443,118121,3318,99863,130196,2132,75263,89198
94804,14466,63764,82780,9559,66079,87162,4907,50390,68621
94803,9131,96971,116324,6810,105543,123799,2321,61036,82305
94801,9407,66476,85983,6639,69172,90452,2768,44915,63206
94720,15,0,0,4,0,0,11,0,0
94710,3297,97917,122967,1799,108576,141774,1498,75536,88858
94709,5209,75721,104760,1766,132941,164079,3443,55275,73397
94708,4715,192577,242387,3259,217608,272091,1456,114667,167299
94707,4843,161332,216220,3236,213167,267782,1607,77656,105276
94706,8129,107669,138386,5628,124704,155853,2501,78404,94647
94705,5746,139029,207284,3124,200357,284194,2622,75000,106963
94704,8670,46735,69498,2060,72333,108551,6610,31558,55603
94703,8617,87114,127085,4221,123736,156947,4396,56667,90385
94702,7256,85357,118414,3772,122134,151160,3484,58667,78439
94621,9543,40813,61648,6563,46932,64569,2980,24392,44955
94619,9017,106875,137988,6184,120469,150389,2833,75112,106796
94618,7136,169856,221698,4129,224960,272507,3007,107524,143481
94613,11,0,0,11,0,0,0,0,0
94612,8988,59773,100936,2480,55333,130488,6508,59091,88436
94611,16854,136538,193602,9477,198966,255062,7377,79078,108820
94610,15290,104919,149245,6286,163409,212382,9004,82605,103041
94609,9933,95693,131795,3970,115655,168377,5963,84454,103749
94608,14345,95716,119260,5867,111901,138459,8478,81577,101490
94607,11121,60181,99298,4897,52538,91580,6224,64605,103336
94606,15054,63188,83477,7518,69912,88688,7536,55392,73900
94605,16022,77939,108881,9941,98176,123621,6081,49860,79154
94603,9613,55692,71028,6839,59836,77255,2774,37580,46185
94602,11532,107208,144087,7077,131856,166090,4455,71503,101911
94601,15118,53433,75541,10218,55813,76571,4900,41259,62547
94599,1428,65962,102411,690,75833,145574,738,36761,61369
94598,10327,156280,203326,7581,182114,222555,2746,89150,145992
94597,10708,121067,137495,5472,148472,166245,5236,79484,103686
94596,10256,115938,150006,5910,136596,183492,4346,85417,102794
94595,9702,78874,126543,4457,128615,185431,5245,50920,74525
94592,414,171000,170959,168,170625,173486,246,0,165174
94591,18612,91380,108436,13918,102723,118549,4694,54842,68539
94590,14534,57254,71632,8515,67154,80634,6019,39656,54818
94589,9466,71715,86526,7281,73123,86097,2185,43393,71302
94588,12616,157203,192945,9810,188682,219360,2806,78548,95555
94587,21723,120772,140262,17889,127014,148359,3834,66250,87033
94586,284,164063,290452,223,215114,331972,61,114306,114852
94585,9254,81683,94259,7028,91052,101674,2226,52672,59359
94583,13044,159414,182899,10518,174394,196734,2526,98354,118820
94582,15095,186021,207249,11653,216662,232363,3442,80580,119058
94580,8794,96581,112983,6672,107933,124148,2122,51044,63856
94579,6594,91201,106996,4976,96124,114878,1618,44837,71027
94578,14357,71758,87182,9355,74640,92329,5002,45169,66005
94577,17261,89219,110620,11300,108680,125578,5961,57303,76708
94576,66,0,137594,24,0,81483,42,0,169657
94575,0,0,0,0,0,0,0,0,0
94574,3931,104848,188872,2338,134150,240229,1593,64095,111226
94573,23,0,0,23,0,0,0,0,0
94572,3303,78175,104145,2539,88996,112612,764,44955,65569
94571,4939,68617,79658,3022,80194,91708,1917,50042,59787
94569,156,0,82815,53,0,0,103,0,62282
94568,19065,148083,177533,14683,160380,191606,4382,93359,118141
94567,263,53813,95604,185,54107,109969,78,44773,52651
94566,15685,163499,212056,12415,181766,237597,3270,75000,102895
94565,27807,78985,99212,21904,82043,100175,5903,49503,72767
94564,6750,105217,118921,5028,114483,128156,1722,62115,79174
94563,7109,231373,323689,5472,"250,000+",344254,1637,90136,240541
94561,12621,102911,113436,10318,107478,120207,2303,33229,60916
94560,14356,127619,149431,11785,132526,153947,2571,90676,108264
94559,9943,76960,109756,6164,85022,118793,3779,58081,86753
94558,24027,97759,126309,16859,115126,144284,7168,51090,77321
94556,5623,152965,220772,4136,192727,262919,1487,66125,97703
94555,11463,161175,192815,9775,179429,206777,1688,88864,102835
94553,19096,106557,128626,13015,128338,144298,6081,63330,89272
94552,5137,180681,212614,4208,186406,233881,929,81563,107004
94551,16521,119087,148746,12219,141612,167579,4302,61721,85146
94550,18335,150061,181637,13964,169556,200946,4371,89614,107822
94549,10830,185950,247408,8365,220298,280481,2465,83584,117838
94548,127,150492,162863,59,0,196631,68,150682,133566
94547,8980,110669,129898,6688,125933,141358,2292,56304,84433
94546,15922,101445,120535,11254,116567,138092,4668,55899,71253
94545,9668,88764,118818,7421,100417,131115,2247,34774,63576
94544,22482,89657,106466,17427,96135,110860,5055,59771,77322
94542,4321,115956,148157,3202,121310,160854,1119,97750,102977
94541,21187,82690,102112,14188,93559,113421,6999,54259,69166
94539,16458,188596,217764,14840,199673,229462,1618,83438,101108
94538,21690,119206,138560,16393,131170,149167,5297,65139,95057
94536,24879,132568,155530,19381,152568,172584,5498,62868,85316
94535,924,70943,77188,915,70758,76391,9,0,0
94534,13121,115561,142552,10075,125611,157705,3046,73538,83458
94533,24396,75544,90293,18227,82869,95853,6169,48642,58004
94531,12049,104275,117533,9596,110714,122165,2453,69115,80162
94530,10499,107621,141031,6778,132279,166000,3721,65949,91400
94528,346,"250,000+",297600,292,0,266748,54,0,0
94526,12647,163801,213334,9791,192237,243415,2856,73351,105231
94525,1434,89630,99205,774,101176,113323,660,66510,74614
94523,13859,124375,143603,8841,143779,165553,5018,79897,97014
94521,15977,104141,125561,11203,120840,144710,4774,62788,73530
94520,13416,68756,83329,8285,72900,87625,5131,56870,69723
94519,7082,105774,122386,4975,112813,130121,2107,58958,97216
94518,10548,95961,118338,7261,109715,133669,3287,68138,79271
94517,4467,145426,181019,3508,161833,197474,959,55417,108426
94516,79,102917,126935,56,0,140014,23,91528,95091
94515,2772,85263,165466,1939,93012,207524,833,55703,57415
94514,527,82538,112124,447,84735,115504,80,38587,56319
94513,21300,112302,128785,16869,120783,141369,4431,49987,70060
94512,18,0,0,0,0,0,18,0,0
94511,837,62019,75695,405,101250,106369,432,38750,46681
94510,11496,106739,128190,7767,124518,146989,3729,61009,80234
94509,21744,68224,84243,15629,73257,88482,6115,52904,63775
94508,1059,111750,145175,719,128792,157233,340,67083,110470
94507,4815,"250,000+",314706,4063,"250,000+",334251,752,122895,197206
94506,9274,200726,266239,7763,222526,295410,1511,84313,113413
94505,5450,128865,151675,4405,133880,155165,1045,91477,128736
94503,5147,108638,129990,4372,114942,136183,775,45491,73336
94502,5037,161518,183523,4107,179323,201046,930,64013,82586
94501,25477,96014,130880,14908,118240,154659,10569,71460,91744
94404,13818,155789,190559,9605,180701,213378,4213,101543,134144
94403,16506,139631,181768,11067,165748,209464,5439,83933,117196
94402,9872,163442,224827,6624,210188,266060,3248,104500,135769
94401,12689,94334,126131,7536,103985,138651,5153,74719,100566
94306,10641,167043,220341,6992,220024,255805,3649,91832,147217
94305,3505,62515,147022,1150,237330,305721,2355,43266,69182
94304,1935,143412,242185,1077,154353,274923,858,109167,201090
94303,14360,120754,183192,11007,135598,201740,3353,81661,112306
94301,7102,169270,275325,4361,236134,348420,2741,79557,152641
94158,4406,160236,208466,2326,196791,263505,2080,127389,146918
94134,12520,82810,118831,9046,91552,120941,3474,57347,95493
94133,13247,68423,127999,6046,73910,142872,7201,65120,114550
94132,10864,82557,121943,5430,107585,143821,5434,63149,94844
94131,12888,172785,209605,6870,201786,243008,6018,125570,163961
94130,646,59211,106234,378,35815,65103,268,170000,159683
94129,1291,198194,226797,799,210469,258765,492,142188,169140
94128,0,0,0,0,0,0,0,0,0
94127,7529,176025,232236,5357,201642,248926,2172,98333,179038
94124,11148,67094,99905,7740,71584,102433,3408,45031,80453
94123,13172,179143,253801,4509,"250,000+",384175,8663,152091,184071
94122,22647,122144,154450,13196,140816,169842,9451,89789,122561
94121,17809,107158,149569,9840,136412,185435,7969,74691,99881
94118,17508,132201,192308,8645,184321,254750,8863,100082,123292
94117,17871,167807,206422,6641,197773,256703,11230,137865,174458
94116,16019,119800,168985,10806,136200,188047,5213,71703,115028
94115,17000,125550,176143,5364,184808,249985,11636,108235,140986
94114,17000,162529,218715,6352,214900,282297,10648,134395,177588
94112,23090,105340,134095,17323,107945,134260,5767,68768,103924
94111,2218,141230,181880,984,159000,185176,1234,137786,179090
94110,27069,138890,184753,12814,142785,200974,14255,121809,163091
94109,33011,98567,148588,8710,152850,208854,24301,82931,124806
94108,7298,64908,104918,2611,51734,112871,4687,71231,100142
94107,14133,166430,212666,6078,206667,238460,8055,150604,191864
94105,6522,"250,000+",335851,2620,"250,000+",439613,3902,203002,264458
94104,228,56944,159164,80,0,205396,148,0,134174
94103,15918,87587,131159,5262,107222,151313,10656,72275,117098
94102,19089,53539,99235,4838,76662,135350,14251,41518,85855
94089,8351,130164,169449,5016,137857,168678,3335,115573,164030
94087,19605,168228,219732,14853,189877,243253,4752,92078,133155
94086,19415,145103,179331,12234,157402,191861,7181,121822,151061
94085,8484,150915,184672,4953,139519,183382,3531,159250,180413
94080,21551,106352,140295,16145,114081,139610,5406,75981,132148
94074,67,167813,295655,58,168750,331819,9,0,0
94070,11200,190872,254809,8125,233442,291149,3075,105042,145504
94066,15195,112933,137476,10477,129383,153637,4718,74311,91226
94065,4780,173760,217160,3079,202731,254148,1701,123458,144320
94063,10724,80313,127719,7073,74068,127047,3651,86806,121592
94062,10126,184479,268313,7312,225684,313008,2814,102308,142461
94061,13332,119370,165799,9318,135385,184369,4014,77331,108314
94060,346,113056,186177,218,124688,236303,128,97361,100807
94044,13833,130327,147807,9774,144953,164009,4059,77456,102233
94043,12860,145994,189539,7306,181618,220890,5554,102661,143627
94041,5949,149291,194946,3245,175547,230422,2704,127321,149765
94040,14408,139717,199021,8172,178664,249100,6236,105833,130953
94038,1125,110448,155565,790,150673,185657,335,72250,75537
94037,1023,167888,210671,810,205845,236873,213,81528,111027
94030,7959,126319,163425,5642,138584,183834,2317,59375,103940
94028,2556,221667,354021,1854,"250,000+",418180,702,110938,148395
94027,2252,"250,000+",482454,1885,"250,000+",496338,367,109702,320720
94025,15194,169352,252939,10316,204557,299131,4878,92935,149082
94024,7797,247604,347690,6745,"250,000+",379920,1052,97647,128051
94022,7170,"250,000+",359982,5609,"250,000+",407028,1561,99185,177126
94021,113,246133,474159,59,0,0,54,178295,636239
94020,804,183642,206700,547,218125,225274,257,152284,132560
94019,7362,140460,199287,5303,169226,221280,2059,89511,122900
94015,20542,100208,123675,14633,111936,133641,5909,62184,80035
94014,14171,98879,117505,10562,104125,123053,3609,53958,77099
94010,15899,158316,264264,10976,212857,328767,4923,81347,115630
94005,2039,114583,218803,1103,152583,195524,936,97969,245104
94002,10404,159599,203958,7234,211207,247735,3170,81080,97588
93962,169,0,155031,95,0,136551,74,0,0
93960,4147,65108,78757,3550,65791,81082,597,26172,49973
93955,10986,68772,86464,7378,76303,92487,3608,40354,64705
93954,100,56111,61737,91,47125,58531,9,57813,48711
93953,1710,143750,201769,1151,190368,247405,559,86983,103365
93950,6977,89088,115489,3958,125690,147270,3019,60830,71833
93943,0,0,0,0,0,0,0,0,0
93940,13947,85765,121753,6970,120170,159011,6977,63966,81850
93933,8988,73856,92085,5632,85512,104398,3356,45278,63577
93932,223,75446,75953,142,76786,73015,81,53828,81102
93930,4416,57007,75623,3866,49293,66163,550,54184,94882
93928,19,0,0,19,0,0,0,0,0
93927,4031,63696,73138,3547,64975,74480,484,31477,43960
93926,2320,70057,78139,2105,71747,79033,215,31781,37908
93925,396,50987,73590,358,49844,66891,38,0,69768
93924,2638,127813,174653,1670,152760,195327,968,55291,117504
93923,5375,108424,184206,3459,158164,229712,1916,45811,75374
93921,1643,93234,124628,828,154365,184763,815,51477,63535
93920,568,46429,74310,328,53698,92988,240,34911,48523
93908,4279,143750,177083,3391,151185,184283,888,88667,131951
93907,7034,86380,112939,5561,92449,122354,1473,46550,59655
93906,17076,75373,95731,13787,76628,99281,3289,47466,66142
93905,13227,57081,71979,11522,53980,68214,1705,35684,45039
93901,10077,72434,90784,6857,80487,100925,3220,50357,64039
93730,4404,125804,172378,3520,149865,197130,884,50333,72963
93728,5876,38091,53747,3471,42770,59130,2405,27760,43682
93727,24810,62413,82509,19114,74236,91082,5696,30752,44647
93726,14279,43651,54900,9133,46551,57593,5146,30519,43663
93725,6812,52477,66929,5564,53218,68102,1248,27000,42603
93723,3524,86833,101621,3009,91644,106216,515,37404,68066
93722,25326,62225,79519,19474,65590,81640,5852,46973,61330
93721,2352,28101,41858,906,35810,54210,1446,17482,33492
93720,17935,91096,111026,11532,102184,126343,6403,63842,77662
93711,15941,74979,120838,10133,95514,144899,5808,54226,75820
93710,11752,54004,65499,7220,62331,74404,4532,33295,45983
93706,11549,31854,49995,8101,37496,55841,3448,17005,30475
93705,12330,44509,57919,8184,44788,55830,4146,39457,51406
93704,11644,60362,79169,6907,71917,94979,4737,34325,50791
93703,10331,32170,46753,6655,40768,51279,3676,20968,28659
93702,12112,30473,43872,8976,32920,46628,3136,17628,27033
93701,3670,23356,31729,1949,23900,35090,1721,21656,24431
93675,1326,57321,75896,951,75854,83694,375,25755,54610
93673,169,46406,50421,146,45000,49522,23,25000,30200
93669,87,0,53029,63,68125,63692,24,0,0
93668,309,50063,77668,291,46250,76671,18,0,0
93667,753,62446,80669,537,102981,97498,216,36053,36603
93666,267,25990,32429,214,30385,34742,53,11563,11202
93665,175,30844,38790,110,0,49275,65,0,0
93664,220,106071,107255,137,139688,133404,83,51094,64092
93662,8929,43894,58573,6815,48616,63410,2114,21211,30887
93660,949,39625,48970,878,43710,50864,71,16023,16679
93657,10734,60689,81664,8763,67437,86924,1971,22559,38874
93656,1604,51830,63559,1476,51964,64161,128,20625,32046
93654,8738,52642,70223,7291,54688,73411,1447,27850,41732
93653,586,83462,103013,412,100000,121178,174,38438,58254
93652,161,38438,53964,117,38083,55909,44,36827,39234
93651,781,90482,105369,639,77404,109968,142,91214,84673
93650,941,38616,42909,585,43906,44693,356,32143,39126
93648,4146,38724,51058,3499,41464,50595,647,11185,39606
93647,2906,41402,60480,2660,41705,59869,246,24024,54587
93646,2996,27909,45997,2540,29530,49307,456,15412,20213
93645,54,0,0,54,0,0,0,0,0
93644,3287,55678,80191,2064,64167,89074,1223,35065,60662
93643,1248,59452,67766,869,62565,72083,379,31350,53874
93641,150,0,53073,47,0,125332,103,25000,20100
93640,2971,35982,43079,2534,36731,43008,437,21023,24999
93638,12432,49021,63696,10640,47553,62460,1792,28056,49246
93637,12029,61422,75864,9618,69014,79931,2411,35281,52691
93636,4076,99643,108334,3348,102195,115404,728,52683,66730
93635,11463,63529,80909,9216,70823,84589,2247,38210,58526
93634,2,0,0,2,0,0,0,0,0
93633,0,0,0,0,0,0,0,0,0
93631,5049,72786,96448,3891,87455,111845,1158,23316,41056
93630,5491,62706,78520,4245,68569,80679,1246,29167,62031
93628,237,0,38363,48,0,0,189,0,0
93627,19,0,0,19,0,0,0,0,0
93626,849,90703,127885,660,99750,133891,189,41603,105710
93625,2442,58690,73453,1862,69389,81761,580,27171,41947
93624,170,35000,40685,140,38036,43438,30,27500,27480
93623,23,0,0,23,0,0,0,0,0
93622,2529,38391,56953,2183,39089,59086,346,31917,33655
93621,37,0,0,37,0,0,0,0,0
93620,2621,45257,74933,2103,46901,78095,518,36310,53841
93619,13401,117146,141144,10981,132357,152278,2420,74520,84213
93618,8294,46804,62696,7276,45070,61154,1018,35645,47718
93616,676,43281,57260,573,44141,58031,103,0,48891
93615,1490,46886,51644,1336,38750,48162,154,26481,28534
93614,4673,72446,87567,3505,79090,96000,1168,38564,59246
93612,13424,46892,66414,8422,53900,77485,5002,33683,42707
93611,15819,98228,121441,12797,106327,130283,3022,59605,74187
93610,5016,57689,72926,3664,61667,79164,1352,34274,47456
93609,1450,53084,59030,1260,53893,60027,190,0,39596
93608,329,36361,43684,270,41071,42964,59,29034,29498
93606,175,0,49177,159,0,42140,16,0,0
93605,43,63250,67128,39,0,69995,4,0,0
93604,187,87159,150405,123,95938,118504,64,86364,211714
93603,69,0,43643,27,0,0,42,0,0
93602,1331,66060,78654,938,70300,86217,393,55733,59399
93601,575,64634,81817,448,75167,92328,127,45540,44426
93592,139,66806,74387,114,0,83054,25,0,34864
93591,1929,48911,61379,1507,47473,65318,422,48063,42246
93563,99,200625,188239,90,200921,206277,9,0,0
93562,770,35703,49239,440,52308,65084,330,24091,27241
93561,12247,65401,88540,8058,86303,103468,4189,40347,55805
93560,6916,63936,79361,4792,73343,88954,2124,41250,54608
93558,8,0,0,0,0,0,8,0,0
93555,13674,70571,87294,8403,84340,104134,5271,40318,56147
93554,66,20700,23865,33,0,0,33,0,0
93553,667,62875,78200,514,67647,83966,153,42440,54161
93552,10053,66289,78178,8528,67169,79919,1525,41313,55525
93551,15683,93637,112259,12569,99852,116917,3114,59167,79998
93550,21100,48002,60881,16242,52374,64018,4858,27924,40518
93549,141,58558,56335,93,66181,75055,48,19500,20067
93546,3502,69702,87666,1700,92938,106530,1802,52447,69130
93545,654,37083,52066,288,53750,64455,366,26724,37787
93544,509,38523,57758,277,85117,75028,232,24250,37139
93543,3577,57003,69807,3063,55304,67581,514,60469,64579
93541,160,48681,59608,42,0,0,118,47951,40432
93536,21462,84674,100527,15739,94913,108324,5723,48231,74232
93535,21129,49304,61713,16673,51674,65434,4456,30333,39916
93534,14092,43247,53620,8631,49033,60095,5461,29774,39206
93532,1010,76250,89903,727,85508,98874,283,61953,64439
93531,169,93850,126460,151,0,135513,18,0,0
93530,6,0,0,0,0,0,6,0,0
93529,195,100586,122831,163,101836,144642,32,0,0
93528,48,0,0,0,0,0,48,0,0
93527,805,73720,86137,464,78199,94415,341,0,74874
93526,307,54861,61743,137,75170,80466,170,41667,46604
93524,0,0,0,0,0,0,0,0,0
93523,1197,63314,77605,985,64307,81959,212,0,52480
93522,57,0,30232,20,0,0,37,0,0
93519,0,0,0,0,0,0,0,0,0
93518,380,46250,71385,235,52847,70936,145,26563,69828
93517,234,70260,74153,152,64857,74343,82,83182,73477
93516,1075,51012,70225,447,61250,66778,628,0,72293
93514,5985,64330,79087,3658,76180,95486,2327,42700,50747
93513,692,56466,70313,329,57986,77477,363,54792,63194
93512,85,42708,46121,39,39375,44687,46,50250,43637
93510,2571,101750,127141,1901,117042,147243,670,35429,55898
93505,4161,47641,66045,2666,58354,76210,1495,28125,46827
93501,1868,41047,50621,1211,47917,54867,657,26806,40765
93465,3571,99989,118099,2931,122734,128401,640,51563,47840
93463,3286,98116,147915,2123,135464,177058,1163,73854,89884
93461,506,61250,73567,320,63500,78695,186,0,63495
93460,2318,98968,133062,1605,130750,147388,713,48042,88639
93458,13286,59937,74067,11502,55366,69922,1784,38190,54726
93455,15584,93200,112082,11750,101232,119771,3834,57614,78350
93454,11560,68954,81421,8740,70075,84905,2820,33393,51645
93453,1283,50893,69405,788,69849,97139,495,16583,21795
93452,262,49194,57398,126,0,77878,136,48548,38423
93451,1366,70568,96028,1080,74914,107573,286,35921,41787
93450,209,59886,81231,186,63929,85035,23,0,38561
93449,4149,90837,117779,2112,112308,149116,2037,62454,83844
93446,17667,76859,97164,12287,91295,109763,5380,45451,61795
93445,2803,66428,78230,1719,78910,88346,1084,45667,54874
93444,7397,93603,114415,6084,104309,115053,1313,55417,78623
93442,5022,73701,91878,2718,96600,113731,2304,46506,62784
93441,377,94464,139827,267,109844,161007,110,0,85230
93440,486,73375,126060,351,0,134663,135,73406,103693
93437,1106,67917,70820,918,66563,72636,188,70144,58671
93436,17722,63966,83166,12697,69757,88476,5025,39615,59790
93434,1912,55511,68781,1624,52197,69905,288,0,33281
93433,5212,66408,86933,3323,80496,97241,1889,47132,60730
93432,452,93017,121825,333,103189,149698,119,34639,41948
93430,1294,67750,86449,807,80046,100965,487,56277,62049
93429,48,0,47896,28,68750,65489,20,0,0
93428,2731,74004,91928,1737,86319,106684,994,44621,64241
93427,2320,106682,116708,1746,120333,133656,574,46563,59989
93426,547,80066,97564,384,89000,107768,163,42813,71185
93424,526,80857,200363,280,156192,325964,246,60484,57403
93422,12956,81599,99115,8935,93226,112376,4021,50913,62197
93420,11496,91211,109941,8121,113609,128947,3375,40925,54339
93410,0,0,0,0,0,0,0,0,0
93405,8400,47783,81938,2908,124737,137940,5492,27467,50590
93402,6303,81494,97709,4328,89473,107821,1975,51166,69390
93401,12667,78788,106280,6179,105016,140655,6488,46507,71217
93314,9909,110877,142366,8154,123422,149228,1755,57199,102984
93313,15244,83312,100746,13385,82327,102896,1859,52907,64804
93312,18584,97615,112966,14384,102492,118821,4200,66645,80215
93311,15182,93200,122635,11807,103342,133607,3375,60431,75099
93309,21448,52268,66513,13863,55790,73235,7585,36162,49065
93308,20080,46071,62979,13106,54718,72021,6974,28750,38608
93307,22422,42128,53251,18396,43440,54412,4026,27787,34206
93306,21974,54450,76909,16803,60254,83892,5171,37145,46242
93305,11059,31739,44781,8165,32964,45897,2894,25310,34994
93304,14649,41311,53682,10284,46827,55906,4365,25581,38822
93301,4793,31089,54016,2467,42604,70285,2326,24599,35245
93292,13561,67433,88744,10471,68647,92492,3090,50646,59833
93291,18001,65729,85470,13762,73559,91727,4239,49572,58090
93287,34,101250,92229,15,0,97593,19,101354,0
93286,3048,44980,62005,2616,50572,65474,432,31094,30738
93285,1096,29194,42633,530,30035,50414,566,0,35346
93283,1007,37015,39705,671,0,36477,336,0,41469
93280,6717,39425,54593,5612,42784,58355,1105,14657,21989
93277,18229,65975,81815,13035,74277,89110,5194,40662,57279
93276,46,0,63574,37,47708,54724,9,11607,13267
93274,21459,55269,71979,17414,57648,74864,4045,34620,48971
93272,1198,46250,60984,1011,45262,58341,187,0,66897
93271,1234,71929,91288,915,75197,102321,319,42656,57765
93270,1671,42625,64342,1282,47278,71913,389,13631,31000
93268,6485,45655,57954,4278,46706,64160,2207,24917,38972
93267,1804,32003,49494,1334,34085,58989,470,13797,20429
93266,241,51776,67984,217,50197,65545,24,0,0
93265,1441,67617,88810,915,98609,117524,526,30200,34579
93263,5563,45867,59457,4625,49982,63226,938,16770,30465
93262,0,0,0,0,0,0,0,0,0
93261,599,20956,29041,474,21176,29664,125,12723,22626
93260,95,41382,51703,41,0,76505,54,38750,32872
93258,457,35034,34054,291,35507,37897,166,0,26943
93257,22638,44693,64029,16973,46556,67629,5665,27619,43597
93256,1538,34607,45253,1369,37817,47134,169,11188,23541
93255,456,28200,50050,194,26587,37607,262,29150,58531
93254,338,39375,54449,170,63409,72325,168,0,36360
93252,902,40870,52698,588,44613,61456,314,23241,35372
93251,75,46719,52436,64,43750,46869,11,77813,62209
93250,3264,38111,51313,2805,39423,54166,459,20938,23987
93249,530,35833,45144,370,43333,55575,160,19464,20306
93247,5343,39426,49439,4005,44260,55942,1338,21125,26166
93245,12005,65631,80062,9347,66762,81907,2658,48587,64117
93244,132,68750,127277,103,76458,153422,29,33359,33776
93243,661,34006,53973,472,0,58956,189,23994,38014
93242,1105,49659,72305,790,60847,80089,315,26761,52084
93241,4498,36741,45124,3727,38750,47101,771,18364,29570
93240,2640,33793,50719,1793,39260,54674,847,28731,39524
93239,589,41707,51843,436,42175,54435,153,41092,39882
93238,438,23325,40896,92,55851,70408,346,19651,33049
93235,1217,39332,46578,1041,39336,48815,176,14700,20082
93234,1927,31788,47777,1609,35461,48753,318,18185,34333
93230,22529,65674,80149,17304,70667,85052,5225,41100,56351
93226,51,0,58747,29,0,52372,22,76250,67150
93225,2024,52300,71420,1296,60957,82586,728,37041,40912
93224,122,49500,64413,88,54375,69326,34,33000,36747
93223,2862,44286,55879,2316,42267,56824,546,24214,38901
93222,909,46625,64645,507,52813,72544,402,0,54682
93221,4820,61782,85545,3573,68688,92723,1247,41012,59432
93220,45,0,0,0,0,0,45,0,0
93219,2578,41012,53256,2147,42188,56100,431,21875,27158
93218,196,26905,39105,149,34250,40812,47,15795,17330
93215,12230,46752,60886,10555,50568,63296,1675,16619,35592
93212,4014,42983,54431,3179,45204,57069,835,19572,34668
93210,4896,61808,79322,3630,65930,86072,1266,41923,55981
93208,88,0,0,20,0,0,68,0,0
93207,100,20500,46100,65,0,62711,35,18542,14851
93206,504,43889,55381,412,36100,52265,92,43864,53159
93205,881,23051,36686,535,0,45944,346,20139,21208
93204,2752,49781,54498,2380,49211,53004,372,33182,50480
93203,5077,40045,52007,4707,40699,52014,370,20875,27365
93202,1095,49821,56889,962,49898,52935,133,0,68789
93201,321,33688,41592,258,43125,45659,63,20250,21817
93117,16568,70878,94897,8282,108185,126477,8286,35094,59939
93111,6643,117480,155288,4604,145139,182133,2039,65354,85950
93110,6385,93264,128187,3721,107487,156180,2664,54222,84947
93109,4601,99556,136375,2463,139213,182162,2138,47176,80983
93108,4409,165764,251866,2619,207461,306457,1790,130417,170147
93105,11390,103156,142920,6754,133446,166914,4636,69304,104664
93103,8194,84853,132474,4880,115135,145810,3314,62080,101872
93101,13296,62925,91126,6477,63364,103440,6819,56081,74378
93067,207,75144,76520,85,113343,100435,122,0,59858
93066,972,106900,238382,827,108854,261641,145,66964,100207
93065,24441,100497,129444,17549,116037,146994,6892,59236,75384
93064,0,0,0,0,0,0,0,0,0
93063,19371,96654,116379,13999,110898,126839,5372,54977,78213
93060,9953,63573,77335,7431,66628,82647,2522,47161,53435
93043,9,0,0,9,0,0,0,0,0
93042,0,0,0,0,0,0,0,0,0
93041,7184,64208,78469,5175,72472,83381,2009,46523,56731
93040,524,65625,79257,457,61250,82059,67,21625,28513
93036,13287,78931,92861,10117,75949,93019,3170,70764,76867
93035,9621,85218,111385,6964,96346,118869,2657,61595,77824
93033,16804,68542,79299,14926,65741,74829,1878,41667,61434
93030,14975,78522,90176,12199,81456,92568,2776,38622,60249
93023,8117,80685,115988,5122,103516,134599,2995,49908,75113
93022,2276,97429,105935,1535,106219,120111,741,65354,68217
93021,12064,119139,148757,9870,133417,161498,2194,60833,79519
93015,5369,72311,87442,4354,76113,92564,1015,24774,48304
93013,6449,82231,145945,4105,98034,165897,2344,55250,95212
93012,12797,106388,140885,8803,122267,163279,3994,68077,87721
93010,15705,95836,125051,11136,112821,143446,4569,61024,74051
93004,10895,92074,112045,7701,118185,127779,3194,47005,70749
93003,19279,81501,103695,12341,95901,119655,6938,52069,70235
93001,12655,66460,85643,7367,74010,95207,5288,49694,67153
92887,6746,139750,179874,5579,152147,194474,1167,64509,100755
92886,16661,129253,159843,13668,145299,175407,2993,53711,77894
92883,11175,107393,126450,8904,115409,132934,2271,96290,89105
92882,20790,85819,102320,16853,94069,108966,3937,46713,60726
92881,9318,119023,140515,8132,122576,147683,1186,54091,74914
92880,18125,109438,133487,15747,120604,140656,2378,40938,68936
92879,14218,71817,91715,10959,74336,95153,3259,48935,67767
92870,16813,100685,118751,13036,113488,131557,3777,50649,62614
92869,11348,121712,160267,8776,137000,172268,2572,69936,104985
92868,7900,69034,89352,5014,73154,94369,2886,54766,70100
92867,12934,103040,139457,9955,112449,148851,2979,65750,93183
92866,5543,75562,106179,3252,91462,122957,2291,50429,74388
92865,6761,107706,121093,4932,121756,135638,1829,65913,73931
92861,1972,164919,240160,1724,189583,257237,248,70833,105309
92860,7370,106065,121832,5794,119205,131049,1576,52188,64706
92845,5403,105189,119560,4017,126290,136625,1386,52250,65085
92844,6736,63598,78388,5215,65542,78312,1521,48028,63761
92843,11730,70680,86356,9680,72072,87127,2050,33418,54169
92841,9432,65934,87609,7544,71726,92652,1888,37908,46696
92840,15291,75653,90439,11752,79310,93276,3539,50149,63071
92835,8740,117208,150845,6443,141910,174740,2297,56846,72983
92833,16266,88725,116488,12517,101670,119799,3749,49813,99600
92832,7955,68287,86463,5484,73712,93092,2471,56683,64165
92831,11968,80279,106494,7502,93133,121867,4466,53236,75697
92823,1595,147847,159791,1377,163945,163638,218,129274,129301
92821,13902,96700,117990,9921,113901,133003,3981,58909,73514
92808,7921,130818,153951,5674,157789,170590,2247,90610,106526
92807,12460,120435,142164,9407,134705,158543,3053,65805,83086
92806,12501,77570,98413,8346,86147,108037,4155,54190,69837
92805,20112,71253,86077,14865,73037,87282,5247,57959,69707
92804,24772,66936,84427,18155,74914,89188,6617,37261,60965
92802,12217,66429,81036,8942,63619,79968,3275,56406,70781
92801,18240,65683,81470,13666,67684,83798,4574,40200,59028
92782,8129,125469,169214,5879,156947,199062,2250,72374,86901
92780,18873,75626,98844,13376,80869,105038,5497,57256,74098
92708,18567,89478,115092,13755,105185,127340,4812,45648,74442
92707,14597,86001,96665,11741,83169,93729,2856,66970,84294
92706,10178,80051,104993,8366,81977,108094,1812,47103,73675
92705,15042,106058,147735,11987,114263,155585,3055,70707,103441
92704,20324,76136,93712,16144,73764,92315,4180,60119,72563
92703,13708,65687,81342,11653,64045,78065,2055,26684,46265
92701,13320,53710,67323,10504,52370,66516,2816,38462,53065
92694,8334,171121,213409,7112,176602,225669,1222,109130,129148
92692,17061,125115,148778,13332,135717,167223,3729,62292,73796
92691,16703,118379,137225,12826,129057,144729,3877,72665,105736
92688,15593,116557,138562,11489,145363,156110,4104,65515,85408
92683,27169,67104,92392,21035,73945,98611,6134,39757,61204
92679,11008,182857,230627,9553,194508,244140,1455,87679,127106
92678,214,107708,99882,140,121563,111661,74,61364,77597
92677,25108,119322,159805,18259,139270,182500,6849,74173,94365
92676,755,107083,143137,517,112426,164948,238,90833,84276
92675,13592,105524,146490,9964,120259,168284,3628,50971,80179
92673,9959,149882,186832,8275,161954,204313,1684,75595,94014
92672,14480,89029,134029,9017,116750,168147,5463,51670,72342
92663,10574,106209,170390,4660,137750,216816,5914,81024,131456
92662,1297,127443,212677,797,155893,263629,500,116250,129579
92661,1827,171339,250523,1243,238036,283779,584,140357,178414
92660,15368,135373,212933,9304,183382,275780,6064,86902,112760
92657,3689,187396,308090,2694,238553,345570,995,112303,205672
92656,19235,116350,135114,12942,136116,151575,6293,79799,94660
92655,2514,41538,67448,1825,52917,71977,689,21750,45126
92653,10475,104571,155769,7435,120745,179775,3040,73770,83944
92651,10455,129164,215483,6334,184417,269301,4121,79333,128867
92649,14560,101466,137070,9412,119461,151482,5148,73914,106525
92648,19407,97470,136863,11253,125606,170665,8154,64601,84488
92647,21520,91331,110513,14383,96808,116520,7137,72743,90869
92646,21789,102473,128185,14778,123468,147478,7011,66102,77524
92637,10990,46582,64726,3812,61772,85135,7178,36386,53784
92630,21003,99565,125774,15091,122080,139550,5912,56725,82079
92629,11595,105014,153812,7339,124288,180896,4256,65990,104017
92627,21706,85585,119797,13089,90764,131172,8617,71212,94980
92626,19114,95175,117890,11555,107370,131275,7559,80380,89002
92625,5895,162250,254450,3602,200409,303777,2293,100496,167946
92624,2575,115403,141903,1619,136496,168973,956,82842,93841
92620,17026,116650,148852,12873,131017,169389,4153,69679,81851
92618,20645,112054,145826,13645,130575,168237,7000,76616,99636
92617,3748,42756,91630,1462,135862,162132,2286,18750,46277
92614,10054,107662,128062,6216,122722,144583,3838,86287,97194
92612,12571,74672,112701,5491,120605,153833,7080,46189,79554
92610,5774,141629,165074,4492,150776,175398,1282,112672,124571
92606,9455,112688,136099,6598,125798,148219,2857,85258,102077
92604,9547,112543,133870,6859,131864,148833,2688,64048,88498
92603,7005,170781,225190,5306,177868,245656,1699,122071,135584
92602,7878,101459,134349,5619,101325,142661,2259,98353,107934
92596,8995,103138,119189,7908,102327,118932,1087,88191,97344
92595,9721,79895,97353,7974,84261,100316,1747,48517,62227
92592,24962,108412,133245,21058,116078,138975,3904,71780,89056
92591,13081,89574,108999,10357,96276,115193,2724,62329,75603
92590,1854,63938,142335,1300,74444,175428,554,0,58902
92587,5828,88771,114998,4545,90676,123065,1283,49764,78574
92586,8577,44179,58031,4539,59347,73153,4038,25840,40324
92585,6520,82217,103591,5482,93821,110064,1038,40638,55504
92584,15112,97674,112383,13101,99335,112693,2011,61107,85556
92583,9226,46844,63536,6751,55828,68748,2475,32714,41618
92582,4225,72701,92046,3586,73219,88209,639,67212,102885
92571,13134,69444,80719,11747,69903,81433,1387,50288,49721
92570,14185,62764,79672,12206,63656,81411,1979,28498,42911
92567,2473,79962,109319,2214,84559,108829,259,66250,84597
92563,18869,96604,121519,15823,104085,128127,3046,56419,78128
92562,19971,95156,120456,15778,104612,131727,4193,55497,66589
92561,632,51528,77981,329,85640,100214,303,16925,50478
92557,14135,76174,89126,11704,78404,91567,2431,51838,64396
92555,11380,91839,105464,9619,94899,106776,1761,65014,79650
92553,18513,54234,65055,15471,56263,66381,3042,26658,37916
92551,7743,71947,83032,6925,71039,80507,818,67037,79643
92549,1295,79276,87628,773,93897,106542,522,28198,59175
92548,2413,53643,65247,1711,54017,67983,702,27619,42480
92545,14828,48052,61721,9873,54988,70578,4955,26549,38694
92544,15298,53885,69496,11469,58420,75592,3829,26744,42379
92543,12546,38686,53186,8111,48146,61940,4435,24283,33224
92539,1476,52857,60853,807,80334,82363,669,25607,34070
92536,982,48182,78177,706,70000,95136,276,31357,28587
92532,7145,92288,113762,6060,95223,105598,1085,63988,133291
92530,15010,64270,79575,11585,69838,85520,3425,35329,50795
92518,538,75741,70130,175,76813,73004,363,71850,68744
92509,18757,76568,93096,15681,78368,95914,3076,40339,54028
92508,10110,121021,133266,8892,124154,135980,1218,69375,84973
92507,16843,54701,71043,9733,62075,82796,7110,38393,49211
92506,14660,101670,124445,11280,106897,134397,3380,60717,82795
92505,14326,71139,84536,11156,77783,90543,3170,45230,53559
92504,16576,69531,91391,12602,77290,97589,3974,40644,61567
92503,24650,75415,94218,19867,79581,99575,4783,40327,56741
92501,6608,71204,85257,4337,74093,89871,2271,41659,60606
92411,6621,44129,60064,5467,45671,62343,1154,25357,34192
92410,12661,41060,51455,9693,44964,53120,2968,21080,37713
92408,3602,57197,67469,2541,61641,74311,1061,30042,44342
92407,17076,72281,89056,13780,76065,93602,3296,44690,53627
92405,8970,41631,54568,6434,40926,54143,2536,30771,43589
92404,18056,49799,63748,13539,53407,66693,4517,29296,40902
92401,694,34167,53159,437,37431,59844,257,12300,32860
92399,18759,73647,92894,13562,96053,110044,5197,32176,44223
92398,693,55572,76016,298,91061,114752,395,48159,44506
92397,2014,63705,93348,1436,72188,107642,578,35435,57836
92395,14241,48495,66193,9941,59119,74252,4300,27157,42566
92394,8425,61270,94001,6910,68231,104983,1515,30234,38880
92392,15607,61872,78082,12913,62677,79349,2694,42702,63455
92391,962,44298,55583,740,44914,58033,222,0,35950
92389,152,33173,44396,46,98261,79333,106,28462,29235
92386,983,38378,54748,556,41250,65451,427,19936,36044
92385,113,53854,89197,51,53854,60761,62,0,112589
92384,16,147000,140144,0,0,0,16,147000,140144
92382,1749,66011,74742,1165,71875,83168,584,48971,55442
92378,70,69318,64397,46,69773,66900,24,0,0
92377,5393,95953,102541,4702,103298,106079,691,44896,57635
92376,21559,59416,73046,17523,64054,75719,4036,26708,42524
92374,13964,78191,96793,9781,84862,104501,4183,52539,70739
92373,12608,81557,123730,8342,99653,144229,4266,52629,80864
92372,1988,52500,73714,1473,67097,77712,515,33768,60478
92371,5436,62143,72375,4595,64250,76398,841,22869,27630
92368,288,36500,62361,212,38438,68875,76,16042,25221
92365,1071,55938,55296,664,58750,64801,407,0,36869
92364,5,0,0,0,0,0,5,0,0
92363,2095,33479,51962,1444,47829,59918,651,17139,31053
92359,3238,58250,75097,2247,76135,89156,991,30139,39952
92358,339,53403,60308,183,67014,80463,156,29412,36663
92356,2131,36701,50900,1487,42198,54612,644,23387,33852
92354,8202,59320,82530,5598,75395,93707,2604,44363,54440
92352,2337,89625,124121,1881,102864,138782,456,40385,61294
92347,241,38140,35455,133,40368,36632,108,37988,34004
92346,17282,67823,93215,13596,76062,98424,3686,37694,53348
92345,24572,51712,65569,19363,56850,70564,5209,25922,40546
92344,5607,89795,107818,5101,94370,108256,506,48000,63868
92342,2427,75045,82922,1745,77396,86446,682,68710,71901
92341,125,34375,59885,98,48000,73046,27,25000,0
92339,551,63661,77179,355,58315,82745,196,75485,66679
92338,0,0,0,0,0,0,0,0,0
92337,9923,84649,95580,8803,88035,96916,1120,54286,65648
92336,25768,96447,113762,22831,98077,112518,2937,72680,103686
92335,25003,58070,68108,20490,59607,69279,4513,32890,45305
92333,218,80000,95744,141,81250,84443,77,0,116436
92332,43,0,0,3,0,0,40,0,0
92328,302,90962,95928,129,180509,151266,173,35568,54664
92327,337,0,35753,147,0,53930,190,0,21689
92325,3308,63707,76119,2267,74240,82121,1041,40625,57092
92324,18047,58589,70211,13922,63086,75724,4125,34333,44970
92322,286,57154,73769,167,99292,100794,119,0,35843
92321,341,49018,68551,286,45417,68729,55,0,67622
92320,3218,61067,73467,2185,74809,88708,1033,26542,34338
92316,7748,63529,70951,6558,67418,73969,1190,40797,42275
92315,2132,55061,82604,1322,75658,96659,810,36477,56802
92314,4411,56132,67814,2767,62971,74182,1644,37697,54148
92313,4380,70200,86812,3166,77029,91861,1214,54444,58229
92311,11206,46102,60420,7744,52783,65595,3462,30141,43393
92310,2881,55986,62242,1998,53549,62017,883,59375,61335
92309,246,38750,52485,163,59464,63419,83,25208,29642
92308,13753,54738,71830,10265,60005,77916,3488,33620,45046
92307,12946,59084,81963,9546,70335,90099,3400,32431,51001
92305,204,88846,101201,163,87981,87631,41,0,144124
92304,0,0,0,0,0,0,0,0,0
92301,7990,48819,59304,6499,52344,62079,1491,28730,38702
92285,1098,35767,38834,633,36979,44202,465,27731,30569
92284,10494,45511,64827,6113,57785,74392,4381,33245,48278
92283,531,27014,43219,350,38590,50470,181,11820,25051
92282,448,41534,56768,285,43542,50729,163,29688,64256
92281,668,31935,51591,507,37292,53121,161,16917,28704
92280,0,0,0,0,0,0,0,0,0
92278,400,61481,82964,400,61481,82964,0,0,0
92277,9092,41322,52582,5650,42818,57195,3442,34922,42083
92276,2822,58814,69407,1986,63789,74904,836,27026,53101
92275,1162,24750,37012,461,55208,59739,701,21681,21788
92274,5694,26132,35040,2820,34801,44391,2874,19025,25257
92273,429,32961,41461,339,34145,43639,90,0,31511
92270,9637,84891,133992,5215,118048,170478,4422,58010,90540
92268,204,44500,57346,95,0,75662,109,0,41382
92267,26,0,0,0,0,0,26,0,0
92266,67,0,36455,47,0,0,20,0,0
92264,11278,60318,98393,4536,84654,136981,6742,43779,71584
92262,13877,55757,91736,6119,71412,113137,7758,43391,73162
92260,15568,61161,94906,8709,73542,117483,6859,42855,63999
92259,77,35739,29116,14,0,0,63,36534,31765
92258,178,0,23867,107,0,18883,71,0,31377
92257,610,0,19266,219,27554,34139,391,25000,10935
92256,1492,44944,62447,718,58750,79432,774,35056,46152
92254,3178,26328,33174,1827,38344,45152,1351,14214,16092
92253,16231,76158,119884,10968,99344,145812,5263,45958,61276
92252,3724,42370,59935,2090,49196,67793,1634,30793,46675
92251,5271,82394,89382,4119,91250,97832,1152,49583,55708
92250,2180,49637,66361,1601,58594,76673,579,18393,31612
92249,1935,58148,61396,1688,53491,60596,247,0,47776
92243,13146,47614,66059,10521,49128,69245,2625,24107,43820
92242,617,42083,44627,336,44524,52026,281,25347,32690
92241,3597,31478,45453,1852,44853,59043,1745,22815,29129
92240,12955,40456,56001,7782,51133,62647,5173,24106,41473
92239,119,35938,55124,99,32210,47652,20,66000,56555
92236,17685,34269,47356,9210,52143,60129,8475,21590,30742
92234,19716,50350,73063,12009,61986,87030,7707,29050,46719
92233,1023,40587,41960,727,44769,46386,296,0,30052
92231,9362,42739,61916,7238,54569,71535,2124,15319,25374
92230,784,47500,63235,491,62832,73317,293,41328,44815
92227,7325,47367,66383,5561,46633,69427,1764,50309,52809
92225,5788,43822,62554,3921,54777,70487,1867,24284,43709
92223,17269,86068,98702,13370,94165,105691,3899,42071,67021
92222,0,0,0,0,0,0,0,0,0
92220,11988,44167,65447,7898,50495,74765,4090,27158,44368
92211,12899,66202,105064,7387,87494,135209,5512,41856,64192
92210,2718,108750,185080,1542,157596,245486,1176,49688,105057
92203,12002,77281,95542,7766,87344,106885,4236,51627,69031
92201,24793,44215,62168,14511,59330,76972,10282,26792,39244
92173,8160,48967,64162,6515,54449,70296,1645,12992,29480
92155,0,0,0,0,0,0,0,0,0
92154,22634,70846,84589,18710,74354,87766,3924,43831,55229
92147,0,0,0,0,0,0,0,0,0
92145,519,"250,000+",318600,495,"250,000+",304715,24,0,0
92140,0,0,0,0,0,0,0,0,0
92139,10066,75576,88632,8079,80079,91053,1987,43887,57361
92135,0,0,0,0,0,0,0,0,0
92134,0,0,0,0,0,0,0,0,0
92132,0,0,0,0,0,0,0,0,0
92131,12127,137987,168712,9477,153495,186080,2650,82864,100669
92130,20464,157333,208919,15761,191080,239564,4703,91448,101120
92129,18664,126371,153614,14888,147070,168056,3776,63690,88712
92128,21109,104501,125560,14737,124347,144684,6372,66492,78364
92127,15300,147827,193601,12513,163882,204727,2787,76641,104506
92126,25215,99376,116257,19040,102580,118805,6175,74743,92091
92124,11274,94485,116381,8223,94003,116478,3051,91359,110767
92123,12585,90602,109851,8021,97295,120058,4564,68406,85402
92122,19417,81438,104885,9152,116294,139495,10265,55780,71436
92121,1850,118155,143870,971,147902,181030,879,86083,102270
92120,11665,102597,126300,7185,123019,152032,4480,61750,79104
92119,9339,97965,120548,6281,125024,142464,3058,54414,69690
92118,8672,108992,165468,6073,131407,193329,2599,65625,99464
92117,21213,91347,109276,13553,103074,117362,7660,64475,86176
92116,16260,78697,101866,6215,99494,122341,10045,69242,87518
92115,21208,56137,78993,11766,67487,94278,9442,40156,56311
92114,18276,73090,90324,15205,77249,93605,3071,40940,57329
92113,13670,43958,57654,10615,46993,60552,3055,25497,37982
92111,17174,77249,92134,10755,82262,101230,6419,52332,69484
92110,11462,77579,101923,5229,95031,121871,6233,63105,83692
92109,21893,92379,117081,7397,113096,145637,14496,82248,100372
92108,10832,80572,99445,4277,92888,120268,6555,72347,84624
92107,13970,84190,111990,6044,114486,148180,7926,69340,81540
92106,7565,114158,162638,4984,144635,205842,2581,54529,78439
92105,23130,48072,63488,15514,50000,68078,7616,32967,47330
92104,21873,73447,92464,8491,85396,109457,13382,65429,80087
92103,18397,78338,115292,6523,114519,165242,11874,63304,86469
92102,15049,54862,72736,7784,58646,77238,7265,46999,63937
92101,24984,71077,108606,6388,112979,150622,18596,58623,93610
92091,580,165132,192201,292,217955,242780,288,123500,140919
92086,532,38152,72378,366,55435,84434,166,27500,43887
92084,14603,77970,101144,10981,84227,106090,3622,44797,70933
92083,11550,68551,90401,8541,72586,100345,3009,44837,53014
92082,6023,94067,117081,4964,99656,122529,1059,39145,61517
92081,10654,80584,99684,7507,91730,105779,3147,49949,77012
92078,17528,91564,116098,12334,115556,134241,5194,47354,70056
92075,5152,104201,157797,3330,121404,185588,1822,77317,101820
92071,19360,85751,99481,14106,95352,106480,5254,55246,74106
92070,330,52500,75572,230,63500,86238,100,24792,45472
92069,14535,77618,99266,11126,83603,106632,3409,47263,61842
92067,2867,212188,292147,2448,207132,297558,419,0,218849
92066,165,68250,75812,100,111333,102239,65,0,35046
92065,11941,100645,122155,9357,107838,133559,2584,51567,67688
92064,16032,115391,147969,12705,129407,157372,3327,65590,92198
92061,702,43787,79485,552,0,78593,150,41557,72440
92060,119,0,184656,50,0,0,69,81356,79528
92059,564,96500,138976,387,95101,127801,177,116563,155983
92058,14277,57213,70819,11567,60527,71639,2710,37023,54210
92057,18799,81339,101184,14381,93042,111146,4418,52344,61344
92056,19161,85047,102293,12828,99326,115669,6333,49305,69345
92055,254,0,68097,172,0,83155,82,0,0
92054,15573,63355,88658,9019,73559,105612,6554,45432,60378
92040,15022,83692,100308,10899,97964,110236,4123,49900,67871
92037,16657,113676,185009,10049,156798,235217,6608,67710,106685
92036,1247,64861,78567,679,72138,101334,568,54571,51005
92029,7332,96690,129748,5013,122656,151382,2319,63773,78627
92028,15764,80775,103250,12265,86431,110186,3499,46576,64680
92027,17070,70009,91576,12852,79697,101461,4218,36769,48478
92026,17645,76534,95471,12101,85759,105340,5544,47369,63980
92025,16325,56866,83511,10977,65420,98504,5348,30772,47537
92024,19371,125458,173529,13061,152205,202215,6310,67320,107621
92021,22714,60510,83027,16678,68929,92347,6036,35340,47606
92020,19032,61830,83640,13634,71925,93291,5398,38654,53501
92019,14727,85067,110938,11216,95543,122642,3511,49559,65346
92014,5634,162305,237815,3675,228672,289782,1959,92250,137191
92011,9445,115301,159413,6722,130918,177968,2723,66427,104576
92010,6064,102793,116829,4329,118094,134943,1735,54805,67528
92009,16258,138138,177632,13056,159224,193223,3202,76926,98968
92008,11340,86046,120672,6760,106250,141725,4580,66549,84790
92007,4522,107778,156716,2826,145882,190781,1696,64619,91698
92004,1101,61809,93289,704,93661,105942,397,49306,70852
92003,1849,89201,117827,1326,103081,141172,523,43542,57899
91980,0,0,0,0,0,0,0,0,0
91978,3387,84266,100683,2629,84899,103045,758,65123,76855
91977,19098,71396,89112,14096,76985,93041,5002,47576,66708
91963,127,0,76831,80,0,109713,47,0,0
91962,937,130938,132591,781,135221,141743,156,0,86403
91950,17392,48359,63766,12402,53567,67664,4990,30400,47342
91948,34,0,0,21,0,0,13,0,0
91945,8659,67236,76023,6101,74120,85478,2558,38344,48323
91942,16463,66551,84760,8806,82612,95573,7657,50183,67301
91941,11995,94111,120062,8705,108338,135461,3290,52971,70587
91935,2939,106735,125756,2406,111958,132528,533,44018,85318
91934,241,37422,41541,169,0,31194,72,51471,65825
91932,9361,59795,76679,6333,64818,81529,3028,40133,53993
91931,236,63455,55622,103,0,55334,133,63132,50083
91917,231,0,85568,209,0,88621,22,0,0
91916,617,89531,112221,454,89355,117406,163,0,82958
91915,9062,125864,136542,7988,125340,137558,1074,113125,105924
91914,4546,136833,147979,4094,143503,154025,452,58347,75840
91913,14899,113415,132723,12617,114940,138019,2282,77616,85445
91911,25145,65074,82231,20275,73924,88765,4870,33231,45098
91910,24599,70283,90646,17756,79589,100880,6843,40825,56747
91906,1282,48100,69435,911,64073,80774,371,35991,37850
91905,645,42896,52076,409,0,62563,236,0,30806
91902,6045,106769,132519,4286,123750,138268,1759,70469,111325
91901,6150,93214,119653,4584,106557,134334,1566,43523,62711
91803,10106,66169,84382,7321,74144,91490,2785,48783,57874
91801,20142,66804,88882,13474,72704,95937,6668,49275,67267
91792,8832,85040,95642,6735,89790,100262,2097,54977,67311
91791,10372,87147,106981,7810,104059,122949,2562,31726,46610
91790,12160,84505,102405,10000,89456,106545,2160,51824,63676
91789,13305,105848,127407,11603,113087,132734,1702,54868,79290
91786,18826,65542,79579,12547,72704,86483,6279,46687,58690
91784,8904,133287,151773,7370,142435,162186,1534,66563,89814
91780,11184,83029,101947,8739,90273,110016,2445,47753,65218
91776,11626,65563,82889,8876,66065,87931,2750,41034,54203
91775,8059,94024,121997,5970,106851,135130,2089,54236,77578
91773,11358,89669,110726,8292,109185,126060,3066,40720,57328
91770,16887,61394,76654,14023,65710,80466,2864,31354,46842
91768,8274,62136,74148,6488,62734,76516,1786,32472,48876
91767,14474,63283,76820,10040,69490,81234,4434,44032,57417
91766,18576,61018,77675,14865,60072,79936,3711,39295,52462
91765,14874,101161,124435,11935,115018,137567,2939,48155,62654
91764,16350,60941,74965,12622,59993,75171,3728,47358,63407
91763,10451,63529,74827,8438,67675,76987,2013,35155,54301
91762,17853,64383,82236,13974,70847,86301,3879,44375,52268
91761,17345,76207,89232,13732,78202,91531,3613,59925,69982
91759,175,97109,90927,109,109583,111872,66,43750,55612
91755,8669,59285,84816,6901,62853,87895,1768,42283,60705
91754,11552,66218,90055,8376,76152,100101,3176,43224,57199
91752,8773,89255,110120,7209,99269,112219,1564,42341,81653
91750,12381,93166,116552,8969,115740,136691,3412,36408,57123
91748,13910,73948,95785,11438,77626,101363,2472,32404,54305
91746,6819,77740,88302,5992,80517,90072,827,30564,41405
91745,16467,88702,113820,13983,93793,119176,2484,49559,68580
91744,18821,74100,87402,16671,75904,87154,2150,37632,55433
91741,8688,108750,143102,6734,122125,161309,1954,47179,72844
91740,8199,89655,108343,6222,98468,115114,1977,53093,78791
91739,11421,119397,148191,9535,122356,154502,1886,89226,103172
91737,7795,103679,126912,6478,113347,135664,1317,56353,67243
91733,10868,57500,71060,9095,57666,72495,1773,30640,40935
91732,15466,56098,69994,12688,57731,72244,2778,24800,40514
91731,8122,48723,62763,6375,53832,65916,1747,22837,39322
91730,24954,74943,92853,17458,81032,100311,7496,53208,69532
91724,8448,84679,107707,6663,95017,114078,1785,55583,74137
91723,5802,70428,88212,4182,78397,98683,1620,41563,47555
91722,10019,82441,93765,7776,88860,100639,2243,54869,61971
91711,12211,100598,135984,8589,132783,159177,3622,51975,76065
91710,23292,86702,100746,18399,92731,106426,4893,52533,65668
91709,25874,104661,125494,21525,113664,134364,4349,61016,74690
91708,1287,57198,69660,1087,56341,68195,200,80664,75245
91706,18032,68773,81406,15410,69496,81617,2622,31490,53132
91702,15994,68058,85221,12182,73254,87997,3812,53659,61346
91701,13347,100653,116194,10582,111244,127126,2765,46437,58138
91608,9,0,0,0,0,0,9,0,0
91607,13631,76092,99419,6228,92417,124811,7403,52347,73518
91606,15548,54649,73115,9949,63688,83452,5599,35217,50562
91605,16101,53335,73962,11463,60711,81810,4638,31340,48174
91604,15167,119586,173855,7673,159862,233830,7494,79485,109580
91602,10146,81795,125359,4454,112623,176948,5692,61500,83385
91601,17004,57411,77913,6440,66511,98934,10564,52535,63076
91506,7544,85086,111681,4376,110135,144969,3168,48893,63524
91505,12533,89021,117626,7001,112535,142696,5532,55536,79517
91504,9747,86295,123326,6935,100309,137936,2812,53654,81873
91502,5181,53580,71841,2288,72292,88711,2893,43482,57007
91501,7736,73622,97883,5098,94329,115742,2638,45352,58844
91436,5878,153304,252366,4377,210025,296882,1501,89719,117663
91423,15341,90783,142969,7572,139214,196050,7769,67162,89322
91411,9559,61914,80437,5399,64799,84085,4160,49109,71476
91406,18685,61880,81267,12160,71189,86913,6525,46462,63324
91405,18558,49232,68642,12360,51075,70829,6198,39636,57434
91403,11803,101021,155202,6233,135729,204885,5570,71885,97311
91402,20340,48933,65654,15527,51190,67579,4813,31883,46926
91401,14772,57493,89863,8963,68218,99496,5809,44638,69627
91390,6110,121902,140209,4840,146111,153394,1270,58854,81015
91387,12554,94545,115723,10003,102877,124432,2551,56934,71560
91384,7019,111990,129896,5871,123734,139038,1148,50441,70324
91381,6624,134115,165015,4952,152990,185009,1672,65846,96301
91377,5033,137047,169474,3436,163750,203686,1597,71616,92717
91371,0,0,0,0,0,0,0,0,0
91367,17961,95212,127270,11150,114737,149053,6811,62279,86811
91364,10453,110525,154972,7117,128646,177305,3336,77933,99657
91362,13813,119967,161489,9326,158341,196504,4487,55025,84723
91361,8211,119659,196554,5443,161215,243060,2768,66974,101240
91360,15290,94149,119239,10235,120025,141201,5055,52609,71026
91356,11982,80872,135952,7826,108537,163206,4156,48918,79924
91355,11312,95640,114384,7488,113125,134623,3824,51786,70847
91354,10357,130557,157798,8444,139549,167203,1913,81272,105176
91352,12335,58696,79537,9542,64563,84229,2793,28478,54085
91351,9613,85755,104190,7229,93589,112807,2384,54609,67772
91350,11811,113028,129760,9487,126468,136722,2324,67589,89566
91345,5557,80759,89391,4040,91853,100887,1517,35766,48086
91344,17915,103329,126011,13615,115599,139424,4300,51546,77644
91343,17977,67043,90329,14001,75269,93343,3976,39674,63970
91342,24833,79572,92356,20255,83725,97385,4578,41075,54344
91340,9015,64479,83239,7367,70492,87859,1648,31015,39603
91335,24581,65740,88464,18008,72041,93934,6573,39243,61829
91331,23398,64375,81509,19578,69517,83850,3820,26348,42539
91330,0,0,0,0,0,0,0,0,0
91326,12498,120563,150946,9730,135423,163836,2768,50795,100755
91325,12372,72041,102036,7740,87792,115877,4632,41971,70699
91324,10348,83894,106124,6900,97956,118041,3448,60805,72006
91321,10804,74986,100770,7646,87400,106468,3158,44744,72503
91320,14893,125093,153090,11421,144421,170391,3472,59598,90580
91316,12815,76088,113694,7647,97774,140389,5168,54000,69902
91311,14281,96432,121182,10392,103838,133096,3889,64738,80466
91307,8595,119452,152876,6740,135453,165650,1855,62215,97198
91306,14652,73894,94998,11001,79122,99171,3651,42871,61679
91304,18105,71039,101768,12819,79607,114066,5286,43352,64319
91303,10326,62848,78055,6712,67932,84628,3614,41979,59709
91302,9949,149724,240688,7567,187529,279858,2382,61860,97944
91301,9116,130315,202650,6885,157725,233664,2231,72650,96022
91214,10575,108583,132047,8340,125538,147197,2235,53872,68534
91210,160,138333,146747,131,139844,160404,29,0,0
91208,5908,104866,151692,4198,134397,182723,1710,73977,75510
91207,4151,85107,134534,2828,109583,157687,1323,54875,74200
91206,13050,74893,104456,8678,85530,112486,4372,44655,84931
91205,14052,47160,71879,9105,52527,81597,4947,32817,50581
91204,6743,55847,76327,4157,51706,71860,2586,61375,80051
91203,6223,61384,85141,3790,68602,95497,2433,48163,67240
91202,9359,81665,112551,5898,99295,129491,3461,52488,81273
91201,8238,59073,91494,5411,73782,106862,2827,39515,59192
91108,4108,163654,228665,3534,183403,244912,574,60758,109423
91107,12971,100866,139883,8328,128644,169116,4643,66519,80904
91106,10657,84782,120619,5290,106516,153170,5367,66578,85783
91105,5410,137637,189980,3076,177561,234825,2334,83977,126909
91104,13630,78285,110991,8928,95034,127448,4702,52634,73500
91103,8485,71600,115436,5516,79925,133531,2969,35337,75218
91101,11463,72144,92339,4163,96374,120010,7300,57931,75299
91046,106,0,40947,77,0,30860,29,0,0
91042,10079,66453,84546,6990,78233,95761,3089,38457,55385
91040,7482,92280,110860,5314,108912,124755,2168,47500,70979
91030,9671,109927,167620,6368,143519,202309,3303,79382,92713
91024,4679,106719,158259,2738,150267,206995,1941,71310,88250
91020,3514,65506,85228,1961,99040,110848,1553,46736,52877
91016,14593,82801,103244,10043,92162,114979,4550,49776,71218
91011,6329,170571,258391,5421,193776,279242,908,64219,126832
91010,7963,83051,96370,5974,97041,106893,1989,41315,53240
91008,444,108846,293827,274,169000,413739,170,91667,90846
91007,11763,84833,118685,8950,101783,132265,2813,48977,68106
91006,10433,105011,145040,8537,116637,156894,1896,58455,77220
91001,12460,104577,147447,9221,118461,162643,3239,65101,94748
90831,0,0,0,0,0,0,0,0,0
90822,0,0,0,0,0,0,0,0,0
90815,14519,100034,126729,9556,121533,148099,4963,61357,77052
90814,8646,81925,105033,3845,110837,146002,4801,62453,70925
90813,17167,41175,53979,11299,43599,55402,5868,28817,44322
90810,9571,60486,74758,7706,62188,78375,1865,29375,46650
90808,13992,111163,134132,10431,125801,147179,3561,62073,87596
90807,12697,77966,105590,7721,95771,127189,4976,52636,67880
90806,12335,57037,79398,8875,58313,85579,3460,42717,54902
90805,27280,53299,69985,20293,55041,70657,6987,40374,59431
90804,15027,52122,67579,8000,51304,67189,7027,48092,63010
90803,16858,92230,122208,7173,129554,165620,9685,75505,85851
90802,20841,60939,77717,6701,71192,89036,14140,55726,71250
90755,4514,86140,102832,2468,101419,118240,2046,59700,81157
90747,0,0,0,0,0,0,0,0,0
90746,8342,87713,110887,6611,101292,120070,1731,48678,67570
90745,14495,86981,104677,12170,89570,110134,2325,39352,58698
90744,14938,50965,66504,11891,54473,71021,3047,24820,40039
90743,120,142000,110218,76,155250,138762,44,0,60911
90742,357,81528,144773,159,100156,174755,198,74091,120697
90740,12503,72226,111622,5872,113385,157998,6631,45170,69523
90732,9064,101738,119874,5973,125332,141038,3091,53188,75887
90731,22843,56881,84783,13607,68178,97098,9236,40481,62927
90723,14156,57313,71819,11577,58299,74624,2579,38994,44332
90720,8029,109847,143690,6025,128568,161221,2004,62564,82721
90717,8205,75286,96142,5212,100292,111942,2993,42679,65609
90716,3673,61525,66563,3115,63157,66871,558,28646,40145
90715,6227,74471,90908,4863,82083,97663,1364,43750,56331
90713,8996,108311,119249,7125,118343,125979,1871,51107,68982
90712,10114,102687,114755,7554,112093,125867,2560,52424,73896
90710,9439,65119,85629,6803,72260,91070,2636,40045,66021
90706,22998,63848,79884,17167,69936,84945,5831,39542,53787
90704,1716,77868,96555,1151,101576,107421,565,43125,46357
90703,15496,108844,134381,13132,116282,140732,2364,62471,85674
90701,4503,74523,88752,3790,77269,91221,713,41146,63105
90680,9577,69212,84374,6370,76969,90354,3207,40528,57217
90670,4893,71318,86020,3729,80795,94948,1164,34405,52414
90660,17060,70620,87484,13580,76449,93568,3480,27014,44939
90650,26748,77425,91220,22279,80070,93825,4469,38938,57337
90640,18937,62521,80311,14744,66092,82806,4193,31089,48121
90638,14903,92508,108907,11803,103688,120246,3100,42703,56096
90631,21548,86973,110897,16425,90383,116193,5123,58570,82809
90630,15933,102263,122875,12811,111577,135342,3122,53571,63309
90623,4925,107956,124517,3862,124844,134952,1063,41372,80166
90621,10224,72000,88256,8330,68190,88612,1894,50521,60670
90620,12843,99351,114335,10715,106291,120073,2128,54429,70660
90606,8861,74717,87908,7133,82809,94616,1728,39926,49503
90605,10813,77482,96911,8683,82292,101967,2130,47112,62275
90604,11939,77898,92743,9249,86271,102862,2690,40303,51305
90603,6325,104028,116594,4861,117754,131939,1464,42333,59231
90602,7659,54752,74081,5327,65020,80953,2332,36329,51286
90601,10836,76177,91451,7521,91264,104716,3315,38933,53998
90506,0,0,0,0,0,0,0,0,0
90505,13838,95113,121535,9658,111781,136801,4180,61615,85427
90504,11413,92636,113578,8135,112662,133448,3278,52072,59865
90503,16577,97688,120575,11285,119640,134666,5292,58652,86196
90502,6438,85515,103098,4369,95972,113278,2069,53750,74923
90501,14140,75388,102061,10075,83213,104814,4065,57038,89966
90405,14074,96352,136441,5611,131069,183976,8463,81468,103005
90404,10359,75610,111833,4564,85625,135562,5795,62679,91955
90403,12901,111611,155708,5479,146384,206353,7422,82757,116587
90402,4683,145742,314743,3027,213641,414490,1656,73500,123889
90401,4548,95217,133030,1021,105579,150640,3527,85114,127932
90305,5927,88910,105892,3770,99679,115142,2157,59023,82716
90304,7106,47612,61734,5717,50506,63617,1389,27003,44930
90303,7027,62826,79535,5398,64382,84092,1629,35023,53614
90302,10536,54432,70572,6875,60476,74237,3661,40929,56295
90301,12254,51498,66084,8043,59766,74080,4211,29104,46288
90293,6685,104814,149151,2658,131042,192441,4027,91086,119805
90292,12817,121021,162869,4945,155417,197684,7872,108476,139700
90291,14420,99496,166091,5212,159500,229406,9208,81638,127833
90290,2002,129000,175506,1343,149036,196293,659,95750,121043
90280,23989,55084,68853,20173,55681,69298,3816,32362,43984
90278,15183,126979,158019,10093,150503,180405,5090,82914,107656
90277,15650,104859,152626,8228,146466,191027,7422,80101,107186
90275,15223,145816,194050,11902,164296,214370,3321,66763,116146
90274,8893,181776,257930,7178,204808,288331,1715,82269,120802
90272,8517,199598,345660,5793,"250,000+",443347,2724,91483,133209
90270,6753,50996,60374,5728,52397,61801,1025,27474,37941
90266,13313,153926,243789,9216,195510,289444,4097,92562,137712
90265,7028,163909,265442,4706,198857,301329,2322,94583,180373
90263,0,0,0,0,0,0,0,0,0
90262,15254,57236,71059,13334,57232,71048,1920,27214,41923
90260,10499,70389,84420,7738,73552,88121,2761,45380,61714
90255,18523,49366,62285,15604,50179,62621,2919,20502,36075
90254,8596,142500,209447,4287,199276,264207,4309,103802,151476
90250,30841,60162,79570,21011,66055,85886,9830,42858,58911
90249,8731,65397,82585,5960,78735,93438,2771,38930,53215
90248,3909,63620,89363,2947,73514,97191,962,40000,58989
90247,15851,61234,75699,10986,72466,83392,4865,36279,51785
90245,6645,115846,143417,4141,125022,158403,2504,81691,111050
90242,12522,73037,88155,9741,78621,93766,2781,37906,53736
90241,13304,72274,88910,10566,77471,93342,2738,42407,58330
90240,7607,87107,125793,6449,87572,129604,1158,49912,70907
90232,6773,98116,127266,3227,125809,167808,3546,73116,88783
90230,13670,87469,121365,7842,114526,150835,5828,65597,79946
90222,8439,57101,65933,6898,64454,71142,1541,19932,35958
90221,12074,53683,66701,10212,55878,67997,1862,26760,41513
90220,13336,61279,71566,10405,63066,72770,2931,40559,56547
90212,5728,86496,158695,3077,129225,202069,2651,65903,107689
90211,3912,96111,157395,2102,141357,223517,1810,62500,78240
90210,7752,152037,283080,4984,197632,355184,2768,79120,150968
90201,24232,46109,57422,20655,46742,56694,3577,20449,38012
90095,0,0,0,0,0,0,0,0,0
90094,4026,170634,234855,2222,234559,302386,1804,103372,145505
90090,0,0,0,0,0,0,0,0,0
90089,9,0,0,4,0,0,5,0,0
90079,0,0,0,0,0,0,0,0,0
90077,3008,222982,396259,2273,"250,000+",461650,735,121719,188606
90073,0,0,0,0,0,0,0,0,0
90071,125,61895,81146,7,0,0,118,61613,72305
90069,12570,90546,151285,3049,130856,222483,9521,74236,126403
90068,11723,87327,163696,4115,174237,279485,7608,66269,99179
90067,1501,111299,178513,618,135368,234399,883,101406,137967
90066,26696,87589,124575,13400,108728,152890,13296,66888,93898
90065,16244,76080,112869,10602,81386,120583,5642,62435,90743
90064,11272,103045,161321,5721,166926,227058,5551,69606,90052
90063,13873,50913,67776,10886,57427,69296,2987,30101,47684
90062,10112,52661,71338,7511,58143,75322,2601,22513,46100
90061,7527,47468,64948,5536,51887,68608,1991,19435,46334
90059,10453,44839,59815,8406,49418,65436,2047,15654,27912
90058,792,27708,42192,527,30074,35888,265,0,50903
90057,17555,41748,51386,9476,41133,52938,8079,34328,43898
90056,3552,84387,120594,2103,117852,155278,1449,60486,65515
90049,16375,133032,227182,7933,191930,323905,8442,94981,133305
90048,11906,93583,151911,4433,140821,225294,7473,74871,105074
90047,17197,58830,73485,11624,70734,87624,5573,20700,38410
90046,28544,72457,116558,8337,114390,163293,20207,61469,94609
90045,15469,110535,143151,8671,147039,178715,6798,80112,93410
90044,28368,39434,56281,20854,46764,62878,7514,16931,28625
90043,17740,56285,77808,10491,71942,96532,7249,28104,48352
90042,21077,73152,97223,13135,74856,102763,7942,63623,82021
90041,10251,90461,121689,6456,106114,142076,3795,60465,79625
90040,3454,54567,69829,2623,62586,75038,831,22548,40097
90039,12277,88104,134981,6322,112331,163790,5955,70271,98532
90038,12648,48786,66663,4944,50804,74151,7704,44496,59577
90037,17763,37945,55177,12921,43544,58040,4842,18673,33302
90036,18761,84315,126358,7411,114782,166919,11350,68849,99007
90035,12049,99367,143414,5583,127209,193297,6466,78088,97930
90034,26196,80773,104934,10682,95522,128860,15514,70952,86860
90033,13396,43646,57992,10108,46566,58546,3288,22083,43762
90032,13825,59723,79371,10211,62972,84093,3614,40180,56077
90031,12005,51076,76666,8263,51708,74981,3742,35761,71797
90029,13627,45004,64635,6907,50286,74300,6720,35517,52291
90028,17114,50253,70230,4621,55809,83494,12493,47175,64422
90027,21403,71651,110881,8923,88479,149096,12480,58542,82420
90026,26807,67435,97820,12675,70290,104104,14132,63555,89425
90025,22194,97791,126948,8355,118693,158273,13839,83937,105979
90024,17092,63344,134236,5857,127543,244614,11235,43941,76405
90023,11573,45991,58183,9478,49053,59693,2095,20870,34449
90022,17439,51183,63040,14420,54566,65997,3019,22143,34010
90021,1778,21625,52696,542,56300,77027,1236,13059,41461
90020,17064,50207,74885,8880,51988,93253,8184,43178,52877
90019,24252,58313,89027,12929,68157,100210,11323,42261,72241
90018,16634,49644,68705,10800,54144,76447,5834,31238,48108
90017,11938,36870,61933,5309,32495,58353,6629,38620,62707
90016,17522,49958,69853,10247,57602,76600,7275,40868,57385
90015,11180,48743,82258,4074,47273,81979,7106,50451,81487
90014,5968,36429,66863,792,98056,99403,5176,26455,60950
90013,7810,21175,62660,903,116094,157570,6907,17365,50125
90012,13558,49905,80555,4937,45934,78893,8621,48515,78407
90011,24827,44616,58009,21002,43691,57309,3825,25109,33105
90010,2282,70500,102014,831,68973,130674,1451,69120,84309
90008,14784,47230,73947,6576,72036,99243,8208,33882,51792
90007,12248,30530,55776,5532,41172,79084,6716,17801,34116
90006,19149,37375,53427,12655,37185,52764,6494,32468,47475
90005,16331,42398,59439,7798,49552,71319,8533,35102,46870
90004,22528,52775,92624,12310,58073,109018,10218,46222,67522
90003,17542,42220,54272,14376,44595,55637,3166,18478,27484
90002,12961,42245,54170,10493,45417,55762,2468,20671,30966
90001,13689,48011,57935,11289,50344,59620,2400,21458,31940
89883,1746,56667,71278,1088,79295,85842,658,24529,41560
89835,500,48824,57962,284,63611,79854,216,20800,29053
89834,54,0,52854,32,0,0,22,0,41764
89833,58,44167,48945,35,78083,60014,23,33281,32100
89832,432,41429,46859,257,55972,56165,175,23906,31095
89831,11,0,0,0,0,0,11,0,0
89830,64,0,59386,29,0,0,35,0,0
89828,104,0,77131,55,0,0,49,0,0
89826,0,0,0,0,0,0,0,0,0
89825,409,25496,48513,194,0,62476,215,23878,29069
89823,157,51956,55428,127,62917,64302,30,0,0
89822,705,66791,77520,475,84375,89459,230,33158,46773
89821,242,66357,70536,172,66643,76780,70,0,55194
89820,2208,74344,83106,1585,89607,95062,623,24454,48047
89815,4778,101176,111590,3669,106674,120012,1109,76250,79363
89801,9619,78400,89808,6467,91872,100878,3152,50694,63451
89706,8235,53161,62829,5156,61824,71712,3079,29504,42771
89705,2310,66744,76425,1628,70080,79917,682,50000,63210
89704,1877,81528,97911,1410,86929,102072,467,55625,82860
89703,4727,72402,99304,2709,102745,130533,2018,41563,52313
89702,0,0,0,0,0,0,0,0,0
89701,10523,58079,82587,6816,67149,83825,3707,42319,69910
89523,14986,82902,104737,9105,96865,125041,5881,57804,71586
89521,13512,103279,116917,9162,110503,124713,4350,75988,95343
89519,3684,125988,192479,2764,146389,222031,920,77500,98554
89512,11193,37679,52078,5047,51862,66877,6146,24111,37771
89511,11651,106071,157438,8253,130862,183582,3398,61131,87425
89510,664,71333,105436,471,82853,125770,193,38438,53338
89509,17073,62844,95547,8591,96594,125698,8482,43978,62484
89508,4764,78411,88391,3646,85546,94809,1118,51940,54611
89506,14745,66227,79037,10516,71382,84327,4229,52124,58865
89503,12469,54063,76117,5730,73134,96140,6739,35275,56595
89502,18616,48782,65655,10168,56326,74748,8448,36303,50993
89501,2776,44393,55619,563,71406,89776,2213,41287,46593
89460,5525,66767,85517,4064,76948,94551,1461,38573,53791
89451,4015,119358,176858,2821,139375,192375,1194,80357,137121
89450,9,0,0,9,0,0,0,0,0
89449,1416,57857,111593,873,59867,145079,543,45729,52912
89448,827,100272,158957,557,115795,149978,270,73542,171058
89447,3632,37552,48156,1989,48845,59354,1643,25011,34342
89446,0,0,0,0,0,0,0,0,0
89445,6398,67126,83267,4119,81836,91092,2279,39767,66929
89444,1544,49489,62955,913,70956,74986,631,27027,43077
89442,426,52500,53759,324,56630,57101,102,35250,39091
89441,4644,109717,120941,3790,113760,132602,854,55761,61892
89440,274,0,103595,175,112112,127491,99,47950,61355
89439,633,60547,89705,434,81875,113306,199,33750,37521
89438,39,83021,79815,22,0,0,17,0,0
89436,16513,91338,107179,12380,103586,118093,4133,53308,64791
89434,10651,68539,80202,6728,78333,90248,3923,44094,56823
89433,6875,55960,67046,5152,58873,70265,1723,34397,43846
89431,15322,50233,63806,9496,57611,72438,5826,33034,43835
89430,86,0,93586,21,0,0,65,73616,80345
89429,3227,46492,71005,2143,57378,86020,1084,25323,36550
89428,70,0,49537,23,70625,63700,47,23542,42606
89427,381,23750,36573,239,31544,43118,142,15469,22119
89426,114,0,69661,90,111406,85050,24,0,0
89425,160,0,120791,141,0,135087,19,0,0
89424,103,27321,32829,43,0,40298,60,0,25132
89423,4668,83720,103832,3517,89323,111777,1151,46650,76773
89422,119,36250,51562,30,137656,105343,89,24271,29847
89421,221,16635,36989,123,42917,47037,98,14184,21058
89420,10,0,0,10,0,0,0,0,0
89419,1545,55994,63768,1042,60833,72145,503,46648,46168
89418,86,0,27671,19,0,0,67,0,0
89415,1414,32926,47098,673,51434,70119,741,17292,25903
89414,39,52697,49895,6,0,0,33,53092,51667
89413,370,76635,204001,264,0,259381,106,52361,66075
89412,26,0,0,26,0,0,0,0,0
89411,391,102482,188325,226,195216,256874,165,100366,94434
89410,4829,72335,89960,3334,87345,106061,1495,31275,50471
89409,53,57176,61215,23,0,0,30,0,0
89408,7535,65585,77525,5295,77626,85631,2240,47231,52398
89406,9949,56514,69178,6069,71221,81763,3880,39044,47123
89405,32,0,0,32,0,0,0,0,0
89404,0,0,0,0,0,0,0,0,0
89403,6066,69969,83583,4267,83046,89939,1799,43135,61456
89402,8,0,0,8,0,0,0,0,0
89319,135,80467,63064,83,81018,78786,52,0,37971
89318,461,55294,50928,184,56136,62241,277,40688,43413
89317,125,0,46078,77,59813,65577,48,0,0
89316,364,81100,95237,280,90968,110029,84,0,45933
89314,128,43929,51741,59,48438,55942,69,37750,46974
89311,87,69018,65485,70,73250,67343,17,0,0
89310,137,40724,56957,55,109018,105751,82,23068,23524
89301,2928,61207,74394,1865,74826,83403,1063,32540,46057
89191,0,0,0,0,0,0,0,0,0
89183,14861,65943,85469,9411,69918,92678,5450,53023,64476
89179,2614,96460,104641,1928,94250,105262,686,95093,90607
89178,14778,90801,108479,10360,99788,111881,4418,57923,89189
89169,9734,32114,45328,4091,37250,52636,5643,26123,38345
89166,7823,97316,111538,5751,104741,119160,2072,74608,86121
89161,110,39358,55309,36,0,0,74,0,0
89156,9708,52323,62859,6764,58926,69116,2944,30890,42663
89149,16322,77957,102435,10940,94929,116528,5382,55257,69958
89148,20184,78352,87826,13595,81952,92028,6589,60412,70779
89147,20918,61186,81950,13479,67016,88782,7439,46545,62963
89146,7356,50259,79471,4096,64947,97148,3260,36794,54500
89145,10187,66431,92289,6481,74681,108728,3706,40646,59325
89144,7718,92526,145694,5532,100488,168032,2186,60514,83961
89143,3926,84385,99974,2924,88316,105605,1002,59808,76691
89142,10308,51388,65617,7754,60998,71134,2554,28143,41562
89141,11968,90342,129677,8794,96168,143706,3174,61227,79802
89139,13187,79496,97819,9680,81169,98653,3507,59540,81216
89138,6531,122054,167262,5034,128937,174160,1497,76921,135613
89135,12393,100022,151970,7761,117511,178583,4632,68906,102306
89134,11665,67184,99359,6982,84157,121882,4683,42098,64764
89131,17289,100838,116243,13312,106174,123305,3977,62157,81798
89130,12682,72308,82335,9188,83522,91700,3494,37170,51251
89129,20822,79275,108539,14059,88666,111633,6763,53612,98325
89128,15063,59045,83874,9186,71371,100328,5877,38794,54762
89124,580,102301,200458,487,106017,219571,93,36528,72239
89123,24011,71905,97135,14587,88662,113174,9424,52730,67166
89122,18488,47950,61315,11532,57603,71498,6956,30373,39418
89121,24228,43160,59130,13825,53753,68448,10403,28485,43193
89120,9357,57365,77964,5022,66788,93194,4335,45625,56121
89119,22347,38659,48913,10233,47848,58894,12114,31290,37177
89118,8599,59911,85541,5039,67353,89754,3560,48136,69545
89117,23404,60637,88781,13960,75639,107143,9444,40643,57258
89115,19252,41268,49414,14387,43009,50711,4865,25135,33562
89113,13130,76961,101243,8135,88198,115077,4995,55397,74696
89110,21651,43769,58626,14899,51839,64511,6752,26038,38828
89109,4133,44890,96770,1628,43846,101137,2505,45917,86854
89108,26913,49351,59774,16245,54526,67018,10668,35500,44554
89107,13299,42728,57673,7628,54473,67769,5671,31147,39758
89106,9081,31031,53707,4943,41684,56779,4138,20838,47589
89104,14846,38939,50702,8112,50274,59982,6734,25059,36024
89103,22864,42833,58599,11875,46455,64681,10989,34673,49095
89102,15576,38122,54593,8211,41743,59835,7365,28277,42810
89101,15693,28080,41000,7330,37171,49728,8363,19412,30821
89086,2181,49046,60993,1599,49623,62482,582,43973,50824
89085,1414,98713,96731,1228,104500,98085,186,0,69206
89084,9386,79766,92814,7007,84570,99253,2379,49222,63381
89081,11635,71206,77984,8850,73938,79247,2785,48912,65850
89074,20356,77935,102113,12822,90124,119224,7534,54106,68598
89061,2527,56865,62940,1751,61148,69431,776,33474,47327
89060,4348,45833,56469,2584,52552,60592,1764,35592,48517
89054,29,86146,77210,12,0,0,17,0,0
89052,22433,86589,120754,14755,104321,137885,7678,53340,82999
89049,1363,31223,40610,406,34107,47243,957,29798,35942
89048,8973,45238,59421,5967,56154,66981,3006,26108,41186
89047,82,66000,71243,30,90357,82253,52,60625,61112
89046,241,31813,35508,105,38958,42434,136,0,30161
89045,886,66591,74406,539,61699,73762,347,61976,69224
89044,9846,97917,119982,7084,107895,133777,2762,52303,81295
89043,489,62621,70436,270,64758,78960,219,54293,59926
89042,384,78750,81632,289,82063,90985,95,0,43996
89040,1532,65875,82838,1022,77123,106467,510,23382,31881
89039,135,37625,32627,46,41071,32026,89,0,31688
89032,14323,60995,71930,10405,66911,77351,3918,41059,50464
89031,21618,68888,80416,16660,72109,84300,4958,46952,56568
89030,14464,36993,47531,9828,42354,54078,4636,20538,27589
89029,4438,37422,47791,2009,49347,59164,2429,26684,37406
89027,8182,59206,71776,5561,68049,81020,2621,34614,50094
89026,0,0,0,0,0,0,0,0,0
89025,369,49291,56388,306,61500,61671,63,15764,18932
89022,0,0,0,0,0,0,0,0,0
89021,979,80083,90617,865,85707,94788,114,29063,33707
89020,496,36731,52504,192,56579,70762,304,31567,40972
89019,1114,56765,86818,489,89558,131125,625,0,50086
89018,305,45875,46854,216,50938,52828,89,24479,31328
89017,10,0,0,10,0,0,0,0,0
89015,14943,57049,74140,9972,65287,82710,4971,37260,49182
89014,16889,61752,80871,10101,75029,91240,6788,44137,61965
89013,129,36250,44381,49,58438,67551,80,21852,30189
89012,15336,79727,111402,9902,99486,133674,5434,52143,66786
89011,11491,77100,107868,7486,89347,118528,4005,42368,81733
89010,185,32847,53109,113,44750,66807,72,21429,31610
89008,638,24238,44156,193,78482,77226,445,22998,28306
89007,302,96563,98737,250,108478,114568,52,0,0
89005,6556,62792,83943,4164,76679,101299,2392,35333,49435
89004,108,80938,91152,58,101500,126193,50,38269,50504
89003,552,19651,38495,164,54839,50405,388,17283,33460
89002,12865,83700,95263,8912,90625,104065,3953,60634,69157
89001,482,56098,77166,395,54208,66020,87,0,127768
88436,27,71094,59119,19,0,0,8,0,0
88435,1053,33390,55540,592,41316,74680,461,23405,29552
88434,144,41875,71169,82,65833,99896,62,24265,32845
88431,8,0,0,8,0,0,0,0,0
88430,41,47917,61039,13,0,109862,28,47667,38371
88427,54,46250,64463,37,45208,66300,17,68068,55982
88426,451,26313,36854,235,0,41813,216,25192,31434
88424,18,0,71322,14,78750,83186,4,0,0
88422,33,0,49206,14,0,0,19,0,0
88421,7,0,0,7,0,0,0,0,0
88419,50,80441,74406,18,69250,83217,32,80882,69447
88418,77,39583,47470,64,51250,52202,13,0,24169
88417,0,0,0,0,0,0,0,0,0
88416,100,0,43632,14,0,0,86,0,39551
88415,1142,35870,53496,604,41957,69117,538,24318,31665
88414,13,27708,25838,4,0,0,9,0,0
88411,33,0,87039,28,115556,98504,5,0,0
88410,65,30417,33303,37,0,0,28,0,0
88401,2389,33585,49019,1345,42287,58067,1044,22614,35435
88355,0,0,0,0,0,0,0,0,0
88354,50,0,0,50,0,0,0,0,0
88353,130,20833,28629,52,36250,35625,78,17222,17869
88352,1559,51733,71978,1167,56632,81642,392,40816,37312
88351,105,51042,63890,62,51726,66339,43,21806,60360
88350,108,40577,37888,63,0,0,45,0,0
88349,0,0,0,0,0,0,0,0,0
88348,201,0,62113,113,81349,94206,88,13711,19952
88347,32,0,0,14,0,0,18,0,0
88346,992,31964,46173,679,45274,47507,313,28295,43281
88345,3701,44525,59614,2253,61250,69446,1448,20164,40093
88344,25,93625,107584,18,0,0,7,0,0
88343,13,0,0,0,0,0,13,0,0
88342,5,0,0,0,0,0,5,0,0
88341,282,46894,58992,226,53448,67537,56,0,24505
88340,1112,36129,43911,679,44779,54149,433,20845,25221
88339,238,65667,68263,198,66500,69016,40,44688,40193
88338,73,0,0,47,0,0,26,0,0
88337,829,50655,57848,472,66563,77838,357,25465,31420
88336,169,39063,42322,145,47708,42394,24,0,0
88330,1107,47838,57563,907,48563,61305,200,33913,39911
88325,411,58625,66239,245,74726,84429,166,38049,39394
88324,98,82414,90697,95,85250,92978,3,0,0
88323,0,0,0,0,0,0,0,0,0
88321,69,32679,42797,21,100114,79986,48,19868,26527
88318,162,53750,74678,110,63500,96528,52,23833,28456
88317,834,44833,73893,478,53500,78323,356,31866,67945
88316,955,49044,63224,562,62851,61667,393,40673,62261
88314,45,0,0,45,0,0,0,0,0
88312,1237,47557,89896,823,0,119030,414,37798,31981
88311,454,24821,123173,244,65865,215725,210,0,15548
88310,14570,46716,64838,8470,62556,82072,6100,33424,39327
88301,494,38958,49774,242,55250,67855,252,30385,32411
88268,0,0,0,0,0,0,0,0,0
88267,501,63603,67735,369,60329,63351,132,70056,54514
88265,68,0,50634,62,0,51029,6,0,0
88264,0,0,0,0,0,0,0,0,0
88263,51,132578,124822,51,132578,122516,0,0,0
88262,4,0,0,4,0,0,0,0,0
88260,4564,62815,76624,3422,64464,82411,1142,35357,52997
88256,629,41964,59073,422,52378,68260,207,18945,38803
88255,11,0,0,11,0,0,0,0,0
88254,39,0,0,9,0,0,30,0,0
88253,282,72955,101085,228,103125,116099,54,22000,30204
88252,740,54417,65800,504,57639,73153,236,25481,47040
88250,98,0,43042,58,64000,62484,40,15870,14853
88242,2373,73628,83256,1912,80370,92189,461,23179,33326
88240,13409,58381,79495,9411,66568,90985,3998,31800,48612
88232,628,45893,56581,479,50598,60896,149,18375,29009
88231,1184,71444,75810,881,73194,80734,303,33162,53081
88230,1677,42431,55412,1215,52679,65830,462,20179,27009
88220,13996,69304,85050,9580,84484,96816,4416,36709,52404
88210,6718,56675,80738,4962,65493,85820,1756,34574,63367
88203,10860,38750,48802,6975,44626,56748,3885,21624,30374
88201,10150,56994,77652,6970,67264,89887,3180,27667,47525
88136,16,0,58119,8,0,0,8,0,0
88135,604,52024,64393,359,65893,74591,245,0,47937
88134,23,0,0,14,0,0,9,0,0
88132,85,46328,72308,70,0,82003,15,0,27060
88130,6296,42629,56246,3822,56706,67213,2474,27688,37934
88126,8,0,97425,6,0,0,2,0,0
88125,24,65833,74038,20,0,72410,4,0,0
88124,461,51339,68155,348,54000,73720,113,31875,47416
88121,74,23750,50045,53,31875,61894,21,20781,20138
88120,195,58415,63157,165,58862,65816,30,28750,48533
88119,515,30924,49884,251,66964,70506,264,20250,25657
88118,111,52563,53461,69,54063,64958,42,21250,34576
88116,150,45000,63441,113,54750,74389,37,27813,30005
88115,32,0,56156,9,111458,110300,23,0,34970
88114,25,0,146840,15,0,0,10,0,0
88113,48,0,45879,29,29792,31410,19,0,67963
88112,122,51510,66937,111,51536,69300,11,0,42091
88103,0,0,0,0,0,0,0,0,0
88101,17286,48374,60630,11176,53825,67412,6110,35478,43765
88081,4121,31186,49029,3013,31086,55047,1108,16687,29298
88072,612,35238,41339,577,31687,38675,35,0,0
88065,146,0,50477,88,82772,65834,58,0,26284
88063,4167,24095,40820,3173,28466,46434,994,13240,22208
88061,7643,37672,63369,4053,64119,88068,3590,23617,34879
88056,108,56053,47501,72,56447,55936,36,0,30631
88055,14,0,29586,8,0,0,6,0,0
88053,47,0,26949,7,0,0,40,0,0
88052,99,0,87243,60,0,129818,39,0,0
88051,69,0,46655,32,82083,65928,37,0,29986
88049,180,0,39648,74,0,35614,106,0,42465
88048,1035,46265,48994,546,39821,50485,489,57922,46784
88047,659,77250,77229,476,83011,83252,183,0,57344
88046,449,38973,49783,204,80625,68262,245,19810,34397
88045,1306,40000,52996,883,53125,62878,423,24875,32369
88044,1138,34012,53838,904,43750,61655,234,15343,21726
88043,624,35435,45357,301,48194,60624,323,26125,29742
88042,225,0,58526,107,0,59356,118,14258,57774
88041,551,32441,41215,379,32285,46038,172,0,30266
88040,34,0,55774,18,0,0,16,88750,89638
88039,309,40871,45015,231,0,45865,78,28750,33576
88038,86,0,107183,45,155742,137067,41,0,0
88034,8,0,0,8,0,0,0,0,0
88033,0,0,0,0,0,0,0,0,0
88032,126,22550,24602,64,0,0,62,0,0
88030,8500,33931,46464,5089,48438,57801,3411,18433,26507
88029,411,21660,24690,253,21621,27187,158,0,20690
88028,126,35500,40829,111,33482,36638,15,0,0
88027,139,0,60370,91,85313,80865,48,23182,21515
88026,547,31719,44971,289,49750,62036,258,17500,23781
88025,72,46389,53206,55,60078,63580,17,0,0
88024,14,0,0,14,0,0,0,0,0
88023,1057,51576,55072,490,61500,67849,567,0,43081
88022,300,38810,43679,188,41500,49545,112,0,33529
88021,6083,33290,47237,4874,38559,50698,1209,14579,30682
88020,314,49444,60898,263,54148,69103,51,17250,18590
88012,10310,51452,63814,7655,53174,68257,2655,41766,43352
88011,12633,63701,85774,7086,92674,117038,5547,30534,45103
88009,6,0,0,6,0,0,0,0,0
88008,3819,60103,74746,2684,54654,78626,1135,34932,54518
88007,8618,54631,72559,6444,62080,79492,2174,26691,43243
88005,10556,46260,61516,6366,54356,73561,4190,26835,40442
88004,0,0,0,0,0,0,0,0,0
88003,0,0,0,0,0,0,0,0,0
88002,319,64063,84141,292,64375,89073,27,0,30807
88001,14675,29532,43651,7782,34343,47901,6893,22017,35336
87943,81,33188,39322,50,37692,49788,31,0,0
87942,313,30586,36877,139,28977,35958,174,30577,35907
87941,294,0,24815,191,0,23049,103,0,28088
87940,135,0,36981,135,0,33880,0,0,0
87939,50,0,110554,37,0,0,13,0,0
87937,1005,41687,46344,715,49365,55002,290,0,24998
87936,249,23229,39669,137,36495,58734,112,14667,16348
87935,802,31415,46254,379,54904,68480,423,23003,25927
87933,51,0,0,51,0,0,0,0,0
87931,438,56250,58374,281,56175,67916,157,0,33976
87930,340,46726,53137,252,65500,67076,88,8750,13219
87901,3046,30842,59466,1507,61726,76587,1539,17491,40524
87832,83,16705,20727,23,0,0,60,11389,18618
87831,62,51786,49726,40,0,53998,22,0,41959
87830,373,27260,35086,155,43194,50216,218,19744,24328
87829,316,46667,51132,249,47396,50623,67,37981,42639
87828,120,22639,36923,83,0,42301,37,23681,24857
87827,131,0,39825,11,0,0,120,0,42337
87825,711,24321,44300,442,24500,55217,269,23047,25390
87824,32,0,0,32,0,0,0,0,0
87823,209,82366,68945,117,81027,61258,92,105750,78722
87821,327,32163,48477,152,0,76838,175,25813,23843
87820,44,38333,45020,44,38333,45020,0,0,0
87801,3159,44123,60649,1707,57578,75173,1452,26983,41058
87753,44,27875,23480,39,0,0,5,0,0
87752,297,37116,52877,229,0,58748,68,30000,32757
87750,0,0,0,0,0,0,0,0,0
87749,89,0,0,42,0,0,47,0,0
87747,611,51875,60504,343,63578,75765,268,24286,38565
87746,43,65489,57521,7,0,70071,36,65543,55081
87745,398,43438,56748,330,0,62351,68,0,29557
87743,107,30139,140547,52,0,260738,55,21484,24880
87742,185,71556,66090,123,74453,81409,62,0,35700
87740,3558,34982,46310,1973,44824,58997,1585,21875,28726
87736,16,0,0,2,0,0,14,0,0
87735,77,12594,11917,0,0,0,77,12594,11917
87734,107,0,39885,60,60577,52670,47,15893,23562
87733,26,39375,62577,17,58750,63694,9,37917,28856
87732,677,35644,39246,373,43411,43450,304,16587,34088
87731,127,51042,52213,127,51042,52213,0,0,0
87730,6,0,44867,3,0,0,3,0,0
87729,49,24519,27129,17,0,0,32,0,25269
87728,197,45469,53859,142,40682,56764,55,28229,33131
87724,29,0,0,0,0,0,29,0,0
87723,120,0,49711,67,0,0,53,0,0
87722,251,0,33912,130,47833,37897,121,0,29631
87718,174,57500,56013,74,83125,76345,100,31250,40967
87715,251,21513,27623,107,26659,36482,144,15357,21040
87714,579,28413,42428,292,47500,54431,287,19920,29470
87713,177,87969,74306,90,115300,107336,87,0,0
87712,244,0,28690,33,0,0,211,0,17377
87711,297,18729,22681,191,0,18762,106,18900,20592
87710,675,49896,62063,442,54907,70416,233,34031,45606
87701,7884,33998,51316,4342,42422,57586,3542,22712,35594
87583,206,0,55796,114,0,0,92,16875,17442
87582,293,0,94406,198,0,117257,95,0,0
87581,14,0,0,14,0,0,0,0,0
87580,226,0,57473,92,38977,36685,134,0,0
87579,328,73373,69438,228,80833,77596,100,0,49203
87578,123,0,77541,58,165000,135353,65,14196,25955
87577,155,28068,50061,53,137546,111026,102,0,18383
87575,345,63147,66842,189,65250,84829,156,0,42438
87574,40,0,42663,15,0,0,25,0,0
87573,11,0,0,0,0,0,11,0,0
87571,4869,38088,85703,2667,49375,109536,2202,32635,55847
87569,299,0,58085,172,70227,61210,127,17240,53852
87567,392,38500,51942,154,38488,40471,238,0,50442
87566,713,36964,54564,397,51058,69506,316,0,32365
87565,153,0,40588,153,0,40588,0,0,0
87564,90,0,0,22,0,0,68,0,0
87562,138,0,63609,96,0,75216,42,0,0
87560,664,15876,34998,229,0,57207,435,9300,20270
87558,375,0,75640,268,0,88459,107,17750,38480
87557,1943,43777,53810,1142,58788,67025,801,23003,33339
87556,826,43190,51361,473,54612,68174,353,18618,27132
87554,0,0,0,0,0,0,0,0,0
87553,523,31815,46475,316,39186,49268,207,20078,38507
87552,1148,29127,54966,650,43750,68829,498,17193,27355
87551,106,0,120090,48,0,0,58,0,0
87549,487,53349,82743,305,0,92730,182,53109,65720
87548,447,0,48797,303,54176,61237,144,20066,18651
87544,7895,119266,142293,5005,141569,168994,2890,82278,92419
87543,44,0,0,0,0,0,44,0,0
87540,506,55867,74242,249,84321,112856,257,26376,36313
87539,21,0,0,0,0,0,21,0,0
87538,224,25380,35406,54,0,0,170,18077,26538
87537,1048,42702,53710,637,44742,61350,411,20208,38817
87535,933,40657,60323,455,70781,85439,478,24034,36047
87533,75,24583,38801,33,65750,54870,42,13804,20686
87532,6897,42280,57966,3920,55269,71204,2977,23537,36771
87531,164,0,112377,130,56190,139893,34,0,0
87530,271,17041,19242,203,0,0,68,0,0
87529,1599,52934,75505,879,88203,96596,720,34441,48373
87528,740,49375,55563,479,56098,62382,261,31339,34614
87527,213,41576,37435,50,42174,48580,163,0,34017
87525,17,63661,68312,17,63661,68312,0,0,0
87524,34,0,0,0,0,0,34,0,0
87523,243,0,73192,117,0,122405,126,0,27494
87522,1152,65031,68364,800,70200,75749,352,43264,51580
87521,328,30938,45297,157,49760,65918,171,12309,24223
87520,504,36988,60510,315,64154,83631,189,19137,21947
87519,239,0,45082,78,83190,69832,161,0,33092
87518,0,0,0,0,0,0,0,0,0
87517,185,0,61462,33,0,0,152,0,44770
87516,41,0,50568,24,0,0,17,0,0
87515,64,0,0,64,0,0,0,0,0
87514,351,43620,67406,261,0,70630,90,44844,58056
87513,440,31939,47884,125,0,64887,315,31845,41137
87512,35,0,0,35,0,0,0,0,0
87511,588,51500,52419,479,63457,58782,109,0,24262
87510,448,0,45551,137,113401,92919,311,0,24684
87508,6988,74992,104314,4482,91985,125511,2506,50423,64821
87507,18550,54857,72207,11876,59412,80467,6674,42405,52674
87506,5935,70625,111274,3802,96857,134064,2133,39063,67058
87505,14716,62894,86143,7216,81736,111397,7500,43829,60367
87501,7805,64905,109425,3687,90029,153929,4118,48071,67656
87499,167,40905,52263,132,0,63308,35,7917,10343
87461,431,27386,39283,320,24531,39748,111,13854,19734
87455,553,24602,43283,347,33854,48662,206,12625,27015
87421,516,50547,52875,391,57159,58314,125,0,28205
87420,3602,35113,49973,2831,38354,55337,771,16250,26894
87419,182,47404,61871,143,60129,65424,39,0,0
87418,341,72904,81548,265,73934,81019,76,0,79221
87417,1706,42331,54240,1426,50815,57638,280,27350,36718
87416,1531,38264,57464,1129,53606,68223,402,0,24528
87415,975,36908,60070,702,37221,63909,273,24727,49624
87413,5586,50690,64801,3939,56556,72640,1647,28915,39054
87412,500,44167,52575,351,48920,58393,149,43472,38870
87410,6500,47360,60430,4345,52121,67440,2155,31004,42374
87402,3593,65835,85158,2582,71214,92917,1011,40515,62016
87401,15885,52424,67708,11030,61944,73625,4855,35111,48561
87375,940,37273,47809,766,44333,52340,174,12500,17512
87364,342,22344,33492,233,28365,38638,109,11477,21735
87357,230,38906,43040,162,34583,45198,68,42581,31700
87347,84,65870,59268,50,77685,72730,34,0,0
87328,808,26714,38676,613,30917,40669,195,12708,25546
87327,1851,43125,52122,1571,43194,51471,280,42321,36410
87326,511,27006,42671,391,30809,47301,120,12273,22733
87325,1003,29077,38941,676,38333,46834,327,12664,17981
87323,1412,26610,41925,958,31875,48344,454,15776,25121
87322,57,110464,83044,51,110679,88129,6,0,0
87321,853,45568,63096,594,78500,79383,259,9505,24127
87320,132,27000,40755,91,33750,50553,41,16250,19007
87319,537,24427,32734,359,35707,42760,178,8102,11983
87317,479,0,49787,408,0,51560,71,0,21794
87316,421,65391,94759,305,66797,109738,116,0,51759
87315,45,19844,27093,10,0,0,35,0,0
87313,1868,36589,47964,1194,43061,53910,674,13827,32390
87312,146,24706,40477,79,33750,39758,67,20956,20809
87311,1123,28008,37019,782,36190,44628,341,9035,16241
87310,285,35104,49678,217,45694,52361,68,22963,20287
87305,830,31442,46184,660,35714,51041,170,10000,17436
87301,8043,45498,59125,5267,51650,64385,2776,31317,46630
87144,15096,72585,87289,11657,78776,94344,3439,53383,55087
87124,20970,61495,76666,14866,72935,86952,6104,39591,48058
87123,17889,51139,71489,10547,63466,86226,7342,33884,46006
87122,7045,126278,158396,5593,146067,178807,1452,66000,78149
87121,24950,43847,54424,16948,45752,56589,8002,29623,42453
87120,25274,71041,85826,16309,82005,95353,8965,49657,61929
87117,0,0,0,0,0,0,0,0,0
87116,1385,63021,68129,940,65263,64772,445,59125,71302
87114,25903,68186,83725,16944,78531,95164,8959,45859,58380
87113,5910,76059,100415,4010,97583,119401,1900,39542,54780
87112,17893,56019,69872,10003,73142,85482,7890,33091,46901
87111,25443,69335,93263,14452,89566,114254,10991,47039,62544
87110,18064,50673,67885,9017,70793,86659,9047,33358,46363
87109,18211,50618,71827,9485,69087,93053,8726,34223,47329
87108,16796,31158,47047,6936,38722,57005,9860,25936,39067
87107,12657,51042,76362,7180,60931,91500,5477,32202,52629
87106,11480,43360,64670,4827,75656,90937,6653,30186,43165
87105,19317,41810,55366,12719,50945,62941,6598,25953,35901
87104,5801,58715,78899,3577,63106,90247,2224,37007,53239
87102,9451,30958,44888,3115,33800,46641,6336,26680,42371
87083,252,53611,64219,117,70625,83496,135,40179,46205
87072,178,57500,78290,132,66750,98789,46,13571,19467
87070,20,0,0,0,0,0,20,0,0
87068,1965,56964,70408,1311,75547,84141,654,33071,41957
87064,78,15930,15415,14,25000,0,64,15988,16027
87063,106,32065,54948,57,0,71626,49,31359,34745
87062,431,36382,43849,303,36250,44980,128,22500,29522
87061,171,24915,30592,59,0,0,112,23239,28964
87059,4117,79880,92799,3085,95202,105705,1032,32885,49209
87056,344,71154,84339,254,79519,88529,90,41176,67466
87053,388,33611,38917,224,43000,50300,164,0,20452
87052,575,36734,54665,469,38516,61902,106,9868,20157
87051,308,66620,68753,308,65370,65968,0,0,0
87049,386,50417,57103,316,54000,59071,70,25000,11700
87048,3869,84398,114942,2619,120265,138449,1250,46534,63803
87047,1837,92043,107340,1325,99592,120537,512,60581,72776
87046,80,0,33504,58,0,36231,22,0,26309
87045,473,30550,40246,311,29408,42224,162,0,27722
87044,77,49297,72244,43,0,70793,34,0,61397
87043,2210,94357,110597,1396,109719,130502,814,53077,76268
87042,1433,54375,91071,1004,72546,109892,429,35576,47026
87041,351,38860,46984,211,67679,62693,140,13750,19368
87040,114,32955,53096,88,0,61663,26,0,24104
87038,128,36944,44440,112,42857,43270,16,0,0
87037,267,11250,25383,173,21518,35064,94,4000,6471
87036,643,45240,55709,395,56985,70223,248,19714,32548
87035,2485,40871,54930,1899,55400,58150,586,22738,27324
87034,515,55313,60601,429,55938,62722,86,21000,28385
87032,93,0,0,39,0,0,54,0,0
87031,14578,52366,64587,10137,58409,70696,4441,32945,46817
87029,147,46202,39071,93,46490,44587,54,0,29572
87028,100,40125,38339,64,41250,51333,36,20682,15239
87027,122,0,37349,75,0,37859,47,0,36536
87026,1081,34522,54296,795,42288,63154,286,14709,27659
87025,713,125103,111089,474,126767,135466,239,24922,61997
87024,567,45337,64965,493,47067,68597,74,0,32012
87023,215,34336,44293,178,34609,47538,37,0,0
87022,314,36964,45788,179,53646,55728,135,0,28116
87021,1123,41563,60124,645,50703,61115,478,0,54488
87020,3779,44723,57729,2591,59219,63566,1188,29922,39651
87018,136,14500,18797,96,13750,17427,40,11250,12175
87017,109,90893,75294,93,104688,83461,16,0,0
87016,1365,35974,49246,918,57848,59218,447,19707,28087
87015,6066,62058,73770,4237,72217,85768,1829,34177,44509
87014,299,0,47152,154,65595,75949,145,9447,16566
87013,1794,24858,36777,1341,25721,38676,453,13417,25106
87012,145,60184,58763,91,0,58281,54,61146,59576
87011,20,55500,60090,16,56500,69069,4,0,0
87010,589,32350,42374,241,42250,51641,348,0,35957
87008,1149,99018,109449,743,130524,128177,406,62051,75174
87007,241,32583,39543,191,34464,41584,50,0,25092
87006,200,90156,77582,160,100417,85813,40,0,44660
87005,86,0,186451,31,0,0,55,0,0
87004,4728,51357,64199,3099,59920,73252,1629,33844,45176
87002,8023,46301,61804,5333,51205,66857,2690,30619,46732
87001,997,38295,75915,657,68542,100165,340,0,26629
86556,507,20982,31205,350,22917,33506,157,0,22121
86547,280,27500,37742,217,33750,45333,63,8438,11594
86545,349,22697,31632,218,30000,37697,131,13068,19049
86544,357,25987,42332,270,33438,49597,87,11932,16634
86540,279,20048,25860,180,22222,30444,99,7772,11140
86538,560,25446,33956,304,36250,44155,256,11667,21775
86535,385,27848,38128,262,29672,46829,123,9234,16338
86520,447,20313,30853,279,31094,40222,168,8375,12029
86515,1185,35332,46443,722,42115,54940,463,19620,29414
86514,885,33977,44196,655,41442,49384,230,11912,24893
86512,879,26904,35090,623,27455,37751,256,9575,21914
86511,1051,34107,48099,763,42047,58084,288,11176,19151
86510,1286,24926,37804,905,34620,41123,381,10990,29543
86508,189,21875,33266,114,33000,44843,75,8828,15668
86507,582,19239,29885,390,27700,36081,192,9911,14873
86506,391,21691,38251,240,36250,49248,151,15313,15617
86505,2130,23553,35052,1482,29889,39434,648,8604,16318
86504,1965,35820,51316,1387,41783,58311,578,0,30999
86503,3368,23862,35624,2041,24926,39120,1327,20392,29946
86502,390,16500,31213,212,35862,46641,178,7891,12838
86445,116,53148,76438,52,0,0,64,52963,45906
86444,768,48333,47114,389,65590,70429,379,19173,21040
86443,0,0,0,0,0,0,0,0,0
86442,14715,42776,58665,8854,48628,57806,5861,27911,55000
86441,992,28833,40718,592,48013,52428,400,20542,23387
86440,3134,50858,64440,1997,59265,79082,1137,30650,34886
86438,397,30375,48148,269,32731,51973,128,27857,40108
86437,32,0,44219,15,0,52287,17,0,37100
86436,859,27955,41720,424,0,55843,435,0,27954
86435,0,0,0,0,0,0,0,0,0
86434,588,38095,45917,459,40481,48802,129,23438,26909
86433,26,0,0,26,0,0,0,0,0
86432,1654,35292,35140,1047,37680,37605,607,30154,29495
86431,243,26063,34947,114,36413,43347,129,19125,25514
86429,3888,44020,67371,2402,56167,79969,1486,27813,44777
86426,6532,59108,69421,4583,67977,79243,1949,31125,39424
86413,5042,39183,47300,2917,48566,50691,2125,28890,38363
86411,117,37679,54662,41,106250,107746,76,32895,26025
86409,12524,41446,54921,7691,51993,65984,4833,25649,33740
86406,11032,61206,79988,6736,70630,88071,4296,45949,65319
86404,7499,58065,75527,4939,72619,87208,2560,36316,46760
86403,8202,47500,64676,4616,59444,76699,3586,30000,45571
86401,10899,53679,67506,7401,59394,76201,3498,32366,45868
86351,3453,67659,85123,2013,83945,103587,1440,54762,57307
86343,43,0,71944,34,106111,85591,9,0,0
86338,214,58500,76097,122,82500,93885,92,0,52509
86337,701,34779,55690,436,61298,69642,265,22083,26342
86336,5988,54714,80480,3274,77138,107919,2714,37083,46637
86335,2489,42762,54128,1522,67764,69621,967,22610,28122
86334,1818,50300,67144,1383,64236,75326,435,26382,36658
86333,2628,43500,51610,1546,50357,61817,1082,28517,36195
86332,1076,31579,46828,578,61413,69212,498,0,20158
86331,205,44904,75709,106,93333,104119,99,30568,39317
86329,415,47863,56948,256,0,54104,159,65048,55666
86327,4998,57308,73989,3186,69819,87368,1812,32669,41039
86326,11153,44716,58936,5742,61300,74575,5411,28635,39160
86325,2678,63679,68004,1435,70170,82425,1243,41142,47058
86324,2278,29343,49961,1258,51410,68094,1020,17228,25726
86323,7436,48230,68083,4851,67180,80832,2585,28719,42132
86322,4110,43543,59655,2823,49430,67295,1287,19600,35132
86321,826,64875,73805,633,72639,74570,193,53472,57326
86320,1039,37596,52105,697,41696,57964,342,24615,37601
86315,3376,61262,75051,2544,60833,72269,832,46667,55839
86314,15802,51141,63620,10105,62909,72089,5697,32999,42589
86313,0,0,0,0,0,0,0,0,0
86305,8515,67420,100642,5746,79094,125495,2769,36461,47356
86303,8821,58435,80789,4922,83986,105349,3899,39928,49062
86301,10248,57432,75678,6198,67027,88579,4050,37595,53207
86054,496,26071,43681,285,44659,58872,211,8209,16499
86053,671,51103,59876,554,55068,65706,117,11354,24028
86052,0,0,0,0,0,0,0,0,0
86047,4273,42875,57224,3128,53649,63672,1145,20893,35495
86046,2705,56341,67418,1838,64762,74113,867,40821,49380
86045,3385,46723,55706,2459,52735,62833,926,12738,28335
86044,1057,19016,33232,682,22404,34178,375,12448,29451
86043,635,40665,43481,505,42031,47533,130,8611,16500
86042,623,61375,65078,407,55625,65906,216,70524,59187
86040,3628,62658,65507,2367,64966,74031,1261,21892,40010
86039,401,31699,50659,282,46667,64023,119,12697,17359
86038,23,0,0,23,0,0,0,0,0
86036,221,54306,67926,111,66827,89997,110,52611,45535
86035,550,44000,54823,405,56442,67232,145,12560,18655
86034,550,18289,35638,391,24659,40111,159,10625,17243
86033,2270,26451,41570,1617,29408,46737,653,17991,23378
86032,581,65110,74741,423,66382,78982,158,46250,52819
86031,549,17109,23786,377,22298,28411,172,7819,10096
86030,486,31813,43320,391,33315,46187,95,9750,19583
86029,21,0,0,21,0,0,0,0,0
86028,27,0,0,27,0,0,0,0,0
86025,1851,46391,59191,1239,52157,69451,612,35000,36255
86024,418,79643,89466,313,83867,100035,105,51875,57378
86023,707,54141,65282,213,102883,103765,494,34272,48688
86022,694,42386,54740,445,51197,67941,249,30807,29659
86021,867,54792,63475,816,48824,62273,51,33839,35692
86020,584,31500,42751,423,39766,50304,161,15446,18807
86018,283,67813,83817,193,75795,98120,90,43690,52300
86017,495,69844,85842,221,90048,116589,274,63200,61042
86016,14,0,29214,6,0,0,8,16667,13875
86015,170,0,74322,106,0,0,64,0,0
86011,194,15938,20140,8,0,0,186,15000,19481
86004,13534,67650,84407,8873,79122,96595,4661,47551,57910
86003,10,16875,18540,8,0,0,2,0,0
86001,17753,60287,87804,8679,91680,121861,9074,37623,49723
85942,11,0,0,11,0,0,0,0,0
85941,2672,37188,48525,2217,37480,51335,455,14960,24478
85940,440,57823,61462,224,54352,76132,216,58387,46248
85939,1624,57188,63269,1258,73455,73168,366,0,26980
85938,954,47469,62245,571,64911,73893,383,38229,42903
85937,2707,48869,60037,1887,61750,70571,820,19024,32205
85936,1079,61486,63011,855,62125,64104,224,0,36429
85935,2057,57312,79964,1436,81528,88720,621,43530,59360
85934,238,0,107051,173,180732,140745,65,18850,17375
85933,1336,38514,47784,738,48571,57842,598,30957,34624
85932,204,0,54843,204,0,54843,0,0,0
85931,73,72813,63540,67,73080,67087,6,0,0
85930,304,53333,59108,241,69583,60556,63,28828,31395
85929,3184,45503,62665,2003,52961,73798,1181,28613,42050
85928,376,51792,60169,259,65625,67125,117,39844,44769
85927,78,76144,72914,78,76144,72914,0,0,0
85926,235,25000,22537,223,25000,20687,12,0,0
85925,1662,66284,72617,1262,71699,81398,400,36034,42489
85924,1124,41613,53167,748,53093,65619,376,25599,28395
85923,238,41048,56308,132,47361,50643,106,0,60920
85922,40,46389,58285,40,46389,58285,0,0,0
85920,315,59803,67723,216,68542,81658,99,0,37320
85912,145,20563,32483,73,0,51522,72,15147,13181
85911,370,15385,27516,257,17546,31307,113,8693,18277
85901,7380,48383,62032,5095,53612,68408,2285,33735,45426
85757,6144,58961,68308,4860,60434,72552,1284,33205,39317
85756,11730,53995,68790,8919,58819,73017,2811,38096,45673
85755,7435,91817,118665,5421,108883,136847,2014,50975,69613
85750,11562,84191,130514,6815,129717,170870,4747,53519,71322
85749,7991,92238,118945,5870,109333,133105,2121,61369,78457
85748,7779,80913,97557,5293,90522,113605,2486,51588,60280
85747,8739,95241,100709,6840,97986,106547,1899,69453,73589
85746,15602,54413,64170,11950,57318,65102,3652,38490,46064
85745,16596,54996,75437,9129,77929,93768,7467,40337,50797
85743,11441,74653,88819,8595,87526,99901,2846,44670,51710
85742,11154,80808,98653,7928,87379,101176,3226,56881,87110
85741,13989,63092,73330,8490,69334,82574,5499,43562,54666
85739,9126,68558,94004,6600,83047,109055,2526,40037,53234
85737,9756,91936,108085,6685,104472,119345,3071,72635,81660
85736,1783,44426,55624,1083,49633,66320,700,22125,37468
85735,4070,50938,63854,2843,58359,69092,1227,41609,49503
85730,15289,53080,64585,9731,62819,71862,5558,35532,47531
85726,0,0,0,0,0,0,0,0,0
85724,0,0,0,0,0,0,0,0,0
85723,0,0,0,0,0,0,0,0,0
85719,18119,34013,48571,5949,51318,71104,12170,26328,35629
85718,12818,93185,142567,7275,136383,188566,5543,50871,80550
85716,15259,42147,60003,6089,57146,77956,9170,33003,44820
85715,8792,71949,94499,5309,86685,116191,3483,44035,59605
85714,5132,35260,48721,3042,39986,53666,2090,22434,38141
85713,16758,39939,50730,10956,51107,58790,5802,24198,32677
85712,16384,37524,53990,6826,50045,68554,9558,30751,41881
85711,17212,42497,54899,9510,52520,62659,7702,31561,42378
85710,24780,46055,59440,12438,64796,74252,12342,34487,42651
85708,1212,58486,61996,1059,58574,63311,153,51719,52214
85707,0,0,0,0,0,0,0,0,0
85706,17260,39655,50407,13131,40458,50416,4129,26077,35467
85705,24304,30885,42888,11513,40391,54710,12791,21721,30847
85704,15591,62544,91136,8062,93534,118640,7529,40865,59299
85701,2750,45862,71602,807,53021,84005,1943,41616,64744
85658,4734,90114,111834,3803,99671,120725,931,48533,70660
85654,0,0,0,0,0,0,0,0,0
85653,7057,70131,77213,5213,75071,82983,1844,52232,50841
85650,6591,69437,85986,4538,91287,99149,2053,43067,55965
85648,6170,51670,73795,4937,55497,79989,1233,27251,44207
85646,667,68267,92101,392,76719,104595,275,34213,72075
85645,654,44116,49366,457,47202,54744,197,27639,36101
85643,3144,43769,57875,2039,52214,67750,1105,26368,38250
85641,9405,101108,113613,7944,106365,118664,1461,51454,67325
85640,68,0,107228,68,0,107228,0,0,0
85638,830,43696,56510,473,56705,76290,357,22899,29394
85637,476,78071,95313,389,79769,102284,87,50313,60902
85635,14872,51701,68331,8548,63469,79290,6324,36386,49818
85634,1632,31111,42615,1243,37159,45402,389,17212,28921
85633,5,0,0,0,0,0,5,0,0
85632,392,41167,53531,212,51400,69363,180,19000,31781
85631,1722,41250,48683,1068,40288,46593,654,46250,47994
85630,938,42576,63404,525,49728,73208,413,0,50942
85629,7943,90645,95816,6435,95077,102664,1508,43784,59722
85627,481,60994,70532,357,68813,76642,124,30192,51208
85626,261,36058,45398,205,40871,49282,56,30600,31179
85625,998,44211,55722,632,58750,72178,366,19571,26342
85624,584,38720,56251,327,55179,67650,257,30197,41255
85623,2490,55942,83845,1601,65469,82444,889,0,85996
85622,3435,62210,84327,2169,75246,98120,1266,42222,60696
85621,7789,29333,48518,5454,36841,58758,2335,14714,22863
85620,369,38403,38261,217,48032,51922,152,0,18757
85619,28,35313,37175,8,0,0,20,0,0
85618,611,38589,46215,430,54167,54914,181,16593,22614
85617,683,34028,44722,302,67922,69399,381,16935,24893
85616,2472,45654,58370,1490,59191,69313,982,24235,40076
85615,3967,77731,86780,2739,86276,97743,1228,53058,60241
85614,13572,52594,69843,7886,68020,83254,5686,35706,50815
85613,954,83167,85198,936,81979,83278,18,0,0
85611,467,61964,75275,311,88839,93425,156,26944,33263
85610,372,45000,67864,227,53250,68291,145,23375,64449
85609,176,0,110252,159,0,85942,17,0,0
85608,0,0,0,0,0,0,0,0,0
85607,5779,38164,53086,4040,48278,56742,1739,23417,41425
85606,415,51523,59466,282,64200,71679,133,32813,32802
85605,254,40551,42432,200,41186,46147,54,16500,27556
85603,3476,38944,50986,1458,56250,68082,2018,28929,38495
85602,4064,50838,58471,2494,63989,70612,1570,26830,37375
85601,416,29250,43328,172,51053,58861,244,22750,32378
85554,257,29952,41981,109,48750,60836,148,23152,26035
85553,1009,42377,41101,471,44575,48555,538,22222,31278
85552,2077,63880,77000,1532,76267,86408,545,41397,47781
85551,130,64919,75063,91,64879,80292,39,65125,59410
85550,1406,34881,50268,1183,36566,46008,223,0,21150
85546,6199,52598,60620,4204,61057,67568,1995,31715,39000
85545,370,22234,33421,135,22917,32159,235,0,34146
85544,1497,46820,59697,930,53209,66835,567,34952,46036
85543,1308,47333,62155,988,57760,69011,320,32400,39752
85542,701,34848,40551,604,37375,41775,97,15938,16731
85541,10310,51161,67608,6037,58847,82007,4273,34799,45493
85540,1056,71585,84264,776,70669,80900,280,73726,88129
85539,1584,41563,60296,1009,53224,69825,575,25560,34896
85536,170,86667,80399,136,105769,84586,34,58625,52982
85535,0,0,0,0,0,0,0,0,0
85534,974,53730,74115,725,63750,81347,249,30625,47944
85533,1225,56473,70302,838,60833,80925,387,38242,46637
85531,167,78365,75138,95,76761,76855,72,0,0
85530,477,34107,47610,320,0,61258,157,12917,16445
85501,5233,56922,64493,3546,66327,72618,1687,30028,41477
85396,8100,99477,104392,7105,98569,105118,995,67599,79305
85395,10092,91920,113146,7558,106900,125771,2534,58505,72301
85392,12642,73652,88203,9356,83368,96401,3286,42548,56033
85390,4262,53352,83516,2603,74408,95950,1659,31589,62327
85388,9855,78597,95312,8528,81171,96161,1327,51521,63141
85387,5191,72675,79207,3722,79335,86634,1469,52426,57240
85383,18456,118125,141638,15845,123657,147813,2611,69233,97254
85382,15803,72553,85855,10480,86722,99110,5323,45285,56266
85381,9180,77254,92278,6113,93159,108010,3067,41859,56047
85379,14048,81310,92903,11649,84490,95824,2399,51161,66593
85377,1773,109883,161557,1239,114397,176102,534,56923,120129
85375,17328,57452,70882,10307,74864,86837,7021,33012,47256
85374,22266,61565,75225,15193,71002,83474,7073,41725,53313
85373,9212,60077,71146,6043,69038,80628,3169,34784,50566
85371,109,21250,26563,76,23636,25367,33,0,17358
85367,10783,46939,60148,6645,58525,70826,4138,29654,41174
85365,19734,56409,71736,14241,65398,80380,5493,31148,46680
85364,26560,46644,65189,18538,53536,72180,8022,25811,44629
85363,2498,42564,53573,1340,49921,65968,1158,23789,34265
85362,407,41010,45779,229,42482,51095,178,33000,38939
85361,2240,59970,78816,1797,70239,81988,443,55382,59602
85360,53,54583,63487,24,83000,72300,29,48854,55186
85357,287,31641,32176,109,44821,55935,178,13571,17626
85356,2097,52654,61097,1527,63674,68848,570,23571,34093
85355,3808,94246,108344,3395,98666,111319,413,68661,75293
85354,2436,63468,71350,1899,66184,75096,537,36723,50300
85353,10855,76179,81555,8862,72942,79825,1993,59871,67766
85352,197,29250,39153,138,0,36817,59,35673,38993
85351,17511,42875,55266,8193,58533,69594,9318,31268,42383
85350,6143,52843,57494,5274,51195,57853,869,0,43170
85349,8356,41648,54281,7341,41801,55420,1015,30291,38032
85348,1507,43242,50216,1210,47500,56252,297,21557,23915
85347,131,37961,44908,116,38421,46597,15,27250,31853
85346,2556,20611,36994,1361,37636,48943,1195,13486,20030
85345,20384,52904,64524,13169,63362,71499,7215,37006,44759
85344,4084,41514,58107,2471,49873,68738,1613,24542,38267
85343,28,0,83946,28,0,83946,0,0,0
85342,913,44792,64742,503,57216,86958,410,27067,37393
85341,24,0,0,24,0,0,0,0,0
85340,12170,98533,112884,9866,103304,119084,2304,63469,78676
85339,14022,79310,95459,11203,82262,98106,2819,56776,63689
85338,16472,80750,95911,12937,85264,101626,3535,52415,66518
85337,811,41278,59583,563,41728,60917,248,36214,51758
85336,348,36311,40016,348,36311,40016,0,0,0
85335,10873,59975,67770,8505,60618,67234,2368,46589,56444
85334,536,38393,44860,344,41700,48574,192,16944,37250
85333,293,29219,46277,153,41964,59461,140,24113,31596
85332,846,52600,59648,692,58280,66106,154,30054,30629
85331,12680,100554,124428,9739,115507,136343,2941,60836,81171
85328,172,38113,57327,76,0,53053,96,28571,60710
85326,16218,65721,78972,12951,70314,81822,3267,46934,53365
85325,677,29696,41770,419,41292,51662,258,14722,25705
85324,1296,37165,52192,596,40909,53223,700,32273,46830
85323,13318,59699,73234,10018,62038,75706,3300,44212,55793
85322,252,38654,58654,134,75227,75888,118,18438,22090
85321,1528,37418,48882,916,42847,50005,612,25673,44250
85320,278,26250,53977,180,38382,55791,98,21000,50646
85310,6890,102103,128361,5453,111803,140094,1437,54066,69039
85309,0,0,0,0,0,0,0,0,0
85308,25087,80474,96416,17008,93774,110211,8079,47835,62681
85307,3986,62949,76991,2620,62241,74716,1366,60458,71680
85306,8545,64135,72781,5566,76612,82039,2979,41216,47805
85305,4297,84853,97550,2943,89375,99247,1354,68974,81908
85304,9882,68190,83061,7141,74967,91026,2741,40139,49075
85303,9776,58736,76493,7850,57992,75230,1926,41912,61542
85302,14344,47927,62954,8681,57883,73600,5663,36110,43113
85301,21921,38454,48381,13788,42477,52906,8133,25272,33547
85298,10656,111763,131455,8900,121533,141889,1756,56000,74867
85297,9279,107651,120443,7736,114839,126167,1543,53466,69414
85296,14525,98397,117877,11674,106916,126534,2851,61383,71419
85295,15781,101090,118579,11486,118503,132682,4295,65246,71858
85286,15448,102137,127487,11426,112722,137464,4022,69262,93987
85284,7406,127500,156784,5619,138276,170274,1787,94792,106917
85283,20435,65738,84360,11609,80390,96886,8826,53864,64770
85282,24431,61700,73501,12003,75240,87478,12428,48363,56248
85281,25889,42545,56421,8094,49080,67204,17795,37170,49719
85268,11500,87223,124322,7784,100867,147682,3716,57173,74428
85266,5759,134658,181640,4618,154583,200170,1141,65208,104568
85264,427,68250,126116,304,62917,86311,123,0,211013
85263,1577,121174,150870,1266,130962,167337,311,76518,81252
85262,6034,138924,195176,4484,148674,212072,1550,81897,144064
85260,19254,86274,117480,10329,109606,147084,8925,64347,81435
85259,10034,111284,161030,6776,135862,195062,3258,70849,84787
85258,13238,92100,137817,7900,123362,169903,5338,60854,89226
85257,14958,65948,84233,6254,87216,103461,8704,54658,68160
85256,1621,38427,46853,1202,42167,48173,419,17468,32908
85255,18074,135727,190676,13260,158649,214925,4814,84734,119130
85254,19040,97780,129564,12694,113569,149357,6346,57770,87838
85253,8082,170224,300401,5733,213551,354549,2349,61081,166715
85251,21671,71662,122491,8345,97314,158779,13326,61891,98937
85250,8757,83410,100478,4350,99063,126070,4407,54970,74210
85249,14047,121224,144446,10914,132209,159157,3133,56883,80454
85248,17269,79190,129093,11305,108650,166294,5964,42097,57269
85234,15787,91010,114694,12036,102196,127123,3751,54926,68483
85233,13256,89000,107121,9099,99621,119033,4157,55321,75422
85226,15032,91825,108480,10237,105779,118554,4795,61524,79946
85225,25232,66024,80394,16373,77098,89040,8859,45538,61220
85224,17653,75220,88976,10602,82538,97563,7051,58501,69928
85215,7423,73873,103048,4904,90636,123878,2519,43266,59078
85213,13012,77942,104014,9629,89331,117314,3383,42622,60260
85212,12045,104235,125113,10184,111415,131424,1861,62375,71284
85210,15048,46258,61878,8646,52667,70440,6402,38665,44950
85209,16815,64663,82134,11371,74871,90987,5444,46701,55481
85208,15184,54982,66040,9837,66087,76904,5347,32137,41895
85207,19041,77750,107296,14200,92376,121101,4841,41452,60400
85206,15759,51572,67395,8982,63743,76328,6777,35193,51857
85205,18304,57850,77982,11407,71637,92183,6897,35913,50191
85204,22969,55906,71375,15394,60212,76230,7575,43448,54056
85203,13123,60412,80826,9306,71297,88737,3817,41487,56662
85202,15919,54047,71010,8957,65548,80792,6962,40876,55035
85201,20510,46348,58458,11502,49347,63672,9008,37318,47011
85194,3082,62932,80063,2463,67048,84564,619,47019,56848
85193,1635,39813,75318,1423,51302,82480,212,23333,22996
85192,1062,55521,48945,583,51597,52500,479,55508,43697
85173,1375,33175,43865,656,57162,64677,719,21318,24379
85172,496,57400,67520,372,66658,79008,124,0,0
85147,1241,26136,40930,709,38652,52895,532,14115,16017
85145,1175,75035,78834,949,72260,82139,226,0,52843
85143,13419,73036,81263,10421,79813,87690,2998,44302,50830
85142,23221,95901,113695,19259,100999,119189,3962,53378,71139
85141,173,59250,66845,140,0,67867,33,0,46185
85140,16084,76744,94843,12983,83209,101043,3101,42065,62628
85139,5645,61011,73730,4318,70472,81889,1327,34016,43032
85138,12433,76353,87640,9809,80967,91440,2624,51029,62873
85137,967,55089,65638,613,63594,74159,354,32813,46325
85135,154,34500,39027,103,39297,48399,51,0,20098
85132,8465,58390,70403,6069,61518,74516,2396,31302,52392
85131,4043,40902,53660,3070,42004,55318,973,27545,43732
85128,4811,50785,69737,3520,56332,74432,1291,34746,43508
85123,4337,42254,55092,2555,51511,67858,1782,26571,33017
85122,19572,53772,84047,13695,60107,97045,5877,32281,47900
85121,597,15583,30222,248,30625,51184,349,0,12806
85120,13855,44867,60382,7451,58310,70940,6404,28739,45745
85119,11442,58474,71524,6870,71331,81669,4572,33453,54751
85118,6470,68350,91679,4649,76343,99451,1821,44508,70763
85087,3229,92528,103443,2143,98583,109883,1086,71007,86839
85086,15537,103122,127553,11764,117358,145020,3773,59253,66745
85085,9352,98714,121758,6229,119777,143216,3123,56068,75250
85083,6448,124430,151551,5496,134054,163570,952,64083,77431
85054,4175,87384,124222,1967,132022,176711,2208,70714,71496
85053,11716,53500,68875,7640,63000,76230,4076,40526,49780
85051,15408,46363,61047,9610,55744,65665,5798,32831,46386
85050,11809,99306,137593,8374,122799,159772,3435,62932,80195
85048,13658,102675,133671,9880,124298,153175,3778,62978,76018
85045,2587,130169,157463,1957,136927,165144,630,66538,126214
85044,17550,79983,105192,10735,95503,123840,6815,54896,71947
85043,9838,55563,66902,7588,54475,67349,2250,42027,54353
85042,15168,66652,81796,11016,68522,82877,4152,50035,66550
85041,17415,58438,73233,13907,61729,74419,3508,36240,53296
85040,10792,43127,50329,7323,45046,54496,3469,19480,32724
85037,15084,61318,68869,12186,61206,69942,2898,41292,50670
85035,15206,45754,59442,11650,46347,57125,3556,31792,56362
85034,2317,33140,43529,1031,30850,39154,1286,31150,45791
85033,16107,45492,57241,13194,45360,58214,2913,32177,36820
85032,28664,59214,77678,17168,72272,90495,11496,39696,53586
85031,8695,50740,62976,6932,52796,58185,1763,32827,47877
85029,17886,50067,59873,10784,58203,67352,7102,35426,41516
85028,7805,97865,126331,5270,118947,154940,2535,49761,65813
85027,16212,63591,78327,9371,75681,83917,6841,45606,67786
85024,10553,82618,104316,6777,101635,122031,3776,54754,68047
85023,13409,55111,77129,8342,64620,86585,5067,34920,55114
85022,23104,57660,81634,12649,72625,98333,10455,42926,56623
85021,16691,46358,74692,9873,60243,88877,6818,32205,49259
85020,16695,65224,100818,8193,85606,132318,8502,49013,68366
85019,7966,47290,60146,6010,52314,62656,1956,36694,42757
85018,17326,72032,136749,8594,122692,172067,8732,46205,100021
85017,11554,41893,51055,8171,45535,55761,3383,26872,33510
85016,17118,66759,107470,7669,84161,143983,9449,50968,74697
85015,16772,42038,56570,10109,50203,65025,6663,30891,39303
85014,13405,52408,75423,4928,74928,99530,8477,40972,60164
85013,10076,56526,86462,4138,86989,116953,5938,47461,61058
85012,3880,71296,112197,1534,144722,165740,2346,56180,75848
85009,14042,38228,52448,10077,40147,53855,3965,25086,37976
85008,22950,46724,59238,12475,48856,62772,10475,40750,50444
85007,5196,35642,57840,2855,42440,67473,2341,27460,43150
85006,9471,43567,56523,4998,46617,59115,4473,37109,50474
85004,3584,52000,81508,753,129250,150342,2831,30173,61974
85003,4378,48306,82992,1450,110652,132779,2928,39303,56798
84790,16634,65475,86955,12475,77325,96600,4159,35785,53149
84784,407,58189,65903,372,0,58147,35,0,0
84783,341,56910,76373,263,63990,88718,78,33667,34746
84782,275,90104,78267,264,90486,79605,11,0,0
84781,57,0,73140,29,136964,115886,28,0,0
84780,9096,75902,105421,7186,87577,119147,1910,29664,49512
84779,238,66667,71269,202,83250,76059,36,36250,44389
84776,185,45625,62128,155,52083,68004,30,30000,31773
84775,202,76711,64348,166,87500,74087,36,0,19439
84774,444,80625,91558,356,81875,99408,88,28750,40220
84773,101,35677,36096,93,36094,37176,8,0,0
84772,99,34943,57089,71,44306,71342,28,0,0
84770,15864,56503,71802,11196,63892,80657,4668,31203,45797
84767,219,59276,85959,134,99063,120349,85,22083,31745
84766,83,0,65493,83,0,65493,0,0,0
84765,2279,74692,94453,2083,76683,97569,196,48793,61049
84764,82,68125,80268,62,0,86039,20,0,0
84763,134,36944,46949,55,49583,63927,79,18438,32472
84762,48,0,0,28,0,0,20,0,0
84761,1289,39233,55275,811,46181,69078,478,24349,29409
84760,193,61513,81705,165,65893,89630,28,33438,32396
84759,668,0,57880,534,63456,64809,134,17344,27646
84758,159,64375,69627,136,70000,74443,23,0,41157
84757,620,60862,71337,414,70625,86154,206,0,41561
84756,120,0,46285,120,0,46285,0,0,0
84755,14,0,86029,8,0,134400,6,0,0
84754,1427,58494,71975,1113,68009,80856,314,25625,37786
84753,0,0,0,0,0,0,0,0,0
84752,284,67500,73605,228,74167,84248,56,20682,28270
84751,698,61739,70171,528,74167,81073,170,34265,36311
84750,180,24868,44184,109,39327,60221,71,13281,19565
84749,59,100313,112869,57,100938,115993,2,0,0
84747,395,48472,63647,289,67344,80384,106,17258,18014
84746,417,52109,80418,336,65333,89839,81,24728,41340
84745,1450,51429,54116,1085,55152,57462,365,29940,35865
84744,84,42188,48144,72,50625,50928,12,30000,31442
84743,3,0,0,3,0,0,0,0,0
84742,130,0,84620,110,0,92306,20,43333,42340
84741,2426,49241,73219,1379,72337,96961,1047,35565,41189
84740,100,0,36491,45,40694,44409,55,0,30013
84739,194,52500,72322,141,60417,86043,53,0,31855
84738,3755,68685,91417,2851,78295,102292,904,37021,53244
84737,6494,57941,73482,4831,68892,83939,1663,31232,38745
84736,97,62625,59846,81,64625,67873,16,15000,19213
84735,54,71875,76128,51,82679,78837,3,0,0
84734,110,41250,45335,63,50417,56900,47,25673,29834
84733,84,74615,84219,69,0,80532,15,0,0
84732,15,73438,74993,15,73438,74993,0,0,0
84731,35,48264,47429,23,0,0,12,0,0
84730,126,71667,94784,106,93214,103907,20,57778,46440
84729,116,54500,65424,93,72708,77773,23,0,15491
84728,20,56429,62470,20,56429,62470,0,0,0
84726,388,42742,69943,206,75625,99158,182,34688,34160
84725,485,63750,64670,409,66950,70034,76,0,33393
84724,447,51625,59995,351,52788,63697,96,23981,29871
84723,277,40563,51736,193,45521,56938,84,31875,39785
84722,431,52159,62306,280,60179,67033,151,48808,53342
84721,7672,56660,70580,6098,64711,79785,1574,25284,30024
84720,7521,52532,64233,5226,62484,75407,2295,29311,35594
84719,29,72188,76559,13,88750,105877,16,56250,52738
84718,133,0,50644,71,90341,77108,62,13750,14527
84716,192,43929,57824,122,61250,73907,70,17045,24633
84715,128,48125,56092,100,57000,57171,28,0,48493
84714,288,52750,53752,175,60764,72299,113,16834,24880
84713,1216,68929,77222,1010,84375,85272,206,20952,30923
84712,56,37500,45866,34,52500,53744,22,25000,33691
84711,298,69000,75316,254,73958,79372,44,25000,48064
84710,50,41250,46674,42,45938,53217,8,0,12325
84701,2954,49615,64762,2203,60271,72843,751,24338,36603
84667,131,57813,76287,122,59375,78384,9,48750,47856
84665,182,67308,65532,146,80804,73510,36,20313,33178
84664,2642,109261,154814,2403,117875,164823,239,32375,45473
84663,9611,73783,86489,7791,81467,94864,1820,39533,44710
84662,498,54412,70111,411,65433,77385,87,26382,33743
84660,11280,79639,95690,9858,82413,100610,1422,37542,50237
84657,154,70417,63282,113,80234,74347,41,22679,32788
84656,127,80313,82742,102,85357,89034,25,0,57068
84655,3660,76950,86525,3219,82061,90677,441,36250,47454
84654,1090,53125,60853,765,56493,64871,325,39271,45809
84653,2409,92413,115532,2155,96750,122712,254,39063,47504
84652,281,58393,76168,246,62000,76524,35,44464,67154
84651,7508,75084,86035,6445,78005,90646,1063,34476,47745
84649,323,69950,82230,307,68950,81298,16,74375,76919
84648,2103,69734,75939,1705,76885,82094,398,36034,39552
84647,1343,52516,59379,1008,57121,67490,335,17214,34973
84646,547,61563,70035,410,64615,78255,137,37083,44299
84645,776,78333,90645,690,82955,94913,86,37727,47836
84643,183,52250,66817,155,56875,71965,28,0,38314
84642,1150,44596,63993,922,56583,67317,228,29167,44804
84640,44,62500,58718,32,67500,66331,12,31071,38417
84639,297,56736,69934,233,69750,80261,64,25833,32044
84638,116,65000,91536,87,71250,105893,29,39609,48466
84637,250,62885,63846,202,63846,70600,48,31250,34679
84636,190,65000,74177,162,63750,77644,28,42500,47357
84635,314,63125,74301,286,68750,74744,28,26875,31646
84634,471,63906,66522,391,70375,71429,80,22500,34649
84633,357,75625,72911,287,79375,73953,70,0,64924
84632,380,58041,68852,310,59569,71855,70,34643,45544
84631,957,59521,85103,750,66591,93845,207,40156,40161
84630,147,0,46990,119,0,48116,28,0,42207
84629,1131,65625,118835,905,86528,139765,226,35200,33725
84628,243,58092,68407,174,67083,79447,69,28125,37955
84627,2162,58214,66638,1524,69698,76944,638,35221,38792
84626,95,64491,83801,95,0,68255,0,0,0
84624,1932,62056,71334,1514,67412,80652,418,28250,35577
84623,87,37277,35293,87,37277,35293,0,0,0
84622,523,64236,71125,402,72250,82087,121,27188,34437
84621,59,39669,44256,25,0,0,34,0,0
84620,360,76250,83682,296,84688,88867,64,49722,53288
84606,10466,39180,57406,6688,41087,59041,3778,33230,50232
84604,12033,61728,88695,8397,72523,101686,3636,42252,55093
84601,11074,51440,64817,8276,57344,65696,2798,33573,56961
84542,628,47742,48771,424,49722,56064,204,25556,30692
84540,19,0,0,19,0,0,0,0,0
84539,134,0,49210,73,73750,69049,61,0,23656
84537,482,61731,75144,401,75375,84775,81,20625,27462
84536,376,20385,28507,216,35417,40738,160,0,9819
84535,1097,65589,73229,896,65139,78412,201,66326,49992
84534,705,39837,54993,570,48864,60657,135,0,24655
84533,34,0,0,0,0,0,34,0,0
84532,4564,58019,69991,3040,68488,82186,1524,33871,45065
84531,187,25972,35020,145,26563,38485,42,15000,16607
84530,63,0,38894,14,0,0,49,0,0
84529,75,0,79785,12,0,0,63,22847,80705
84528,1041,57450,67954,748,65870,77769,293,24572,39710
84526,1712,56341,62985,1175,66466,71913,537,32375,41264
84525,339,41991,59429,263,62946,68316,76,25000,25750
84523,610,62222,66975,461,76719,79011,149,21016,23626
84522,112,61250,65681,85,76250,77796,27,0,27541
84521,269,59844,68628,201,74083,79455,68,25833,31684
84520,457,29726,41550,332,38571,47807,125,17917,24751
84518,278,74318,68849,213,80750,85027,65,25000,15832
84516,43,43125,54935,30,54167,70083,13,0,19969
84515,0,0,0,0,0,0,0,0,0
84513,558,51829,60359,374,56042,70215,184,37500,40325
84512,236,44500,47796,177,47426,55409,59,17188,22442
84511,1493,52350,73232,1030,66375,80847,463,21801,54271
84501,4796,50594,60711,3212,66708,72429,1584,28333,35450
84414,9084,89912,102203,7875,93563,106910,1209,53917,58303
84405,11468,72393,84274,8504,83476,93215,2964,37578,54106
84404,21177,67165,78366,15475,75919,87939,5702,38114,46567
84403,12897,69119,93789,9070,78665,104993,3827,49644,64063
84401,14585,61001,76167,9348,73899,91732,5237,33756,42586
84341,8390,52414,74005,5933,62645,83377,2457,39715,48879
84340,1080,80761,90867,769,95430,105190,311,41563,54326
84339,1642,85788,98429,1439,87414,98698,203,41250,92398
84338,176,51250,63105,131,66875,71801,45,40208,37140
84337,4303,60744,73674,3285,67083,83188,1018,40526,42475
84336,89,65938,65263,80,68214,69614,9,30750,26578
84335,3765,72854,85072,3313,77549,86883,452,47083,60644
84334,59,100964,100869,59,100964,100869,0,0,0
84333,882,67500,80718,769,75481,84200,113,43594,50616
84332,2511,83233,115345,2168,87656,127652,343,35801,37000
84331,103,55938,80815,76,68333,92271,27,43438,43315
84330,145,63036,72406,113,70104,80688,32,37083,41519
84329,41,0,182107,25,0,0,16,0,0
84328,466,80000,96935,398,84741,105003,68,60000,48768
84327,236,64615,86674,199,68958,92834,37,57656,46703
84326,673,66490,91702,557,68424,99715,116,38750,51959
84325,670,84342,106621,558,103558,120364,112,29833,36729
84324,297,98625,108672,231,113125,119381,66,58000,69376
84321,15069,49056,63105,10347,59031,72426,4722,29747,39598
84320,794,62955,79601,710,64024,82994,84,32969,40407
84319,2587,69975,79517,2246,73923,82992,341,42860,55557
84318,1343,75142,86785,1142,79257,93108,201,0,39413
84317,918,93113,101737,624,103977,102197,294,66741,99006
84316,108,72656,80687,90,73750,88710,18,43125,40572
84315,2801,97847,106345,2186,111750,117990,615,41360,61612
84314,335,91932,105349,284,95625,116276,51,36375,44496
84313,32,48750,42984,25,60208,50728,7,0,0
84312,1523,64754,71771,1126,68929,77259,397,38466,48885
84311,217,57917,67074,181,65208,72478,36,28750,39083
84310,1514,119000,126934,1200,130063,147478,314,53225,47114
84309,141,73438,78438,115,76875,83523,26,46875,49423
84308,81,51797,86762,73,52422,92641,8,31250,33113
84307,337,65750,73228,271,70156,74682,66,52768,50630
84306,100,88819,99442,84,89375,105050,16,0,0
84305,267,55313,66224,178,69500,84716,89,22656,29239
84304,29,0,0,29,0,0,0,0,0
84302,8567,63324,75576,6596,72541,83725,1971,31092,45096
84301,256,66000,74742,202,72955,82482,54,47500,44243
84180,0,0,0,0,0,0,0,0,0
84144,217,0,293425,170,"250,000+",358238,47,0,58998
84128,7163,85672,92120,6168,84549,94628,995,45046,50349
84124,7988,92000,141877,5679,108065,163337,2309,46635,83852
84123,13860,61372,73803,9466,73989,82986,4394,44488,49105
84121,15381,93241,120600,10371,118264,138311,5010,50977,80734
84120,13195,71216,83138,10956,73764,84592,2239,42513,53622
84119,16408,57572,70129,11417,63589,75123,4991,41630,50036
84118,20187,72218,84653,16544,77194,86827,3643,44806,55916
84117,9939,69178,113473,6247,86960,143338,3692,42462,57803
84116,11628,53330,65165,7215,59292,66672,4413,41193,57925
84115,11264,47651,62748,5625,59100,74266,5639,36244,49501
84113,0,0,0,0,0,0,0,0,0
84112,200,23468,44101,37,0,117254,163,21761,27495
84111,6969,50339,65188,1957,85914,84767,5012,37320,56003
84109,8759,100335,134185,6387,116141,155564,2372,53678,72780
84108,7572,107660,156943,5345,138653,185691,2227,57417,83122
84107,14424,57202,75347,8050,74500,88368,6374,41412,55713
84106,14431,76751,94142,7861,94587,113002,6570,55269,69315
84105,9457,83391,115130,5156,108475,148289,4301,63581,72125
84104,8111,49712,61843,5620,57759,65748,2491,33866,47750
84103,11204,72542,129066,5038,128590,197800,6166,51626,71060
84102,9730,43364,65098,2280,72782,95303,7450,36689,55122
84101,3303,47280,59699,843,66250,79137,2460,36616,52685
84098,6988,135167,185216,5376,152336,204072,1612,65833,117603
84097,7081,79610,107326,5641,83233,114390,1440,50625,75729
84096,14072,104248,115143,12604,108038,117187,1468,65395,74366
84095,22263,106631,128832,17681,119741,143637,4582,54772,65655
84094,9394,89268,99789,7332,96735,105262,2062,63446,75602
84093,7632,110500,142996,6211,120953,157723,1421,54679,70997
84092,9069,127582,157206,7845,132952,164868,1224,54571,97104
84088,12162,79951,93822,9509,86875,100405,2653,47842,58061
84087,4887,95524,101536,4167,105488,106564,720,49338,63308
84086,154,49891,88321,123,85313,97516,31,0,51839
84085,133,68393,152414,116,0,55378,17,0,0
84084,11896,76798,89203,9137,85169,98002,2759,45025,54066
84083,481,37171,48434,319,38661,48954,162,33500,37606
84082,364,128500,158300,295,132953,175909,69,98373,82436
84081,13883,96148,105442,11861,97506,107705,2022,68446,75735
84080,107,59375,71132,87,61477,75793,20,45909,50855
84078,8931,62403,74851,6395,73920,85806,2536,31567,45228
84076,87,103036,117933,82,92143,115921,5,0,0
84075,7961,103440,121021,7149,106646,124492,812,50278,66249
84074,16410,77334,86466,13297,82856,91357,3113,36788,52740
84073,84,78929,95682,77,107750,98984,7,0,0
84072,133,55893,61836,118,57813,65530,15,30625,32780
84071,533,108031,110446,432,109500,119476,101,42292,70424
84070,10594,70714,85964,7232,81983,96798,3362,46943,56625
84069,156,72500,83576,110,96250,95094,46,62500,56035
84067,13087,72422,78787,9853,77114,84466,3234,48494,51997
84066,4312,61926,72950,3234,69353,80277,1078,29931,47295
84065,13283,108364,122292,11140,117323,131221,2143,47862,68400
84064,201,73015,78166,170,74706,85801,31,32656,36300
84063,65,22390,177114,28,0,364243,37,21713,35503
84062,13764,82271,101654,11177,90778,110931,2587,39475,54319
84061,168,93194,72136,80,103700,104290,88,0,42905
84060,3171,111637,196102,2038,133902,239610,1133,75505,108153
84058,13285,66340,87315,10135,71890,95038,3150,42469,55713
84057,12266,60968,77988,9247,66071,81973,3019,40910,58372
84056,1022,58056,71641,942,57531,71152,80,87931,77401
84055,472,78125,92580,360,84107,87030,112,61250,99512
84054,6983,80922,101546,5436,96035,110522,1547,46265,55158
84053,338,69583,91462,276,78889,100258,62,36875,43340
84052,499,61250,67612,419,59327,66768,80,0,58383
84051,175,84250,89743,146,89286,94497,29,80179,65810
84050,3357,100365,123165,3013,101528,128614,344,47143,69114
84049,2046,101939,145336,1596,126267,170732,450,47879,55266
84047,13909,61414,71348,7722,69497,82228,6187,46030,54324
84046,101,74554,87277,97,74911,89692,4,0,0
84045,7542,102785,113175,6828,103986,114933,714,55921,83242
84044,8214,68765,75114,6329,73402,79934,1885,39606,47261
84043,17849,100925,114462,15307,106772,120280,2542,55567,69061
84042,2929,94063,117787,2599,103076,124877,330,29946,50843
84041,16539,73620,87598,12362,82094,92470,4177,50086,68516
84040,8066,95934,113097,6728,104435,123671,1338,41300,50778
84039,188,65000,159827,139,68750,78783,49,0,377276
84038,143,84844,97307,130,86667,102272,13,0,47654
84037,11109,102803,127273,9771,111135,135698,1338,52630,59346
84036,2489,84292,119502,1923,94821,131485,566,50489,75148
84035,216,0,24405,33,0,0,183,0,0
84034,64,51500,53488,53,62596,57451,11,0,31673
84033,379,78162,87144,255,101250,101540,124,72600,54955
84032,7376,76699,101296,5624,89356,113554,1752,43750,57286
84031,86,86346,79070,45,107679,88729,41,0,68468
84029,3208,76833,94376,2795,86284,100928,413,0,37822
84028,143,56458,57141,102,61061,64375,41,45208,39141
84027,225,45250,80217,161,74531,97974,64,20556,35545
84026,389,35742,49151,191,40673,51742,198,19423,46628
84025,6920,99420,119821,5328,111237,136855,1592,41704,59746
84024,10,0,0,10,0,0,0,0,0
84023,68,76667,73524,37,112813,104103,31,32344,37026
84022,260,88462,96988,141,131932,122045,119,62125,67300
84021,1331,52813,64081,1094,57250,69323,237,26250,39016
84020,14390,112541,152132,11692,123806,163576,2698,64620,96489
84018,77,0,118818,77,0,118818,0,0,0
84017,1471,76972,86398,1130,86059,94862,341,42670,54296
84015,20182,77597,86977,15616,83589,94446,4566,44575,51565
84014,5921,100230,117455,4804,108954,130036,1117,46270,60188
84013,232,89524,102393,201,91250,111260,31,29766,43535
84010,15019,81258,104080,11149,91870,116692,3870,50655,64136
84007,259,76075,78882,204,77450,92177,55,21853,29191
84006,289,68472,80023,235,69213,78894,54,0,78944
84005,7768,87066,92890,7421,87004,92048,347,72175,80703
84004,2851,123350,160160,2494,140893,174145,357,0,53976
84003,14288,93741,125379,12327,102230,133123,1961,46107,69221
84002,107,72396,91979,82,82857,103973,25,0,52640
84001,219,74531,77625,165,79063,87062,54,0,47989
83876,714,50517,66359,565,50139,69105,149,31719,44042
83874,17,0,0,17,0,0,0,0,0
83873,735,44728,60524,413,72533,76777,322,30769,39111
83872,231,80313,87956,170,80870,92307,61,71964,75830
83871,828,71905,79059,613,79375,86851,215,50375,55023
83870,131,46964,73044,80,71250,94553,51,25417,39253
83869,2076,49274,69934,1625,55250,77316,451,42803,39491
83868,335,40091,43839,163,42969,50885,172,38636,33217
83867,136,0,92337,136,0,92337,0,0,0
83866,82,0,0,82,0,0,0,0,0
83864,7693,52997,69094,5231,66057,81681,2462,31009,40735
83861,2633,51354,64753,1722,60700,75930,911,31343,37910
83860,2400,64574,88604,1810,79236,96428,590,41200,58068
83858,6238,74109,88109,5302,80385,89730,936,42167,69656
83857,411,71776,95548,355,82610,103531,56,53750,44941
83856,2739,49255,65863,1920,66269,80452,819,25549,30675
83855,850,52644,61643,571,54075,67491,279,30625,44352
83854,16097,60308,70909,12028,70555,79051,4069,33935,40158
83852,403,38533,42882,200,44211,48370,203,24716,36678
83851,649,46875,56746,448,53571,66181,201,30272,34309
83850,840,40000,71893,525,53583,97694,315,20341,28814
83849,882,45270,54291,507,50884,60687,375,31850,44543
83848,80,0,67330,62,0,69300,18,0,60544
83847,623,32721,34184,321,49814,45015,302,26136,22671
83846,353,42596,56517,213,62679,74765,140,23472,28570
83845,743,65444,70139,508,71118,83497,235,0,39689
83844,0,0,0,0,0,0,0,0,0
83843,11327,45484,64309,5437,81028,94690,5890,26517,34456
83842,43,48417,47819,28,48500,45932,15,0,51340
83841,149,80949,66745,129,81412,70537,20,0,0
83840,107,43942,44110,45,50250,49393,62,0,35068
83839,667,39340,45969,388,55813,60285,279,23098,26059
83837,1347,32304,46071,777,49028,57209,570,23803,26081
83836,438,70156,69866,323,76588,81330,115,21932,36137
83835,9124,64909,84478,6599,78518,95422,2525,40958,50866
83834,66,80667,77620,53,81750,89715,13,0,0
83833,810,67032,83587,545,94792,96489,265,65579,57052
83832,658,75172,94659,515,76875,102078,143,63125,64915
83830,163,27182,27887,159,27267,27523,4,0,0
83827,72,37778,45510,39,38750,51990,33,35625,36848
83826,0,0,0,0,0,0,0,0,0
83825,90,0,76862,67,91458,97284,23,16125,16974
83824,99,53125,74990,58,0,93069,41,38625,44793
83823,731,63575,70405,444,65625,72186,287,63028,65125
83822,885,33328,39865,512,31959,39614,373,33950,38224
83821,106,109375,159274,86,138125,164902,20,0,0
83815,15252,59299,72630,9602,72601,84557,5650,32346,50628
83814,11348,54460,79023,6587,67139,96827,4761,39568,51560
83813,365,69931,88253,365,69931,87199,0,0,0
83812,22,32000,44736,12,68333,60583,10,27500,25720
83811,684,29919,40693,329,47208,52640,355,18051,28768
83810,673,0,106264,494,110196,128877,179,41458,42783
83809,97,103015,105021,97,103015,105021,0,0,0
83808,55,0,42876,30,0,63783,25,12292,14472
83806,81,42813,46706,61,50417,51400,20,33500,31375
83805,3230,44105,72116,2221,54293,83600,1009,27367,45487
83804,678,39757,66919,417,39497,59715,261,27404,72934
83803,484,51612,65391,306,51542,68470,178,0,57656
83802,20,27500,27670,3,46250,44267,17,26250,24741
83801,2534,59898,72674,1855,64878,79805,679,31285,45330
83716,6865,103784,116320,4953,113814,131286,1912,69167,74164
83714,10436,59873,87541,6042,83561,114616,4394,36372,48159
83713,10803,70517,94427,7768,80582,108427,3035,38554,56211
83712,4641,87116,117048,2660,131833,148918,1981,52837,72678
83709,21787,74941,93384,15352,84508,104189,6435,53298,62437
83706,14623,57664,80395,6636,91373,108093,7987,36400,54104
83705,12267,51547,65616,6289,63503,75319,5978,41887,51812
83704,16351,55688,67108,9323,69338,81453,7028,37548,44787
83703,7354,62222,83175,4198,75155,100526,3156,38353,57675
83702,11069,68165,114580,5265,126415,179603,5804,39797,53511
83687,12173,54256,70829,8411,64989,84053,3762,32222,37694
83686,18119,62591,74789,13192,71246,84297,4927,38178,45007
83677,69,0,0,69,0,0,0,0,0
83676,1868,59222,72578,1430,65000,77681,438,46368,54651
83672,3555,40694,52537,2234,52628,62112,1321,26134,33005
83671,5,0,0,0,0,0,5,0,0
83670,244,58889,63406,237,59861,63791,7,0,0
83669,3926,73178,93818,2854,86532,107370,1072,53015,57067
83666,25,52188,57156,16,76667,72394,9,0,30067
83661,3753,48373,62220,2581,60162,71039,1172,33180,34830
83660,2171,50919,62978,1542,57157,68811,629,32083,35849
83657,90,55547,48308,78,56016,52177,12,0,0
83656,164,51750,60504,152,51667,58641,12,51875,46625
83655,1986,73119,79900,1525,89271,91104,461,31854,41222
83654,657,57371,90833,503,66534,104095,154,40938,44468
83651,13086,54485,62987,8799,64201,72586,4287,32623,40335
83650,186,51563,63176,168,51563,66893,18,0,24250
83648,890,49052,61427,826,49741,64366,64,23895,23497
83647,8757,45818,56835,5258,58518,66793,3499,32400,39470
83646,23299,79706,104342,17953,90588,117344,5346,47980,58015
83645,315,54688,66828,262,71250,71808,53,31125,41272
83644,4507,75285,84858,3577,86375,93798,930,38359,43350
83643,46,66389,54293,29,65417,57434,17,0,0
83642,17854,75708,95807,12851,89955,112919,5003,43093,47784
83641,1252,61726,91812,917,78325,109103,335,29063,40350
83639,1332,51269,61532,1005,60740,68497,327,16733,36956
83638,2508,67296,92512,1843,75929,103854,665,42891,58219
83637,122,38824,40607,63,45625,44854,59,38566,34837
83636,54,0,0,54,0,0,0,0,0
83634,8146,71858,81257,6149,74475,92095,1997,38659,45835
83633,284,79205,90537,246,77727,84498,38,101806,126347
83632,141,54688,75268,95,81458,96960,46,0,30470
83631,533,32679,44935,335,45755,51667,198,31324,31897
83629,878,62792,70503,564,65000,81804,314,56667,49262
83628,1628,42241,53713,1187,54006,61115,441,26174,31794
83627,236,24700,42223,95,43438,56305,141,24250,32735
83626,464,51818,62997,352,61429,72483,112,32794,32546
83624,570,42105,93694,356,55600,121197,214,26063,47679
83623,600,31579,37373,352,45938,48920,248,12305,20983
83622,991,52981,78508,712,65000,89468,279,36250,47562
83619,2971,51975,71567,1919,66972,86363,1052,33659,43064
83617,6210,52000,65425,4375,61981,76461,1835,24545,32192
83616,11230,89603,131663,8786,103312,148193,2444,45917,68940
83615,432,55765,65703,321,65733,74363,111,0,34422
83612,877,43009,53064,548,51429,66590,329,22466,30106
83611,943,53984,60138,668,59722,70389,275,23102,35144
83610,377,47083,87476,221,53750,118751,156,34118,42518
83607,8027,59676,76380,6061,66166,87390,1966,28639,35406
83605,14542,52738,61421,9983,59795,67695,4559,26864,41513
83604,298,41019,65504,187,44018,62586,111,34261,69544
83602,6,0,0,0,0,0,6,0,0
83601,0,0,0,0,0,0,0,0,0
83555,216,53500,60162,141,67708,71306,75,27750,36952
83554,220,27054,48418,122,0,62955,98,26071,30320
83553,410,32083,43508,214,56161,59351,196,22571,25177
83552,459,34087,55583,276,47500,77188,183,14835,22923
83549,312,43333,59179,196,50625,77730,116,20938,27835
83548,50,55833,52188,29,56250,57872,21,31875,37195
83547,177,39028,46985,88,0,57594,89,31875,36496
83546,192,38750,67701,106,65000,93860,86,26500,35376
83545,185,48162,53094,81,59375,71065,104,41250,38963
83544,2605,44564,63391,1408,70114,79345,1197,37543,43184
83543,267,56563,77471,175,71250,95702,92,36750,42154
83542,70,0,33153,43,44750,42719,27,0,17919
83541,433,53295,59432,308,67778,68856,125,25536,34186
83540,788,51875,61999,630,56500,65833,158,24044,28723
83539,934,40303,53019,595,55917,66403,339,24464,27323
83537,416,67361,80390,311,77891,91728,105,30972,43237
83536,1913,41875,53703,1177,50605,64646,736,26356,34279
83535,404,56111,64075,261,60125,74112,143,28125,34457
83533,82,88214,86423,73,89821,94845,9,0,0
83530,2083,50226,63042,1553,55375,72251,530,22200,35413
83526,104,63125,90513,88,75833,102043,16,0,26713
83525,135,24792,36070,61,33203,53644,74,0,18431
83524,399,52625,60393,303,59063,65207,96,25000,39824
83523,339,52188,71704,225,65179,71640,114,28750,70991
83522,698,51250,68455,516,65000,80435,182,24397,32603
83520,94,46250,53333,65,54375,64072,29,19792,22659
83501,14617,57362,73994,9390,77565,91171,5227,31923,39025
83469,15,0,0,15,0,0,0,0,0
83468,82,38333,43852,42,60278,64269,40,0,22418
83467,2979,39529,52311,1721,59049,67299,1258,20076,31232
83466,124,0,65325,33,0,175000,91,22440,25553
83465,53,79018,74323,44,78571,72416,9,0,0
83464,117,34625,72703,82,40938,89426,35,25417,27837
83463,39,0,64092,13,0,0,26,0,25512
83462,267,31402,43861,164,46453,62670,103,13837,13913
83460,0,0,0,0,0,0,0,0,0
83455,2181,72398,96702,1267,78361,109543,914,60197,77341
83454,163,95179,88455,140,109063,95021,23,55568,48491
83452,807,67238,70580,562,67151,78334,245,67571,52794
83451,226,53750,55123,183,63750,60780,43,19583,28221
83450,297,48438,57437,257,53533,63504,40,0,17645
83449,72,68864,70432,53,69338,70962,19,59375,68947
83448,729,50125,82294,603,66761,92061,126,38929,35264
83446,12,0,38950,5,0,0,7,0,0
83445,2482,57936,66044,2009,63551,71750,473,29208,34120
83444,457,32750,44921,255,40046,47691,202,0,41053
83443,398,52870,65081,291,54125,68404,107,32098,42537
83442,6524,69205,86128,5331,76773,92933,1193,44464,53247
83440,11245,43267,69836,9194,49006,77995,2051,21399,29203
83436,231,57321,91333,210,60250,86008,21,37083,131248
83435,238,59688,77919,150,58750,85683,88,0,64685
83434,564,70254,81973,504,71159,84443,60,29615,29827
83433,4,0,0,0,0,0,4,0,0
83431,285,52250,65840,193,71250,81626,92,22039,28232
83429,357,72938,78936,287,81250,81598,70,46500,68023
83428,243,57841,92753,179,63393,109999,64,47000,44045
83427,586,76641,80025,489,85875,88231,97,31023,37352
83425,203,66250,102737,175,76250,103824,28,0,84971
83424,47,0,0,17,0,0,30,0,0
83423,301,34954,48120,169,52109,61833,132,27298,30492
83422,1255,79882,106331,898,104167,124830,357,50313,57262
83421,145,67904,63346,78,82917,81342,67,46299,0
83420,867,52041,62468,658,60571,70041,209,30208,35724
83414,170,86607,84475,92,0,109975,78,0,54397
83406,6267,67583,86372,4504,85000,105648,1763,24258,36152
83404,9038,68480,91154,6566,81959,105320,2472,29905,46824
83402,10396,56489,77441,6060,71276,96892,4336,38202,47997
83401,14116,59872,73730,10775,68603,79252,3341,37408,49023
83355,1532,47946,61074,1133,55662,67722,399,34803,35575
83354,13,0,0,0,0,0,13,0,0
83353,553,57614,105781,320,85417,140703,233,43150,56654
83352,1221,50840,54467,754,54940,62061,467,32669,40720
83350,4335,49528,63836,3263,58273,71078,1072,22337,36274
83349,397,53125,74473,295,61125,86149,102,31689,38006
83348,100,0,61252,100,0,61252,0,0,0
83347,1155,54517,63918,765,66250,76107,390,45385,38601
83346,533,52465,83742,483,54940,89514,50,17031,22844
83344,375,57356,72800,301,65156,79802,74,40714,38466
83342,404,42250,58057,337,48371,61635,67,0,35133
83341,2421,68072,86073,2110,76649,92480,311,24307,35868
83340,1934,76735,86628,1176,78778,81913,758,63598,92189
83338,7081,56589,70510,5349,61540,77915,1732,31443,38639
83337,16,0,0,8,0,0,8,0,0
83336,2011,54054,73148,1498,56325,75271,513,24583,57160
83335,622,48281,58692,457,60417,66631,165,24375,34602
83334,780,50081,56913,579,55745,64816,201,19028,27882
83333,3897,64917,95938,2522,82745,108667,1375,43311,70900
83332,1176,60529,66136,696,71250,73894,480,39063,53066
83330,2457,44794,61347,1653,49688,71737,804,28134,38228
83328,2111,53464,77122,1551,64482,89527,560,26458,39155
83327,357,36875,71372,203,64219,85775,154,31818,46382
83325,282,52500,57392,213,61023,64474,69,32813,33513
83324,209,52321,58760,172,58409,62586,37,35750,40784
83323,574,53529,69812,443,56906,75618,131,40694,47529
83322,5,0,0,5,0,0,0,0,0
83321,229,44219,65496,178,44583,66424,51,43125,60159
83320,355,42917,61371,299,47917,63901,56,23750,37525
83318,5975,52258,66608,4454,63306,76428,1521,21462,28607
83316,3905,51588,61656,2570,70919,76812,1335,20542,30292
83314,406,55357,83853,302,63750,85983,104,0,74645
83313,1412,63100,73280,947,72227,84288,465,48780,47455
83312,25,0,69772,20,0,81430,5,0,0
83311,293,52393,68259,248,56250,66534,45,31964,52731
83302,91,36055,42475,39,70625,62403,52,0,27531
83301,21990,52183,69843,14741,60817,81594,7249,35060,42435
83287,98,86000,112955,79,107750,120703,19,0,80742
83286,387,65938,76497,325,64792,76074,62,52500,69165
83285,39,44531,52782,21,44519,58333,18,0,0
83283,51,152604,212027,51,152604,212027,0,0,0
83281,23,0,0,23,0,0,0,0,0
83278,242,66772,78766,202,0,0,40,125887,104010
83277,69,125288,111314,61,125545,115297,8,0,0
83276,1347,57266,68092,915,67219,81561,432,29500,38987
83274,3194,64688,83275,2554,69880,94762,640,23182,31251
83272,122,51711,66304,72,77188,92144,50,24063,29094
83271,137,63375,70725,108,68333,81441,29,17917,28600
83263,3244,58725,79120,2553,72604,89705,691,25158,31365
83262,274,69500,70434,172,83333,82539,102,0,48672
83261,230,67500,69285,171,78750,80381,59,23125,34788
83255,486,50625,71801,324,67500,89742,162,27589,35919
83254,1453,47039,62922,1065,57917,73747,388,18852,29731
83253,25,0,0,10,0,0,15,0,0
83252,1715,54484,63643,1183,64145,72270,532,35200,43176
83251,449,50938,59304,299,62147,67143,150,19569,43677
83250,733,56950,88335,647,63750,95773,86,30093,32378
83246,439,75893,84330,338,91818,100001,101,19250,31577
83245,833,64770,81361,685,78290,88977,148,36944,38424
83244,172,54615,65624,116,69000,71883,56,0,52661
83243,0,0,0,0,0,0,0,0,0
83241,851,57232,77116,695,61926,83936,156,23351,43627
83239,231,78125,79384,189,81161,87883,42,21667,34267
83238,32,61250,65888,16,0,0,16,0,0
83237,303,50150,61892,257,51938,66246,46,25000,33802
83236,923,53625,58166,616,66824,72678,307,24354,28084
83235,79,0,20872,70,0,22303,9,0,0
83234,493,55438,62223,380,67000,71138,113,22917,30606
83233,127,42062,53341,127,42062,53341,0,0,0
83232,196,70833,73414,159,83250,83532,37,0,29935
83228,251,71458,71644,189,71875,75609,62,0,59556
83227,7,0,0,7,0,0,0,0,0
83226,989,27928,40065,524,48660,55532,465,16738,22534
83223,57,95750,97454,51,95750,95641,6,0,0
83221,9203,59337,71577,6771,68761,81272,2432,31107,37674
83220,60,49500,60622,34,59000,66968,26,0,0
83218,120,58750,69321,101,80625,76605,19,33542,30600
83217,335,58068,71980,277,58523,74784,58,54583,58409
83215,25,40313,40808,2,0,0,23,40104,32926
83214,217,65813,67097,159,79063,78130,58,35417,33921
83213,453,31750,70093,285,51442,90934,168,16061,32762
83212,134,0,52983,125,0,52140,9,0,64689
83211,2120,51394,69577,1362,63000,85519,758,33152,39119
83210,1319,46814,59597,999,51314,65101,320,21632,31638
83209,252,16315,15964,26,0,0,226,16034,14145
83204,7512,45121,63220,4067,64952,77664,3445,28494,44557
83203,155,0,28552,70,34000,53104,85,25000,6964
83202,8210,57691,69222,5633,66442,77767,2577,38750,48409
83201,13529,51396,67171,8691,65722,80484,4838,31365,40455
83128,396,74091,90473,237,100875,110882,159,46593,57738
83127,1534,83696,101331,1105,105951,117337,429,46050,48254
83126,152,101771,121320,152,101771,121320,0,0,0
83124,64,114167,121981,55,112917,124609,9,0,84800
83123,303,103207,124477,254,0,141100,49,40139,38308
83122,198,68929,66414,156,68418,65304,42,0,0
83121,0,0,0,0,0,0,0,0,0
83120,124,85625,84665,92,112917,96822,32,0,0
83119,49,0,0,49,0,0,0,0,0
83118,329,49904,59076,219,48942,60989,110,59286,55267
83116,323,56563,73417,204,76250,86631,119,48487,48854
83115,312,0,82435,262,0,95451,50,13571,14230
83114,293,61146,64174,229,71250,73289,64,28500,29478
83113,792,71029,76895,576,77717,83571,216,55227,58152
83112,161,121076,122170,128,0,100723,33,0,0
83111,308,66635,62218,217,85071,71615,91,0,39807
83110,1744,74167,77223,1299,94399,90845,445,38337,36120
83101,1423,64038,71106,666,85185,87403,757,50240,56769
83025,477,84701,273792,199,96696,113005,278,0,388888
83014,1328,92287,152998,906,103889,182143,422,86324,87157
83013,53,0,0,53,0,0,0,0,0
83012,0,0,0,0,0,0,0,0,0
83011,56,0,0,56,0,0,0,0,0
83001,7764,86884,135184,4658,101845,171109,3106,66510,76552
82945,83,100625,84949,48,76667,85477,35,0,81277
82944,117,236023,185732,117,236023,185732,0,0,0
82943,81,0,38247,25,0,0,56,0,0
82942,36,0,0,25,0,0,11,0,0
82941,1696,85197,111643,1089,96908,110965,607,49789,112859
82939,569,62109,77065,461,77056,85982,108,30741,35753
82938,106,65882,64643,77,66949,78365,29,0,0
82937,1267,86650,89637,942,93512,96238,325,54476,65850
82936,6,0,0,6,0,0,0,0,0
82935,4651,78445,94819,3402,95633,106888,1249,48457,56290
82934,69,106188,78843,59,106172,79219,10,0,66190
82933,161,96174,98607,132,97273,112302,29,0,0
82932,194,54667,62679,95,80375,89368,99,38309,37069
82930,5699,66203,71782,3724,80182,82460,1975,33443,49774
82929,24,0,0,17,0,0,7,0,0
82925,179,"250,000+",312074,140,"250,000+",257395,39,0,0
82923,348,0,93795,125,0,96332,223,0,92372
82922,202,87083,320025,104,91333,113882,98,0,538789
82901,10294,72385,86189,6701,88525,102026,3593,42594,51716
82845,0,0,0,0,0,0,0,0,0
82844,9,0,0,9,0,0,0,0,0
82842,407,86964,84366,242,93750,91620,165,77708,73727
82839,471,54018,65585,328,57143,72103,143,45156,47650
82838,241,54123,73727,220,0,76510,21,0,0
82837,20,0,66290,3,0,0,17,0,64065
82836,423,80417,92843,256,96111,115130,167,29375,58680
82835,168,66429,72413,110,97500,81423,58,28333,36428
82834,3427,54895,77941,2086,70385,99932,1341,25522,39418
82833,56,0,0,56,0,0,0,0,0
82832,422,76794,105416,219,77224,98122,203,0,113285
82831,154,52132,86282,145,52316,89638,9,25417,32222
82801,11091,57927,78107,6435,84019,97435,4656,36129,47298
82732,729,83819,89428,497,86563,96340,232,79038,69719
82731,66,0,82571,66,0,82571,0,0,0
82730,834,58269,67905,554,77900,79259,280,30444,42859
82729,1168,74318,78840,872,101204,90119,296,32143,44596
82727,711,0,82812,482,150293,115395,229,11956,14232
82725,96,82778,71355,76,105179,87870,20,0,0
82723,58,24500,29071,27,0,0,31,0,0
82721,1086,75000,80801,785,85121,88133,301,50486,60690
82720,288,42857,53188,155,44196,53663,133,34306,52339
82718,8957,86457,96485,7198,93381,100541,1759,55107,69930
82716,6905,73020,75794,4238,80430,86715,2667,44610,55007
82715,0,0,0,0,0,0,0,0,0
82714,23,0,0,23,0,0,0,0,0
82712,125,59306,44861,85,61326,55820,40,0,0
82711,15,0,0,8,0,0,7,0,0
82710,60,0,75835,38,104500,110850,22,0,0
82701,2098,57880,67842,1503,62577,74423,595,31544,43841
82649,444,44167,62730,262,63750,77157,182,32188,39747
82648,33,0,0,33,0,0,0,0,0
82646,0,0,0,0,0,0,0,0,0
82644,731,46825,63436,414,47250,65912,317,0,55958
82643,123,56042,57812,78,51667,59523,45,65438,51049
82642,35,46354,58946,12,94375,109600,23,0,0
82640,137,0,0,137,0,0,0,0,0
82639,271,62601,82540,224,63243,90662,47,0,37355
82638,18,0,0,18,0,0,0,0,0
82637,1494,76786,84651,1101,83693,93805,393,38558,49467
82636,1457,67906,79601,1054,71483,87501,403,37946,51838
82635,47,27083,32549,25,32292,35144,22,18750,29600
82633,3973,71947,88242,2591,90036,101884,1382,31848,58451
82630,0,0,0,0,0,0,0,0,0
82620,90,100417,130826,82,76481,96434,8,0,0
82609,8345,64280,90669,4954,93974,114677,3391,42959,52774
82604,11033,66402,80991,7619,77440,92382,3414,42038,53023
82601,11027,57442,76297,6357,78973,95484,4670,32833,47584
82523,340,58750,80215,238,71875,97130,102,35208,36347
82520,5050,61111,77149,3058,71473,91045,1992,46967,53426
82516,134,46250,55709,80,58750,60249,54,0,42528
82515,141,62083,65909,106,73333,75075,35,28250,26266
82514,420,41250,54691,293,50938,62520,127,16223,27255
82513,882,41724,58527,434,66098,73050,448,25938,44391
82512,78,43000,67841,41,43250,45893,37,38750,92162
82510,84,36875,51451,66,36250,51676,18,34167,44289
82501,7226,52564,68337,4499,65341,80098,2727,32364,45755
82450,86,56116,53131,68,0,0,18,0,0
82443,2158,53871,63938,1397,66250,75621,761,31412,39726
82442,377,52750,54733,253,58807,61183,124,35441,41573
82441,89,0,79560,49,101016,124596,40,0,0
82440,109,0,0,50,0,0,59,0,0
82435,4893,64793,84074,3414,74148,93606,1479,48595,61232
82434,45,23836,35451,45,23836,35451,0,0,0
82433,491,64792,66937,382,68843,74854,109,0,39194
82432,143,35821,38617,91,37321,43189,52,24000,28367
82431,1258,62564,75764,801,75764,91720,457,32344,46882
82430,29,43750,47766,23,48250,53043,6,23750,27533
82428,79,64063,66459,52,63750,63852,27,0,0
82426,1133,48229,56238,700,63021,70354,433,23393,32345
82423,101,41875,62391,81,45417,69196,20,0,31395
82422,13,0,0,13,0,0,0,0,0
82421,106,31250,60687,76,43750,75566,30,14583,21413
82420,221,62723,76647,192,64018,84556,29,21528,23783
82414,6898,63764,79083,4402,77276,95949,2496,29253,46077
82412,179,56705,63726,111,72688,75867,68,33636,40738
82411,170,71500,68662,150,72167,72021,20,0,43475
82410,808,51923,58896,477,68894,75246,331,23313,34674
82401,3129,56492,70536,2034,68721,83817,1095,35871,43412
82336,98,51000,65548,45,70673,79969,53,46106,53304
82335,26,0,105435,18,0,0,8,0,0
82334,219,88438,98168,166,59408,105027,53,50313,55979
82332,40,10119,9668,21,0,0,19,0,0
82331,1100,62381,79193,665,83646,87438,435,30724,63615
82329,164,26250,40683,86,55000,49731,78,23519,29292
82327,357,48232,55707,265,49411,62869,92,24688,35075
82325,454,38295,71502,264,45179,95062,190,27037,32988
82324,96,55893,52398,63,48906,54386,33,56518,48606
82323,57,30625,41051,27,37917,38281,30,0,41540
82322,83,0,54248,64,76250,65730,19,0,15574
82321,321,81563,77221,209,91761,95361,112,31875,42464
82301,3368,70648,79232,2323,79688,87018,1045,45469,57350
82244,223,77969,69341,146,85403,79055,77,43317,47474
82243,23,25000,0,7,0,0,16,0,0
82242,17,0,79765,1,0,0,16,0,76994
82240,4072,57426,69069,2778,66548,81459,1294,28534,38643
82229,1,0,0,0,0,0,1,0,0
82227,96,46136,73576,60,86667,100915,36,23500,21072
82225,683,44028,55460,405,48523,59233,278,30893,37827
82224,4,0,0,4,0,0,0,0,0
82223,354,48571,60622,265,54792,68455,89,25469,31844
82222,41,44750,44868,41,44750,44868,0,0,0
82221,255,24440,35669,98,41694,53504,157,20163,21640
82219,9,0,0,9,0,0,0,0,0
82217,14,0,0,10,0,0,4,0,0
82215,52,49722,59963,31,0,83826,21,21875,24738
82214,519,47688,69033,349,75208,86064,170,23214,33958
82213,212,0,61641,103,128482,102597,109,17614,22939
82212,255,64063,80642,189,73750,95184,66,0,39002
82210,136,55366,59301,107,56067,67125,29,28250,30434
82201,2991,61766,90490,2057,73482,85074,934,27296,87326
82190,271,65223,60025,74,0,0,197,54375,55071
82084,6,0,0,0,0,0,6,0,0
82083,131,59250,122298,66,51500,66686,65,0,178765
82082,790,56822,72452,632,57336,76288,158,45000,55677
82081,26,0,0,26,0,0,0,0,0
82073,0,0,0,0,0,0,0,0,0
82072,7143,46913,66677,3418,82926,99778,3725,24290,33377
82070,8612,54124,69512,4236,85563,91228,4376,33982,47676
82063,75,39241,53059,23,85536,88530,52,38214,37369
82061,0,0,0,0,0,0,0,0,0
82060,69,112730,102794,69,112730,102794,0,0,0
82059,100,0,54996,35,0,83303,65,24020,39754
82058,6,0,0,0,0,0,6,0,0
82055,154,68571,78661,98,69464,85476,56,0,66736
82054,288,79444,86744,288,79444,86016,0,0,0
82053,583,71750,126857,449,87614,154629,134,30556,33799
82052,0,0,0,0,0,0,0,0,0
82051,11,0,0,6,0,0,5,0,0
82050,135,117417,101294,122,140231,109789,13,0,21569
82009,14098,88826,112511,9908,104307,131293,4190,51337,64707
82007,8384,50732,65024,5660,61296,74674,2724,30239,36308
82005,0,0,0,0,0,0,0,0,0
82001,15736,65535,78856,8946,79674,96052,6790,41377,53561
81657,2447,84476,152068,1195,131027,225321,1252,52857,81663
81656,153,34085,60175,119,33326,58446,34,0,0
81655,34,0,0,17,0,0,17,0,0
81654,541,82102,81854,360,81136,84381,181,62072,74551
81653,8,0,0,0,0,0,8,0,0
81652,1713,80054,88735,1422,84674,92478,291,59280,59650
81650,4546,67309,77253,3497,72768,85062,1049,36918,47103
81649,110,55357,69265,57,55625,70128,53,51250,66825
81648,932,54861,71421,636,79457,81562,296,38958,43286
81647,2472,80375,95518,1860,89167,101136,612,46571,69283
81646,79,74063,80646,54,74167,73928,25,0,95156
81645,374,105000,109329,246,107500,111556,128,91071,93193
81643,237,71563,80643,160,74063,99939,77,0,38504
81642,9,0,0,0,0,0,9,0,0
81641,1564,51296,67281,972,75000,79990,592,31810,44747
81640,61,28603,34243,16,62778,55113,45,22446,26822
81639,1047,77750,81191,718,105000,93689,329,48625,53915
81638,16,0,57600,3,0,0,13,0,0
81637,2526,77273,98977,1824,82536,109026,702,54858,66330
81635,2658,65064,81819,1744,68648,96817,914,54615,52448
81633,0,0,0,0,0,0,0,0,0
81632,3219,68954,127722,2078,94022,156542,1141,35448,70794
81631,2605,101463,126157,2132,103083,132788,473,0,71913
81630,380,66667,71523,294,69167,74197,86,35625,59156
81625,4997,55598,71210,3339,72060,82643,1658,27905,39750
81624,496,75875,80898,411,97083,90050,85,31250,32129
81623,5787,93008,118582,3760,106189,133155,2027,62563,87679
81621,2457,101470,132399,1625,104920,130040,832,91304,137007
81620,4147,82234,116264,2350,90833,125569,1797,59770,101467
81615,1428,76777,108164,636,70655,108573,792,86679,107045
81612,0,0,0,0,0,0,0,0,0
81611,4378,83646,168074,2247,112543,237127,2131,51521,87526
81610,106,52000,62725,70,76000,73291,36,37000,36317
81601,6161,82938,95492,4162,97855,111765,1999,45197,57955
81527,685,74840,87045,559,83839,100575,126,0,27017
81526,2427,51156,76094,1510,81277,97918,917,28533,38082
81525,440,49408,62035,330,0,64198,110,57714,47564
81524,811,79632,101639,532,113571,119755,279,60777,67094
81523,459,76853,82051,300,107679,95858,159,75216,55999
81522,54,0,0,54,0,0,0,0,0
81521,5685,52384,68693,4270,68889,77964,1415,32985,37823
81520,5035,47408,59065,3315,57711,68504,1720,22123,38015
81507,6272,82348,99887,4381,96672,119295,1891,37635,52416
81506,5212,63565,87979,2697,93453,117044,2515,37027,55648
81505,4444,71279,83796,2726,78929,95478,1718,46591,61220
81504,11477,56272,70156,7987,64913,78389,3490,37566,45063
81503,5876,62650,70083,3999,71822,79570,1877,37159,46318
81501,9729,39187,51093,3992,54567,66398,5737,28203,38478
81435,2392,66563,105452,1126,87500,147816,1266,50882,66570
81434,132,0,52457,39,51518,61649,93,0,48603
81433,284,54000,71977,139,64659,80772,145,41350,59783
81432,1493,70875,89661,906,81552,107515,587,34583,60716
81431,142,76500,92536,109,76417,99733,33,0,62676
81430,395,83897,123129,279,108625,154453,116,0,47791
81429,36,43125,51839,36,43125,51839,0,0,0
81428,1675,71490,82076,955,76132,102722,720,41667,52778
81427,552,68295,88493,360,77237,103736,192,54875,59594
81426,66,107500,107741,49,110972,113914,17,93750,89947
81425,2117,57734,65687,1462,62895,73545,655,38245,45902
81424,539,32578,48889,345,44271,56858,194,27000,34718
81423,713,62806,77182,512,64848,84345,201,39583,54870
81422,260,24412,46191,137,57266,64204,123,19375,25354
81419,1310,41900,64919,895,55144,81068,415,24115,29165
81418,662,61316,76099,521,63917,82727,141,23472,37241
81416,5181,43161,57206,3341,60988,70702,1840,25659,31314
81415,793,55665,78367,574,57079,91154,219,41165,40849
81413,2245,42415,55881,1441,57565,68769,804,21981,30021
81411,28,0,36775,10,0,0,18,20909,0
81410,710,60227,65460,467,66750,75813,243,29801,45564
81403,4714,62896,84332,3700,71379,91735,1014,37083,54711
81401,9528,51687,67825,6241,68688,83628,3287,25986,36075
81335,11,0,0,11,0,0,0,0,0
81334,470,27095,33538,272,30652,40689,198,20543,23713
81332,112,72500,94332,63,143024,129259,49,40536,46294
81331,114,55833,65502,68,88485,78168,46,50278,46778
81330,111,0,0,0,0,0,111,0,0
81328,1693,56125,71979,1175,57734,76219,518,48214,61494
81327,218,70750,51577,79,75380,72766,139,0,39535
81326,937,44271,69933,682,61806,82151,255,21445,34424
81325,81,47250,63789,52,80208,78846,29,45083,36790
81324,675,62905,65715,439,67448,80631,236,0,37969
81323,2166,57635,73828,1429,76080,82501,737,24141,56300
81321,5772,50927,63396,4019,60401,72465,1753,27964,39857
81320,168,31894,37554,97,44519,46516,71,27132,25308
81303,3317,69659,86565,2235,82434,98666,1082,46802,56734
81301,11986,71386,99514,6966,92917,125021,5020,44558,62270
81253,307,85139,92780,307,85139,92780,0,0,0
81252,1964,55132,61496,1181,64209,71955,783,44632,45656
81251,96,61667,82720,59,80938,98407,37,0,57705
81248,58,0,79903,46,0,0,12,0,0
81244,199,53958,62661,118,57500,72814,81,38194,42837
81243,37,78438,74297,27,79063,70656,10,0,0
81242,370,66250,74118,278,80750,85750,92,35147,38968
81241,110,0,36096,39,71563,75700,71,0,0
81240,1439,82344,133055,1144,89250,148629,295,41375,57118
81239,87,0,157629,45,0,97747,42,0,0
81237,30,0,104010,14,0,0,16,0,0
81236,660,62292,71735,446,84875,89975,214,24281,33720
81235,357,38750,68218,214,60833,91270,143,22163,29952
81233,430,0,80960,246,0,93306,184,0,64096
81232,97,0,0,97,0,0,0,0,0
81231,0,0,0,0,0,0,0,0,0
81230,4110,55242,66756,2057,77483,86591,2053,35788,43877
81227,0,0,0,0,0,0,0,0,0
81226,2571,47321,59812,1729,54665,68076,842,35500,40913
81225,517,80521,103941,305,135125,136084,212,41250,54354
81224,1348,74375,102796,746,106563,129382,602,52105,67004
81223,902,35000,65594,610,37422,80114,292,27791,34509
81222,133,58859,235121,74,59239,57493,59,0,457908
81221,125,34886,53969,94,46667,56554,31,28438,29445
81220,53,51563,72247,41,0,78532,12,51250,50775
81212,11487,55881,66233,7321,70973,80575,4166,26867,38172
81211,3556,52287,75727,2348,57308,91500,1208,28611,45069
81210,195,0,114024,84,0,154136,111,0,79282
81201,4070,56611,73941,2518,71579,90523,1552,31000,41187
81155,103,71563,73732,69,88315,87620,34,42500,40697
81154,427,56875,80722,301,79940,94546,126,21731,46140
81152,558,26290,38462,282,38438,53576,276,15078,22928
81151,631,41635,51187,401,52238,58828,230,31006,33543
81149,460,36346,54059,237,51625,73702,223,26823,31431
81148,126,23125,31271,68,30000,37526,58,0,20883
81147,5403,55247,77075,3730,64867,90661,1673,32721,44533
81146,356,63929,71839,286,68750,77477,70,23125,48804
81144,2717,44080,64403,1713,71767,81134,1004,14672,28339
81143,275,45363,44607,211,48125,52523,64,12500,17508
81141,458,42011,68176,298,55833,76874,160,38750,50969
81140,875,37747,46080,441,56328,58810,434,29091,30710
81138,33,15547,15215,4,0,0,29,15234,12990
81137,2096,53977,72438,1338,71042,89575,758,30726,39910
81136,118,0,77279,83,0,94628,35,22604,25460
81133,505,39489,51037,373,42961,54931,132,28333,38941
81132,1450,38138,53662,761,51417,66544,689,30531,38689
81131,655,0,44380,291,54840,59785,364,17045,29389
81130,381,53512,66520,242,63333,77176,139,43821,43340
81129,37,0,23514,17,0,0,20,0,0
81128,57,72750,78716,39,72750,74908,18,0,86967
81126,84,54423,86927,58,0,101522,26,0,54365
81125,1407,47617,58858,1078,50188,62734,329,29183,38132
81124,51,10272,8594,23,0,0,28,0,0
81123,380,43162,52836,235,46544,67755,145,30040,28657
81122,3216,83065,98873,2161,110290,117203,1055,38783,59720
81121,150,63000,71656,101,74583,90292,49,21250,33243
81120,1067,28428,40661,454,44559,59920,613,21343,25242
81101,5826,40233,57271,3537,50143,70260,2289,27988,35678
81092,354,53889,72064,230,67955,81263,124,25313,55002
81091,345,51979,69570,200,70167,87831,145,31719,44381
81090,473,33750,46564,275,44219,59517,198,16579,26263
81089,2098,37840,47854,1197,42428,52076,901,24877,40521
81087,46,53750,62111,27,73750,77089,19,34750,40826
81084,70,17344,29500,44,0,36993,26,16250,16819
81082,5469,45877,60268,3191,56206,72729,2278,27937,38850
81081,68,34211,52684,18,61875,89489,50,33618,39434
81077,288,49167,48654,171,59345,56855,117,31161,30086
81076,209,39511,52522,109,57841,67228,100,35000,35331
81073,892,34286,53459,540,48333,71043,352,22656,26376
81071,103,44375,63377,66,54500,78715,37,35208,33543
81069,895,79821,81329,622,97784,95869,273,0,48200
81067,1928,30500,46158,1268,39628,57603,660,20300,23600
81064,129,39875,63390,83,49250,79551,46,30333,32807
81063,768,38125,45755,513,49631,55223,255,25901,24938
81062,382,43158,53235,229,62422,79376,153,0,14064
81059,29,0,83321,24,0,97275,5,0,0
81058,489,50694,50335,395,53805,55906,94,23750,26921
81057,146,58000,64385,100,71500,80045,46,32917,30341
81055,721,45089,62610,484,63800,76938,237,19679,33351
81054,1519,34715,42978,937,37361,46624,582,24323,32591
81052,3711,43159,58564,2353,49934,66291,1358,26092,41821
81050,4371,51739,59494,2472,63838,76147,1899,26921,36411
81049,124,41250,52628,86,53167,60094,38,26250,35732
81047,634,42171,57527,429,50792,69576,205,17760,30481
81045,25,45625,48912,18,47500,56456,7,30625,29514
81044,103,25972,41662,54,31364,59152,49,20729,20724
81043,22,0,27455,12,33750,42125,10,11071,9850
81041,287,40893,51965,198,41786,58353,89,0,34424
81040,164,0,57902,95,0,66282,69,38875,46365
81039,704,41417,49442,371,51250,61041,333,20729,33010
81038,0,0,0,0,0,0,0,0,0
81036,480,38972,53928,289,51125,65107,191,27868,34036
81033,52,39000,38267,22,29167,33673,30,39500,41637
81030,55,67083,89000,36,92000,100219,19,33906,43642
81029,124,43409,58141,89,61094,71822,35,22375,23351
81027,75,51750,64693,29,79583,117479,46,33500,31413
81025,349,60060,54817,177,64861,70476,172,35833,37917
81024,102,0,48168,64,53542,73328,38,6111,0
81023,548,70114,73047,376,85588,85342,172,46220,46170
81022,531,50139,65405,380,60833,73794,151,0,41436
81021,7,86563,87014,7,86563,87014,0,0,0
81020,535,27917,45580,268,31755,56905,267,24036,32033
81019,642,54211,63555,455,62875,76773,187,0,29657
81008,4770,54537,76100,3145,61344,82850,1625,39421,58794
81007,11403,73608,92765,8876,84681,101868,2527,48672,55202
81006,4499,55265,74709,3311,66227,85000,1188,35746,40879
81005,12690,55843,69909,7961,68634,83685,4729,35641,42352
81004,11082,38141,50411,5943,41772,59445,5139,28410,37067
81003,5608,35130,46958,2650,53417,61411,2958,23403,32257
81001,12390,38546,53398,6498,51275,68093,5892,25296,34201
80951,1516,80333,142652,1272,84276,157416,244,60652,58157
80939,0,0,0,0,0,0,0,0,0
80938,122,56494,71299,122,56494,68815,0,0,0
80930,598,66938,66709,477,69214,73163,121,33155,38134
80929,46,28382,34428,12,0,0,34,0,0
80928,373,67443,81135,322,70417,85576,51,19813,29496
80927,1356,125234,130290,1224,128663,135894,132,65227,56532
80926,606,104375,112771,501,123854,119804,105,48173,78120
80925,4053,86572,104617,3206,97877,113407,847,65655,65609
80924,3636,129141,147419,2936,140515,161585,700,63857,79555
80923,11085,90317,99573,7932,99005,108491,3153,65375,70903
80922,10307,91499,99072,8071,93553,103607,2236,65694,72407
80921,9258,125376,144720,7130,143412,164212,2128,52611,67416
80920,13560,96239,113599,10376,107934,125373,3184,57000,67374
80919,11359,99431,118477,7757,119032,138881,3602,56585,70086
80918,19089,71533,89621,12459,85277,103340,6630,50685,60113
80917,13000,61509,74116,7784,72181,83423,5216,43966,53728
80916,13980,51076,61232,9654,54518,67053,4326,34761,42597
80915,8396,61299,73207,5814,64201,78822,2582,42304,55479
80914,50,157273,168318,45,156705,166869,5,0,0
80913,127,72250,75290,127,72250,75290,0,0,0
80911,12012,69845,78445,9370,75466,83749,2642,47353,50874
80910,12287,41566,59876,7133,47332,66804,5154,33068,41848
80909,16305,47299,60287,9271,58432,67992,7034,32488,45163
80908,6725,113020,138590,5441,126982,152160,1284,63148,75275
80907,12516,52430,71398,6446,68534,87993,6070,39126,52060
80906,15210,72014,113430,10424,86871,132626,4786,45560,67372
80905,7786,50849,78443,3646,69063,96045,4140,39944,62181
80904,10368,57374,83746,5162,80611,117842,5206,35350,48524
80903,7346,48220,66145,2985,67723,89629,4361,34010,49286
80902,3063,51841,57618,2891,52195,58736,172,0,35458
80864,603,59896,78683,449,75368,87765,154,44167,51660
80863,4994,72013,91404,3530,86531,104002,1464,41654,57890
80862,19,63750,52642,11,65417,62864,8,30833,38588
80861,97,78917,82069,80,82500,83303,17,78438,76259
80860,334,49167,54385,148,53750,60413,186,40500,47122
80840,607,75750,81192,543,80230,82845,64,0,63959
80836,407,46458,58428,294,55625,67439,113,22396,30782
80835,289,60662,81228,215,60074,85786,74,23077,28962
80834,145,38977,54263,70,0,75319,75,31250,34368
80833,426,34170,46827,183,54750,63667,243,33769,34144
80832,305,48897,61410,205,60750,77136,100,19125,28611
80831,8586,97636,116177,7506,103052,122928,1080,48158,55004
80830,69,67917,64787,61,67639,63544,8,0,0
80829,2817,75942,100065,1666,113615,139066,1151,29890,42501
80828,751,49076,87581,467,78839,115833,284,25000,38652
80827,268,0,69616,210,89038,77270,58,38611,37750
80825,205,67969,71610,152,83047,82588,53,30417,31808
80824,154,80278,88621,97,82083,84176,57,0,93872
80823,70,47500,43920,50,51667,52320,20,15500,22925
80822,115,61875,74255,84,84375,87006,31,0,35784
80821,429,54514,72446,242,79667,98770,187,25625,36247
80820,387,69275,116088,198,126250,175571,189,64844,52693
80819,409,57750,71664,192,81042,98681,217,30795,44144
80818,140,63542,78230,93,71250,96159,47,32083,35283
80817,10354,67314,76287,7853,70896,81123,2501,42092,55688
80816,2683,61936,77892,1816,78063,93184,867,33102,41733
80815,399,40795,58121,214,67500,80994,185,18984,31663
80814,1825,55072,65067,1260,61145,75974,565,37303,39958
80813,769,40707,53033,309,69375,70320,460,31054,40461
80812,101,48125,72175,72,49250,76888,29,0,60472
80810,509,68292,79193,331,77813,96204,178,38167,47128
80809,426,62059,101503,230,126333,133439,196,0,60583
80808,2251,57868,77509,1701,67917,85053,550,35000,50745
80807,1855,55174,74943,1166,66667,79292,689,32625,65279
80805,154,46250,56975,103,52292,67559,51,28125,33098
80804,105,26750,40406,46,31250,48883,59,22656,33797
80802,65,0,59332,54,79375,66626,11,16563,23527
80801,75,21926,52220,31,74375,92274,44,21083,23623
80759,1905,51977,65434,1523,51183,65542,382,40800,42536
80758,1354,62031,83170,911,75313,87238,443,41058,73427
80757,113,44688,58556,59,64625,85251,54,24722,29391
80755,26,0,48815,26,0,48815,0,0,0
80754,77,68750,113486,64,67500,110963,13,0,120285
80751,6714,47260,60290,3820,66211,75414,2894,32661,38544
80750,111,71094,66344,106,70313,68369,5,0,0
80749,103,0,67365,63,96250,85071,40,25000,37855
80747,167,53542,72414,104,81250,85126,63,35139,48833
80746,26,0,92450,24,0,96950,2,0,0
80745,76,51250,64568,57,52188,70140,19,37750,42500
80744,194,33125,50299,102,67500,72897,92,21923,24654
80743,470,53214,64412,331,59844,68709,139,38542,52513
80742,105,62750,67980,51,97813,93447,54,24231,43928
80741,425,61477,87905,312,95625,106787,113,26442,30400
80740,49,51250,62688,32,61000,69397,17,0,43218
80737,657,50052,71485,406,64375,82742,251,28125,53046
80736,204,64500,59670,157,67313,69425,47,27750,27040
80735,155,65625,76695,140,70000,79711,15,39750,48547
80734,1260,49148,71952,928,51918,78792,332,36157,49833
80733,231,68651,71928,168,75000,80788,63,25972,37919
80731,497,52426,68100,300,74000,87929,197,27443,35529
80729,255,55764,72022,181,65313,86891,74,16618,33957
80728,386,57500,64837,288,68500,75147,98,21250,28933
80727,319,44232,51426,79,52708,56425,240,44044,49620
80726,187,50809,54372,121,58750,61613,66,28088,34971
80723,2806,57100,63217,2028,61374,74555,778,23309,28376
80722,173,60573,66808,157,61406,70350,16,0,0
80721,89,54896,89025,59,0,108453,30,58269,49870
80720,1093,49960,62953,788,56929,72441,305,25406,35309
80705,375,48750,55305,289,48698,56442,86,40000,41972
80701,6113,59174,66775,3961,69329,78084,2152,35089,44121
80654,886,62386,74463,654,69484,81780,232,53167,51742
80653,340,57931,61828,250,59474,67933,90,33750,40469
80652,156,0,37261,57,61384,61004,99,16106,23590
80651,1371,68424,96090,1108,73929,100668,263,48750,62056
80650,717,59952,81405,520,75833,92130,197,45075,48728
80649,203,0,350615,128,0,532298,75,0,40544
80648,548,76975,108109,377,92188,130345,171,0,54124
80645,1886,71400,83052,1504,80975,87781,382,49038,59639
80644,1078,66618,96513,853,74583,106413,225,50913,56817
80643,1457,87795,92582,1147,98375,106059,310,26293,31903
80642,1689,70579,95973,1340,70185,101862,349,43917,56970
80640,3967,88284,100113,3044,104189,105710,923,78438,68912
80634,21872,74655,88475,15183,86729,102435,6689,40366,51129
80631,16405,43327,58701,10486,54091,66077,5919,28010,42899
80624,362,61974,75255,221,93281,101086,141,0,26643
80623,336,62917,74390,301,67969,76904,35,40893,41366
80622,37,85125,72646,25,86625,99252,12,0,0
80621,4768,71900,91374,3525,77002,95711,1243,39135,65520
80620,6139,60657,72487,4507,65145,76770,1632,40847,51858
80615,3379,86461,126766,2758,91002,142222,621,40066,56017
80612,120,0,69602,108,71667,74583,12,0,0
80611,313,80114,104838,257,83438,116883,56,22188,40282
80610,1317,65274,74911,1006,69600,82756,311,43125,47365
80603,4666,85450,101271,3590,98246,107610,1076,51211,68061
80602,11631,123633,143877,9917,129208,149263,1714,74342,87886
80601,12091,75103,91930,8652,84980,103588,3439,44541,53274
80550,10064,103510,123974,8081,114911,135512,1983,53210,71579
80549,4005,87753,107007,3115,94959,121374,890,45929,53784
80547,358,134500,153556,344,136250,152126,14,106667,117386
80546,87,79632,85124,69,108456,93451,18,0,0
80545,604,64904,94015,305,93036,95620,299,53750,92037
80544,38,0,0,38,0,0,0,0,0
80543,2768,70332,87094,2265,73713,91546,503,43835,62717
80542,1471,101042,124462,1213,107216,138069,258,52500,54148
80540,1906,117246,126534,1246,118750,138403,660,102500,102315
80538,20082,77359,90630,13788,88438,106905,6294,39060,51440
80537,18920,75847,89491,12151,85048,103195,6769,42522,58628
80536,870,85313,110774,645,105404,128655,225,60236,59516
80535,1110,72321,84730,790,95833,93671,320,31591,56539
80534,5347,115654,112099,4078,125278,123103,1269,44563,74202
80532,25,0,0,0,0,0,25,0,0
80530,1280,84000,96393,921,96563,109111,359,54572,58355
80528,7327,107106,145048,5371,126534,161469,1956,70882,95620
80526,17465,71749,88604,10041,97424,110199,7424,42010,55821
80525,21651,77900,101734,12762,104756,123996,8889,47722,66893
80524,14685,67080,93149,9273,91619,113595,5412,43342,56262
80521,12404,50760,72399,4901,86995,105422,7503,37323,49760
80520,407,72865,76183,293,74598,83909,114,50000,49446
80517,5522,66292,100855,3536,86795,114991,1986,40552,70565
80516,10184,121461,139647,8270,136178,150245,1914,80604,88597
80515,395,91705,96826,297,116164,105277,98,0,71212
80514,1901,72950,88486,1459,80481,95218,442,47857,59311
80513,4895,99803,126842,3998,115494,139716,897,54432,64219
80512,822,66324,97762,519,89688,124687,303,24618,51643
80511,0,0,0,0,0,0,0,0,0
80510,148,145833,123270,97,149653,146169,51,0,79718
80504,19035,92977,112635,14143,106073,124867,4892,54313,72125
80503,13961,104560,131269,9568,127439,156164,4393,53671,71411
80501,16609,66259,79466,10090,77451,91496,6519,41286,55784
80498,3195,81177,116881,1818,88285,126610,1377,72574,102411
80497,96,77212,70455,71,0,0,25,0,0
80488,62,0,77365,15,0,0,47,0,93249
80487,7198,79162,114243,4527,102679,133987,2671,56483,77006
80483,256,64737,74910,195,76250,82987,61,40313,49090
80482,659,81781,102645,373,82469,125210,286,0,73215
80481,227,0,95383,108,120139,140769,119,0,54192
80480,573,48578,69331,380,68875,82420,193,29519,43038
80479,0,0,0,0,0,0,0,0,0
80478,575,81740,98788,310,123362,151205,265,28836,37469
80477,48,44375,55790,7,0,0,41,43281,41302
80476,85,66094,91498,38,108750,113524,47,44438,71985
80475,10,0,0,0,0,0,10,0,0
80473,43,26250,32442,4,0,0,39,0,0
80471,0,0,0,0,0,0,0,0,0
80470,1637,99183,116639,1354,109457,127924,283,54886,62323
80469,187,57049,72406,98,70577,89758,89,55590,53236
80468,141,59107,95789,73,0,151519,68,31528,35962
80467,1041,61507,75797,559,93125,101695,482,40735,44392
80466,1616,84444,109674,899,102476,138910,717,51073,71137
80465,5891,107355,142115,4554,119418,156434,1337,61406,85706
80463,93,84821,105784,56,95714,108963,37,0,100973
80461,3179,65919,75548,1588,84120,90672,1591,50186,58511
80459,999,70694,74517,666,86987,91271,333,22596,37416
80457,86,78429,82906,21,0,0,65,0,0
80456,178,65208,75383,112,74107,91750,66,47727,47608
80455,262,66667,95167,101,176477,168322,161,34023,46524
80454,617,125750,140631,480,148659,162202,137,70042,63810
80453,78,0,125732,62,0,130692,16,0,0
80452,1460,58575,77186,765,77234,103112,695,47125,47331
80451,322,90096,101455,271,100045,110919,51,50729,47939
80449,498,0,70600,360,0,65520,138,102917,83851
80448,0,0,0,0,0,0,0,0,0
80447,995,74534,102115,541,102639,127065,454,45642,72383
80446,1741,63053,84314,1090,91563,94631,651,47516,64606
80444,656,37438,70072,239,101118,99945,417,33411,49133
80443,1805,71453,91212,893,80694,110576,912,61384,72251
80442,854,37163,68903,381,58594,92257,473,27473,41962
80440,1009,76633,96529,562,82917,129944,447,54323,53419
80439,10097,124989,152069,7336,141935,177745,2761,56982,79645
80438,340,44808,60135,203,0,75773,137,28641,32061
80436,140,0,65269,94,110294,89043,46,0,16691
80435,2742,68882,105869,1632,71923,122775,1110,44367,72889
80434,19,0,0,12,0,0,7,0,0
80433,3511,108193,130762,2629,121832,147084,882,52010,77664
80432,111,34012,45859,91,33609,43088,20,0,0
80428,226,73462,81873,142,95625,97344,84,0,55720
80427,316,53426,62354,108,63750,64430,208,52963,61276
80426,26,48654,47062,13,0,0,13,0,0
80425,64,139457,208373,36,138913,274714,28,0,123079
80424,3771,92015,112149,2046,118393,130198,1725,62125,88568
80423,49,90903,85698,44,0,69293,5,0,0
80422,2311,87184,129231,1397,111397,156944,914,73000,81953
80421,3503,80865,91486,2845,89806,98818,658,44044,58751
80420,309,44226,65265,164,0,84455,145,0,42921
80419,0,0,0,0,0,0,0,0,0
80403,8078,116627,149729,5496,136313,162150,2582,73729,104672
80401,16227,96418,127371,9792,120760,151859,6435,63584,86787
80310,0,0,0,0,0,0,0,0,0
80305,7044,99885,134649,3666,147879,176625,3378,65471,85662
80304,11348,98049,157820,6190,131066,181209,5158,60368,125453
80303,11118,64937,105399,4584,136796,170254,6534,37618,58901
80302,12192,54793,108331,4029,147518,196984,8163,32306,63498
80301,11803,80131,119660,5373,121715,166275,6430,54545,78773
80294,0,0,0,0,0,0,0,0,0
80293,0,0,0,0,0,0,0,0,0
80290,77,115125,120125,27,0,0,50,123333,125226
80264,0,0,0,0,0,0,0,0,0
80260,12002,50674,68639,7510,54036,70477,4492,40174,61547
80249,10010,79827,91186,7619,85721,95637,2391,59198,68286
80247,14151,50809,65803,5808,56649,78991,8343,45776,54542
80246,7084,58758,85773,2390,78481,128794,4694,51521,62248
80241,11804,95064,109708,8822,106016,119151,2982,63839,73920
80239,12448,65891,83760,9161,70260,82671,3287,51747,76431
80238,7188,147723,175069,5267,169879,199692,1921,67170,98530
80237,10361,74540,101789,4609,99503,124504,5752,62524,82181
80236,6063,69331,81720,3777,83716,95342,2286,45388,56493
80235,3704,64103,84881,1955,83207,102012,1749,47925,63798
80234,11418,73302,94373,7060,89598,111979,4358,52115,62729
80233,16906,76551,85857,11472,83526,89092,5434,51171,68569
80232,9165,74222,89813,5377,91002,105066,3788,53311,65746
80231,15494,62360,82232,7678,76736,100021,7816,52193,62547
80230,4388,92407,148177,2606,153173,192846,1782,47971,82358
80229,18495,63615,72968,12530,67264,75489,5965,51497,58492
80228,14062,91850,113672,9162,107221,137298,4900,55343,66894
80227,14393,72524,90860,8279,91278,106062,6114,51337,66101
80226,13167,66301,81797,7389,87847,96157,5778,40993,59728
80224,7781,66764,95303,4027,90540,118821,3754,45084,67584
80223,7889,60130,83705,4085,57625,86905,3804,53818,74920
80222,10403,72408,97921,4755,104594,127410,5648,55046,71608
80221,12990,69023,82378,8280,75970,89926,4710,41627,64203
80220,15112,85867,129178,7884,122440,173857,7228,61367,77533
80219,20491,52440,65071,14308,55625,68281,6183,35014,47543
80218,10818,67922,117198,2674,156250,233876,8144,58320,77980
80216,4379,63502,78800,2241,53683,73423,2138,67262,81938
80215,8355,77533,101429,4849,93443,122133,3506,53266,70231
80214,11427,51875,70322,4925,60048,82329,6502,42284,59289
80212,8991,90853,116731,4323,119192,140905,4668,64191,92528
80211,16523,88936,119443,6829,121259,148515,9694,76962,97835
80210,14991,102508,149452,7811,160005,207049,7180,57163,85533
80209,13259,91828,137520,5057,156571,206670,8202,64664,94240
80207,9570,92961,127573,5857,111707,150464,3713,56315,85072
80206,13064,85122,132914,4743,150462,209733,8321,59408,87705
80205,14163,76261,97874,5843,86563,110868,8320,70548,86554
80204,13266,61345,95886,6028,67164,113470,7238,53070,78907
80203,13935,58928,75314,1905,113661,131830,12030,54810,65774
80202,9529,96308,147834,2592,144350,247650,6937,78232,109891
80138,11521,126619,142791,9322,142275,155238,2199,57147,80994
80137,531,111169,134682,438,111290,134396,93,0,134591
80136,1659,95438,111328,1358,113103,123120,301,52644,50091
80135,1494,116250,174006,1181,127950,189589,313,62750,105449
80134,24865,116392,141668,18898,133896,160436,5967,59419,77467
80133,1074,90688,92556,776,105274,109708,298,27167,43576
80132,7348,128816,146701,6107,148483,162212,1241,51156,66829
80131,162,63571,69315,102,68571,75824,60,0,29765
80130,9410,128151,152295,7476,138778,163607,1934,64223,96581
80129,12103,114067,141580,8791,130793,157437,3312,75823,94707
80128,14205,98484,114946,10339,109463,126186,3866,61638,76460
80127,16721,114620,143070,12886,129667,158591,3835,60739,86605
80126,15383,134844,160254,12500,146841,176985,2883,66588,84318
80125,3806,134952,155785,3234,141863,165519,572,64130,87254
80124,8877,107168,151756,5510,129333,182798,3367,71900,100027
80123,18540,87640,118483,11590,115110,145378,6950,56833,69740
80122,12698,105870,132160,9218,121729,151951,3480,59202,73531
80121,7237,101908,174623,4941,123467,205539,2296,51129,101760
80120,13733,69408,99384,7368,97736,124343,6365,43317,67930
80118,2351,138015,170581,2063,143602,177105,288,96932,109798
80117,901,84760,104251,592,111500,119812,309,45536,73035
80116,1591,106309,156164,1409,106993,165765,182,44583,73454
80113,10701,75253,142762,5379,124528,215543,5322,49731,67610
80112,14462,95419,126358,8622,132617,158252,5840,61140,76618
80111,12412,115337,180231,8566,144000,214954,3846,67020,100650
80110,9394,65780,82849,5088,76040,89951,4306,48837,69137
80109,7931,125822,146220,6326,133674,157626,1605,80037,99592
80108,9555,157119,191820,8106,169722,205925,1449,61172,93441
80107,4683,112351,127145,3904,118362,132715,779,57344,74579
80106,2245,119426,115957,1907,128013,121239,338,74265,84275
80105,580,66071,78476,438,68690,86081,142,50000,53017
80104,11220,101496,121702,8320,123286,141730,2900,50810,56745
80103,916,83676,88269,694,86250,98229,222,39375,48755
80102,2144,80000,108636,1461,103894,130328,683,47440,56212
80101,209,69779,87368,136,76583,105604,73,46797,53396
80045,526,49821,61268,135,95804,96346,391,47344,49157
80033,12091,61258,83902,6199,84290,110183,5892,36132,53826
80031,13191,86030,109451,9142,98269,124330,4049,58026,68904
80030,6167,51850,65705,3527,65157,76539,2640,36632,47132
80027,11944,117618,146454,8317,147639,172844,3627,62625,78648
80026,12738,90810,131683,7974,115862,163013,4764,58145,73968
80025,22,0,35082,0,0,0,22,0,35082
80024,65,33958,38380,41,33125,38776,24,36500,37704
80023,8269,127234,162835,6158,161789,187121,2111,70078,83684
80022,15423,74098,88997,11762,82843,95803,3661,41417,61315
80021,14942,80518,99730,8070,108630,124632,6872,56471,67321
80020,19376,97470,117841,13012,114402,133131,6364,62343,81985
80019,1202,97391,100434,885,99077,109214,317,75943,74423
80018,4386,108960,116009,3654,117551,120831,732,71324,78442
80017,13575,65609,76218,8961,75006,86810,4614,49340,52012
80016,20148,123281,161256,15853,143565,177916,4295,68919,95012
80015,23124,104065,120869,18499,114960,130002,4625,57965,73048
80014,17980,61167,76382,8536,76197,93878,9444,44330,57730
80013,24832,80639,94142,18866,87571,98015,5966,52883,70529
80012,18867,59647,71751,11660,69072,79454,7207,45061,54738
80011,16822,55585,64611,11034,59264,68283,5788,40726,51539
80010,13291,48066,59303,8175,52463,63239,5116,35880,47175
80007,5617,143292,169074,4648,154573,183216,969,93224,96527
80005,10795,116157,133871,8060,134239,151668,2735,59375,75733
80004,14444,82311,99325,9391,96660,114621,5053,49661,65317
80003,13508,68866,89656,8824,86875,104397,4684,48323,55120
80002,8499,76149,90388,4523,91581,111575,3976,54696,64260
79942,0,0,0,0,0,0,0,0,0
79938,24132,58237,71619,19832,63080,76024,4300,35736,42819
79936,34755,57402,71372,25885,63188,76985,8870,40045,50549
79935,6434,57617,77612,4523,59634,77062,1911,50016,74201
79934,9414,70975,81929,6892,71624,84522,2522,58750,69130
79932,9422,74821,89412,6898,84058,95046,2524,45966,66827
79930,10496,36809,52108,6518,41132,56572,3978,28776,40301
79928,17370,58608,74016,14654,58736,76243,2716,47075,49853
79927,12229,38753,50424,10198,41731,53135,2031,19017,26497
79925,14442,49219,62341,9619,55620,68419,4823,28835,40783
79924,20366,45592,56180,14384,52363,63551,5982,26550,35696
79922,2795,81992,132721,2216,105882,151635,579,55938,54033
79920,0,0,0,0,0,0,0,0,0
79916,346,53841,48014,302,54245,49792,44,0,0
79915,12964,29017,39243,8875,35249,44320,4089,15207,22623
79912,28881,63307,91652,19105,80113,108875,9776,43252,55185
79911,2273,98059,118837,1759,106215,123816,514,81316,85325
79908,894,57986,66149,894,57986,66149,0,0,0
79907,16023,35539,46542,12316,40822,51191,3707,20168,27082
79906,832,55833,70613,765,57841,66121,67,52292,120448
79905,7817,21847,34399,5209,26971,41161,2608,14104,19288
79904,11461,34778,49530,8036,41113,56341,3425,18584,32280
79903,5847,29653,40647,3587,36638,46938,2260,19179,26881
79902,8561,36998,63355,4315,55625,85329,4246,22624,39475
79901,3436,12025,19659,1510,22521,26447,1926,9407,13487
79855,655,33958,43897,381,37813,46896,274,19732,27872
79854,67,0,33963,41,0,40624,26,24375,23458
79853,667,50781,58190,566,50313,60979,101,17938,27637
79852,345,31625,38341,199,38911,44656,146,24167,29734
79851,270,0,55314,162,76000,65709,108,0,39722
79849,3199,38937,46691,2789,38522,47080,410,22917,33395
79848,351,43815,51953,218,65417,67950,133,20804,25734
79847,28,0,60014,19,0,0,9,0,0
79846,14,0,0,14,0,0,0,0,0
79845,1570,17284,22831,839,25262,27561,731,12409,17402
79843,985,41969,60786,438,90577,90035,547,27472,35802
79842,226,40250,49780,183,39877,51262,43,53906,43474
79839,501,30110,31741,401,34009,37033,100,8780,10521
79838,1623,30737,38448,1157,38555,45210,466,15481,21373
79837,116,33333,44030,54,0,70222,62,16250,21218
79836,1772,42979,50530,1349,45309,53986,423,29676,35923
79835,3559,41238,55538,2643,44731,60243,916,27587,37606
79834,152,41544,46117,18,48438,50472,134,41434,45533
79831,0,0,0,0,0,0,0,0,0
79830,3569,46875,65588,1900,86029,90392,1669,26455,36669
79821,1878,40556,51610,1494,43056,54933,384,0,28929
79789,324,100978,103321,272,102174,107766,52,44063,61912
79788,305,60088,63638,264,60739,66311,41,21875,24129
79785,16,54000,49806,16,54000,49806,0,0,0
79783,80,124375,119755,48,89722,114790,32,141146,127203
79782,1324,67050,83006,1079,75724,90738,245,36042,46434
79781,124,36974,48250,46,77727,73393,78,35965,29755
79780,43,0,35330,12,0,0,31,0,30523
79778,432,65577,79734,309,70341,88267,123,43150,56192
79777,73,87292,104671,55,0,94287,18,106250,136400
79772,3445,63264,71636,2164,64694,81755,1281,46182,51804
79770,0,0,0,0,0,0,0,0,0
79766,2069,62344,86272,1706,64942,93101,363,33324,45799
79765,6097,91250,116379,4144,102960,135321,1953,59665,68011
79764,7104,68419,91433,4953,71335,95802,2151,47439,75837
79763,11544,52031,67839,8004,60449,78299,3540,28333,38997
79762,15613,68245,86777,10594,82250,95777,5019,42950,61409
79761,12106,54746,75463,7643,66829,85641,4463,30467,50259
79759,0,0,0,0,0,0,0,0,0
79758,1090,103167,99803,912,103276,106862,178,0,54500
79756,3345,70476,76546,2352,74239,84720,993,44563,53165
79755,47,117656,92234,43,118281,97563,4,0,0
79754,62,44076,73574,18,0,79539,44,43816,71132
79752,847,53015,59572,557,71477,71674,290,38750,35219
79749,123,117708,137466,103,125865,157842,20,35833,32530
79748,71,65655,166148,71,65655,164763,0,0,0
79745,2286,61648,70848,1634,63731,75106,652,33750,54190
79744,416,67500,86700,323,82212,101703,93,25179,34594
79743,120,76667,87168,75,94821,96867,45,59821,71002
79742,205,71339,67406,164,70714,70960,41,11806,35385
79741,98,41250,56869,52,87692,85548,46,18667,24450
79739,355,74625,100715,333,74625,101729,22,0,84877
79738,59,57396,88127,42,59375,71657,17,56042,128818
79735,4199,51838,70958,2847,61402,73706,1352,30191,61042
79734,915,0,50606,565,60230,58498,350,0,35486
79733,105,78750,80649,86,51250,74321,19,0,58932
79731,1463,55703,77596,1028,72019,89317,435,21936,45708
79730,76,62891,52203,53,63789,65742,23,25125,21004
79720,10776,57450,73576,6730,63929,82351,4046,37549,55452
79719,172,33333,44568,117,50417,54548,55,20729,22015
79718,268,47188,55983,196,71250,72620,72,9070,10696
79714,5649,75147,94468,4425,80863,102229,1224,41545,55693
79713,234,63750,116886,164,76667,131477,70,48750,81654
79707,13849,95024,145641,9308,128503,184381,4541,48345,61428
79706,8603,89162,106435,6432,95908,112285,2171,65464,82281
79705,15637,97394,122399,9979,115638,137125,5658,61521,90917
79703,7883,80666,96861,5856,86864,98974,2027,43532,72427
79701,9881,54915,74913,6994,63373,80640,2887,30641,55742
79699,0,0,0,0,0,0,0,0,0
79607,792,52143,65072,745,52485,65940,47,0,44526
79606,10527,65113,83385,6372,89047,104568,4155,40553,47863
79605,10980,49793,72564,7213,64923,80471,3767,29862,54701
79603,8501,43614,55897,5916,50215,60176,2585,26838,39909
79602,8798,69651,92794,6620,76797,103181,2178,35024,56426
79601,7654,46468,57929,4114,67038,77261,3540,24195,34119
79567,1134,45625,60658,802,52955,70090,332,24286,33978
79566,98,36429,66448,65,61094,80311,33,26563,25036
79565,67,44375,60994,45,85417,75640,22,33333,31036
79563,378,49500,52447,286,42188,52213,92,21250,28647
79562,1230,94091,97601,1092,102924,103036,138,36310,51141
79561,183,56875,73787,107,79464,96899,76,31250,41249
79560,61,44479,51508,49,43229,51651,12,0,0
79556,4620,42956,65622,3110,52402,78819,1510,22841,35222
79553,1402,46862,58275,908,58224,71843,494,0,30470
79549,5651,48425,65724,3684,65459,78336,1967,30149,37411
79548,85,51477,68531,55,76528,84755,30,0,38783
79547,442,27500,48983,251,53859,68898,191,22526,20929
79546,761,47067,66495,497,64844,82925,264,27955,32774
79545,767,46201,62706,572,53889,71168,195,27292,36146
79544,174,39167,47802,119,49375,57345,55,20417,27095
79543,533,54601,68412,372,55530,75994,161,32292,49800
79541,392,0,174034,316,0,208869,76,0,0
79540,26,93036,86062,21,93482,88638,5,0,0
79539,84,71250,85224,50,85417,110270,34,0,48391
79538,93,55694,73209,67,66806,87660,26,15417,12642
79537,13,0,135677,12,0,0,1,0,0
79536,1792,61903,74931,1326,62308,83074,466,50357,48729
79535,92,55625,68595,74,55313,58303,18,68125,110900
79534,88,0,83156,49,154375,129343,39,38050,25128
79533,178,45938,65277,112,57031,79556,66,17500,39236
79532,227,62917,106784,155,84688,142721,72,22813,29044
79530,206,58125,57908,153,71607,66076,53,35341,30560
79529,537,34358,54934,360,54615,70310,177,17201,23662
79528,254,60833,64395,150,63125,76149,104,60213,47442
79527,70,88750,168649,57,96806,202498,13,0,20231
79526,351,50625,74817,246,77222,91431,105,19306,33514
79525,1018,75156,75289,747,90771,88332,271,35958,38107
79521,1234,54415,79066,865,64250,68974,369,27067,97873
79520,924,45833,63587,681,57880,65116,243,24375,56506
79519,39,117083,92815,25,133355,114092,14,0,54821
79518,23,131563,132935,20,155000,138250,3,0,0
79517,114,0,92812,43,136016,136074,71,56076,66613
79512,2141,44678,75176,1237,81566,105048,904,36667,34083
79511,529,61563,75190,362,81818,93778,167,25850,34866
79510,2871,53379,63328,1892,62551,77537,979,28750,34607
79508,428,54375,65992,293,70096,76795,135,37917,42545
79506,326,51212,65245,183,75625,89801,143,34063,33820
79505,97,39821,53331,62,52857,68576,35,25156,26326
79504,1280,57065,73042,874,70200,84212,406,30909,48123
79503,91,80744,79701,24,0,93775,67,80923,74660
79502,472,58235,62417,343,72250,74360,129,17009,28518
79501,1176,46000,57971,779,65929,73424,397,23189,26209
79424,19685,83769,108591,13132,103356,132728,6553,40673,56848
79423,15780,70590,92784,11013,84172,106212,4767,41512,55575
79416,13294,58701,77439,7494,72312,87471,5800,39236,61534
79415,6354,32980,47742,3404,51099,59920,2950,22095,28750
79414,8199,42432,54692,3680,55263,64116,4519,37846,45536
79413,8667,56044,76211,5887,67144,91896,2780,29803,41617
79412,5773,34863,49929,3590,39158,57268,2183,24373,32337
79411,3080,36883,44753,1342,50581,60650,1738,25807,30656
79410,4195,38183,59081,2117,51209,73745,2078,26777,43219
79407,9401,49736,67120,4669,71189,85352,4732,33265,47544
79406,0,0,0,0,0,0,0,0,0
79404,3422,42826,55331,2113,48750,61499,1309,26611,42424
79403,5742,38243,52384,4028,46433,59372,1714,16756,32088
79401,3614,17951,35912,839,57779,59198,2775,11361,28788
79382,2921,72959,91273,2322,80119,98905,599,36995,59089
79381,544,56250,75842,440,61500,86521,104,14524,29124
79380,32,41875,58131,25,46250,70052,7,0,0
79379,174,45455,67875,123,72813,82505,51,0,29765
79378,77,85625,75592,75,86875,76639,2,0,0
79377,84,58182,60807,65,70417,68312,19,36250,35126
79376,15,0,0,0,0,0,15,0,0
79373,1125,35943,59192,772,47115,68840,353,20260,34084
79372,499,52321,68987,384,70294,76850,115,20673,38576
79371,612,59688,62269,452,60500,66512,160,39853,50059
79370,626,41389,57773,379,60469,82118,247,16188,20142
79369,38,0,41397,16,88750,79925,22,0,0
79367,256,45114,61962,157,58542,78952,99,23988,31213
79366,400,106111,132824,309,123194,144436,91,44653,93392
79364,2614,46124,63006,1811,47141,70789,803,31233,34430
79363,1971,63736,88729,1479,82452,106019,492,27763,35696
79360,4537,69964,81808,3620,79012,92787,917,26178,34877
79359,930,46827,59092,638,63347,75172,292,11895,17054
79358,414,70000,87061,277,73750,101615,137,49821,55843
79357,796,39052,45164,517,53616,54929,279,24107,24416
79356,1669,52917,58423,1235,71611,67534,434,18750,30926
79355,567,62125,68924,476,66957,72833,91,0,45219
79353,6,128750,234633,4,0,0,2,0,0
79351,574,59394,82700,422,70972,98845,152,17232,35780
79350,175,61250,61637,108,80391,72116,67,37989,40558
79347,2048,55410,69837,1390,68407,87444,658,21548,28547
79346,816,42549,55698,559,53194,67435,257,15750,26882
79345,290,52083,69200,241,60341,76881,49,30893,30951
79344,74,98664,92316,64,0,0,10,0,0
79343,558,53158,66306,464,68333,75661,94,10577,15381
79342,142,96111,84192,123,98750,88946,19,52813,52311
79339,2420,42622,51945,1580,55625,61973,840,20000,28588
79336,6015,45956,63801,4113,57096,74176,1902,25677,39288
79331,4256,39407,61776,2630,50395,74936,1626,20401,37853
79330,37,106016,117154,37,106016,117154,0,0,0
79329,1118,60410,78089,800,72083,95593,318,22453,32264
79326,18,0,54217,9,0,0,9,0,0
79325,711,58281,75869,519,73750,88091,192,23977,33405
79324,18,0,102300,14,0,0,4,0,0
79323,2296,67891,86371,1733,76612,97879,563,0,38772
79322,764,43526,82732,569,54688,99372,195,18594,30553
79316,3717,41701,61326,2472,47256,69582,1245,29053,42272
79314,35,21339,24031,28,20714,19675,7,40417,41457
79313,550,40455,54883,361,44760,67194,189,16520,23250
79312,314,46250,52375,210,56000,60414,104,24000,34666
79311,1328,52246,69221,942,74130,86826,386,20139,26237
79261,157,42232,74603,122,66500,89843,35,15417,19626
79259,16,0,0,16,0,0,0,0,0
79258,27,65625,52907,21,0,0,6,0,0
79257,388,36316,48463,217,52159,62739,171,21696,30347
79256,151,34688,51590,84,65556,71830,67,25417,26215
79255,209,42250,66651,134,63333,82587,75,21635,37557
79252,1327,45469,59270,837,56054,72699,490,24375,35109
79251,8,0,132113,6,0,65400,2,0,0
79250,550,43438,58669,377,52578,67263,173,22301,37576
79248,680,36818,54902,375,43125,72258,305,20679,32293
79247,22,0,42995,5,0,0,17,0,33976
79245,941,41576,56918,651,46572,64250,290,22885,37532
79244,302,52396,68471,214,60357,81763,88,23800,34273
79243,22,24167,33986,22,24167,33986,0,0,0
79241,759,54680,64960,535,64471,75434,224,32500,37117
79240,22,98750,90750,22,98750,90750,0,0,0
79239,83,26685,69951,52,35500,95427,31,23661,27216
79237,231,66750,62677,168,83654,75384,63,22750,28648
79236,87,39018,48975,63,37708,46467,24,0,55558
79235,1338,51250,63560,955,54627,67184,383,36250,51829
79234,16,36500,74456,11,0,92109,5,0,0
79233,62,30278,35023,19,48125,50411,43,21964,24386
79231,35,0,0,35,0,0,0,0,0
79230,38,53750,62711,38,53750,62711,0,0,0
79229,183,37411,63343,92,76250,86346,91,27708,40089
79227,540,38056,61733,354,51000,76266,186,33100,33596
79226,1090,50571,64451,691,59511,69061,399,29635,52425
79225,379,53472,66483,290,66250,75442,89,22946,25587
79220,73,58375,70727,66,57750,67568,7,110625,100514
79201,2321,43768,65930,1654,53750,71608,667,33939,40320
79124,3395,88828,130036,2409,114635,156852,986,53442,63092
79121,2464,75040,105896,1685,96042,132238,779,36083,48657
79119,7215,82094,118476,4610,125091,153103,2605,48172,56114
79118,8089,74686,91364,6205,87131,98762,1884,36157,60585
79111,487,58021,64425,399,58438,61965,88,45893,58194
79110,6948,57040,68064,5206,64709,74298,1742,36806,42400
79109,17943,60176,81951,10676,82043,99026,7267,33135,54500
79108,3968,50806,59820,2663,59161,68356,1305,28085,38713
79107,11385,34674,46096,8575,39660,51314,2810,17966,27763
79106,11960,43785,60912,6922,53725,72527,5038,30138,42698
79105,0,0,0,0,0,0,0,0,0
79104,2431,46793,50348,1705,55108,55491,726,30638,34736
79103,3719,45701,54864,2668,48036,57232,1051,29119,45679
79102,4426,44677,56194,2461,57774,69816,1965,29279,36554
79101,1166,35313,50903,438,59444,79457,728,21774,30320
79098,165,33239,53948,129,28125,57071,36,40000,41892
79097,376,100000,103217,284,102016,116898,92,38571,59736
79096,785,50179,76283,579,66838,87328,206,35263,44062
79095,961,40272,65410,656,52708,75980,305,26202,35868
79094,8,0,0,4,0,0,4,0,0
79093,40,0,92595,21,0,0,19,0,0
79092,432,67059,89429,330,72386,103503,102,38750,41307
79091,16,0,0,16,0,0,0,0,0
79088,1863,32869,46594,1149,36696,53625,714,24643,34150
79087,256,56000,83764,148,68333,106842,108,41118,50266
79086,852,53404,75338,648,63000,86946,204,27813,35850
79085,5,0,0,5,0,0,0,0,0
79084,742,49286,71018,591,54107,75778,151,35069,45466
79083,721,49034,62107,511,53819,71418,210,19038,32232
79082,83,55750,66124,45,103250,87473,38,31250,40842
79081,1311,46250,61184,938,69615,71945,373,29188,33560
79080,196,50000,55757,106,66250,70880,90,30000,36066
79079,1049,45684,58291,723,48802,66388,326,34167,36739
79078,61,38750,62828,31,0,97361,30,0,27143
79072,8264,47961,58597,5750,54796,68452,2514,22310,32501
79070,3259,53176,66995,2457,64419,72567,802,37717,43663
79068,1335,74753,91440,950,95750,104310,385,57216,58234
79065,7136,55225,75434,4663,71192,92895,2473,32664,38797
79064,820,48182,59059,602,56641,66956,218,17500,27210
79063,278,69773,94876,198,81000,114025,80,38750,38954
79062,78,54643,67465,65,54866,73611,13,0,36738
79061,88,57857,69761,57,63125,78368,31,37250,53939
79059,278,61310,69372,205,62054,73010,73,0,58681
79058,0,0,0,0,0,0,0,0,0
79057,516,57778,79739,370,78125,94097,146,25000,41670
79056,35,65417,73480,12,0,139467,23,0,39052
79054,213,37841,53364,130,46071,64481,83,19875,31754
79053,21,36250,51429,18,0,54044,3,0,0
79052,494,40577,56684,363,41406,65891,131,23523,26111
79051,0,0,0,0,0,0,0,0,0
79046,245,64306,100698,196,84500,104934,49,0,58633
79045,6046,50635,64184,4646,55606,70368,1400,32532,39385
79044,289,45321,56286,236,46071,54774,53,37284,63021
79043,414,40333,46296,289,40644,48682,125,32813,33666
79042,382,48077,65680,217,68854,86110,165,32639,35760
79041,1075,42316,61385,729,50575,67083,346,20000,45990
79040,583,52375,104069,434,69000,125064,149,26875,40760
79039,336,71071,82030,243,95875,102893,93,22708,25642
79036,1790,62835,72197,1318,74000,84967,472,23893,35453
79035,1850,63241,81141,1436,73542,92424,414,28222,36226
79034,180,56250,70437,129,63125,72722,51,34271,59973
79033,32,0,80672,20,0,0,12,0,0
79032,34,32273,40376,20,41250,46085,14,31786,32214
79031,481,51328,67732,285,67417,82078,196,21786,43298
79029,4752,57457,70103,3581,64808,78080,1171,35625,43508
79027,1715,48597,61889,1213,61027,74196,502,24575,31391
79025,17,0,0,4,0,0,13,0,0
79024,148,78333,74253,94,84219,88994,54,36458,48524
79022,3360,59117,82669,2380,70793,98416,980,38924,42304
79021,43,65156,58470,43,65156,58470,0,0,0
79019,692,69079,84844,528,75833,92794,164,65833,55260
79018,133,55125,71341,100,56500,83674,33,16438,21373
79016,0,0,0,0,0,0,0,0,0
79015,7584,70938,89694,5363,95857,111063,2221,27541,37401
79014,1326,62583,96525,932,93333,95698,394,24514,96442
79013,1081,37303,48259,728,47917,48139,353,26952,38898
79012,675,126520,136150,638,130556,136652,37,0,0
79011,111,54375,75526,64,75417,92858,47,53125,51926
79010,118,0,72120,91,0,80220,27,50568,44822
79009,538,47647,57929,376,54833,65654,162,33529,38996
79007,4661,58283,72636,3135,71299,85360,1526,26523,38512
79005,570,61250,74328,445,65156,80381,125,30375,50926
79003,75,76042,75672,58,76250,79541,17,76042,57118
79001,61,90313,123193,43,106875,148419,18,27500,62933
78963,241,65365,101159,214,65313,105981,27,0,62941
78962,1906,63678,82453,1300,83155,104435,606,21471,34438
78959,709,51607,76815,483,59306,87589,226,31364,51981
78957,3483,63036,81930,2350,83893,96297,1133,35444,48978
78956,1932,61652,76121,1386,75357,87967,546,29057,44598
78954,505,83583,127101,318,88214,163708,187,0,64453
78953,403,74456,79126,279,74698,75463,124,0,87368
78951,0,0,0,0,0,0,0,0,0
78950,783,54792,78495,581,79464,91152,202,24344,36017
78949,210,81288,92130,171,93173,107449,39,0,23449
78948,154,0,57021,112,62083,70985,42,14271,19786
78947,1742,59980,81304,1304,71944,92264,438,25536,46482
78946,499,54440,57713,387,63368,63505,112,30750,34129
78945,4133,55964,69854,2711,73598,83995,1422,25194,38385
78944,262,98750,98496,231,105302,105229,31,0,48329
78943,88,0,81567,71,0,101097,17,0,0
78942,3194,55035,64371,2445,55700,69811,749,29943,38638
78941,1050,62852,73959,708,64444,81491,342,0,53059
78940,846,70278,84165,625,77042,94999,221,43828,51182
78938,111,55750,70663,59,82232,99639,52,0,37787
78935,412,0,83166,275,0,78912,137,0,83228
78934,2246,55775,83433,1574,73750,94550,672,27160,54757
78933,510,62689,87104,370,64797,108602,140,0,27746
78932,181,87768,88473,165,89196,92795,16,43500,40106
78931,127,100139,96594,86,118750,115508,41,0,0
78886,150,0,73455,130,0,73798,20,69250,71230
78885,49,80313,76453,28,61429,77161,21,85795,75510
78884,540,66406,80250,450,64737,79594,90,38500,58000
78883,144,65893,67469,89,74479,87731,55,0,34680
78881,706,26667,43852,369,47813,59750,337,18408,25269
78880,690,38750,56998,433,41113,67598,257,25071,32842
78879,50,61389,91096,50,61389,91096,0,0,0
78877,278,36716,49022,278,36716,49022,0,0,0
78873,679,41083,69133,486,62581,82345,193,30043,30381
78872,400,27500,42130,318,38125,46883,82,22500,22276
78871,13,0,0,13,0,0,0,0,0
78870,323,55972,67025,280,61750,70157,43,31125,46628
78861,4402,55155,67835,2972,69205,81105,1430,29455,32352
78860,0,0,0,0,0,0,0,0,0
78852,16369,41794,55921,13124,47662,60422,3245,14470,32609
78851,11,0,0,0,0,0,11,0,0
78850,303,72782,95767,237,73911,97147,66,52625,57582
78843,22,0,0,0,0,0,22,0,0
78840,16221,47906,61721,12059,55955,68277,4162,20382,40898
78839,2951,41275,50601,2466,45000,54256,485,11504,17364
78838,83,92083,120347,39,0,70092,44,"250,000+",164891
78837,95,0,40087,72,38690,50351,23,0,0
78836,20,0,41100,14,71667,58714,6,0,0
78834,2460,26538,52146,1971,31779,55368,489,15459,25622
78833,543,28542,45906,330,40726,64672,213,12067,16832
78832,1475,39972,56212,782,61650,70161,693,19583,40471
78830,291,24659,34388,189,21941,32228,102,20625,28044
78829,323,0,32954,255,23781,29454,68,0,34575
78828,63,72813,61602,27,41964,44907,36,0,0
78827,407,25612,42634,253,51250,57663,154,20641,17944
78802,60,0,0,60,0,0,0,0,0
78801,7386,44923,59912,5132,55365,71376,2254,21290,32733
78759,21740,87080,117177,11052,135765,159542,10688,54789,72242
78758,21851,60769,72663,10008,61805,77408,11843,56565,66731
78757,11261,77560,103468,5749,110273,130722,5512,47785,71292
78756,4414,84779,117297,1488,158500,182799,2926,58311,81490
78754,9348,77377,93057,6051,84797,99626,3297,53199,72286
78753,21602,53797,69922,13173,55850,70935,8429,48457,62072
78752,9133,49214,69865,3892,53652,78701,5241,40729,60265
78751,8446,61735,88340,2278,100160,123994,6168,51734,74013
78750,12383,100489,129628,8241,136283,155190,4142,57033,75733
78749,15836,102303,121722,10091,122654,140155,5745,71279,85084
78748,21027,88688,107501,12154,102972,113595,8873,67637,93442
78747,6657,84098,95805,4745,92757,102333,1912,71273,71940
78746,10414,151488,226821,7314,199706,278333,3100,75040,100795
78745,27994,68669,85209,13820,86973,97822,14174,56926,70664
78744,16053,62905,75300,11313,66280,80177,4740,48272,59547
78742,273,59792,58328,164,58083,57080,109,32132,36079
78741,20714,52048,68962,6773,55842,78233,13941,49708,62931
78739,6788,169023,191001,5891,180868,200751,897,83422,116457
78738,6368,117371,161351,4477,150903,194030,1891,51420,81195
78737,6280,134545,162987,5591,138766,169145,689,53969,99453
78736,3677,97184,122263,2519,120791,140407,1158,64094,76858
78735,7862,100000,154050,4802,138088,200953,3060,62535,78272
78734,8181,114709,146818,5950,135234,166374,2231,66783,89371
78733,2839,171027,241690,2371,188071,266812,468,75104,109898
78732,6197,175118,227782,4546,213750,281093,1651,62907,78829
78731,13412,85586,141835,6843,145401,203542,6569,45890,76057
78730,4453,113614,203172,2978,176429,263246,1475,65025,80014
78729,11516,74782,96015,6409,92691,106199,5107,60664,81040
78728,10429,62223,78449,5497,76703,91533,4932,49739,62020
78727,13911,83603,101330,7728,102358,118178,6183,64227,78709
78726,5604,88750,123671,3198,142753,160419,2406,58361,71272
78725,3038,74205,87487,2172,71838,92016,866,73389,71322
78724,6619,58095,70092,5246,53750,69654,1373,53886,58375
78723,14192,72764,99783,7886,85786,114992,6306,53060,77337
78722,3145,75274,97305,1228,96364,120913,1917,63896,79306
78721,4027,55359,80606,2322,46680,79946,1705,55763,75740
78719,405,49917,65064,342,51923,66325,63,0,56098
78717,9916,117803,128423,7396,128333,147762,2520,57153,69661
78712,0,0,0,0,0,0,0,0,0
78705,8492,23509,53060,1468,82361,123735,7024,18504,37937
78704,26471,78861,118781,9145,123322,167705,17326,64817,90543
78703,9478,108065,186195,4576,181875,270217,4902,66551,107043
78702,10513,72906,93784,4230,70506,88769,6283,72217,94589
78701,7287,127782,174288,2145,154831,221609,5142,109024,154529
78681,18018,109246,126809,13990,125907,140498,4028,57440,71654
78677,6,0,0,6,0,0,0,0,0
78676,5884,76094,103645,3836,101432,129438,2048,40064,53907
78675,129,55054,120542,87,0,162695,42,30500,33224
78672,497,47120,78524,347,46467,86466,150,0,60153
78671,229,64740,88462,191,67083,100393,38,0,0
78670,41,61750,66656,37,72656,70049,4,0,35275
78669,5185,133673,166082,4383,142050,178576,802,58971,95550
78666,29205,45660,59651,14623,58430,77340,14582,29198,39698
78665,16257,101410,127898,12725,112080,137522,3532,63784,86977
78664,21034,77679,93299,14620,90282,104790,6414,54813,63345
78663,304,88750,105578,253,89688,115912,51,60625,54310
78662,1041,85934,84746,814,87427,94479,227,45225,48783
78661,97,41042,55267,56,80000,66821,41,28906,36620
78660,33953,93819,104978,25153,105176,114055,8800,60629,70006
78659,943,76505,91496,629,108090,106726,314,41382,52735
78657,2787,73983,120455,1883,97259,140596,904,35533,77196
78656,850,72637,85283,546,74615,100303,304,51250,54021
78655,1405,49417,67448,867,70990,81690,538,31458,41884
78654,7174,57087,76944,5114,70218,89694,2060,32845,44770
78653,8981,85544,89841,6681,84832,89382,2300,66944,75352
78652,2210,88243,110450,1499,107547,136153,711,48375,55721
78650,702,54643,67299,502,61979,70544,200,32813,43559
78648,3095,52884,61493,2227,60012,72716,868,24135,29890
78645,4851,83388,116422,3415,105114,141371,1436,40985,56605
78644,5836,62811,76632,3924,71727,87996,1912,36522,48246
78643,2666,60714,84750,1921,70956,91953,745,28872,42157
78642,3825,97204,115502,2951,114495,131685,874,45565,56611
78641,24371,105096,126322,19728,112235,137224,4643,54986,69415
78640,19246,74414,87897,14097,80515,93013,5149,49354,61004
78639,3481,49916,82039,2202,67538,103557,1279,31625,42596
78638,820,59403,65572,527,78545,85992,293,18363,27131
78636,1512,63346,74933,938,74444,94256,574,41094,42565
78635,183,85250,84461,178,85667,86660,5,0,0
78634,11461,90843,102233,8727,95307,105006,2734,66055,78813
78633,12626,81571,103485,8580,100353,124682,4046,46038,57928
78632,503,97250,89459,390,105972,102628,113,0,35921
78631,1129,58454,88830,880,73523,101583,249,32587,38905
78629,4487,60092,82191,3141,67123,92799,1346,34583,52374
78628,13159,97494,125190,10313,107231,138904,2846,52666,72531
78626,11466,80152,93357,7932,95630,103548,3534,46958,61077
78624,9343,62333,84636,6259,75188,96821,3084,34922,58463
78623,427,93828,98203,338,102755,109098,89,46211,43602
78622,105,55536,46732,58,60682,58598,47,0,28628
78621,7183,80100,85730,5408,82037,90045,1775,46235,65354
78620,6416,110986,144005,5296,124490,158040,1120,47714,69368
78619,1907,136779,161231,1735,162125,168118,172,44077,55101
78618,148,72500,97620,123,72250,84102,25,0,155964
78617,6981,64117,96277,5680,70439,101779,1301,45354,54037
78616,2491,55337,78027,1888,69356,83613,603,31827,53907
78615,376,70833,98823,293,91250,110442,83,0,30220
78614,223,58693,77275,185,71339,88631,38,30577,21989
78613,27558,107983,125381,20198,122527,138858,7360,60838,83339
78612,4119,71205,80939,3244,73394,84059,875,41480,56431
78611,4507,65130,89636,3179,75516,109245,1328,28116,39139
78610,13284,84114,108413,10269,94644,119633,3015,52465,64752
78609,850,59898,91481,614,86250,109272,236,31833,41103
78608,142,108913,108826,116,108913,114187,26,0,0
78607,55,0,28756,34,45000,43882,21,0,0
78606,2383,68350,115152,1657,78065,136331,726,42500,64861
78605,2144,59224,80231,1730,61792,83911,414,46481,56250
78602,9107,65618,86209,6536,82485,102897,2571,25446,40684
78598,92,17222,31529,31,0,56716,61,16477,18730
78597,1477,58986,132511,892,74421,174268,585,39536,65163
78596,19053,45881,61177,15674,51503,64793,3379,21756,37503
78595,1974,34727,45496,1664,41346,49960,310,12564,15567
78594,514,28438,38042,331,44479,52134,183,9293,11192
78593,1531,38051,45521,1188,40550,50476,343,16776,26560
78592,223,29196,35498,180,32024,38061,43,0,16512
78591,73,0,61649,54,0,70800,19,0,0
78590,64,40357,47641,52,43750,55165,12,13750,12917
78589,11123,42381,53358,9620,46195,56888,1503,19144,26171
78588,39,0,28954,25,0,27588,14,36250,31393
78586,16556,35951,49063,13306,39053,53134,3250,20651,28357
78585,88,0,20300,68,0,26271,20,0,0
78584,4802,23936,35898,3786,26544,39141,1016,18118,21999
78583,2259,40299,59465,1706,58357,70390,553,14036,23413
78582,10957,35441,52293,8655,39608,59510,2302,11212,22490
78580,3831,38096,53741,3000,40595,56011,831,25855,31783
78579,1232,53393,60270,1183,54122,62264,49,0,0
78578,4206,35662,54070,2891,48777,61774,1315,20350,36768
78577,22690,40463,52678,18442,44060,56551,4248,26146,30233
78576,2398,24151,38831,2050,26569,39641,348,0,22818
78575,3425,72306,94560,2933,78772,97415,492,34409,51971
78574,15823,37639,58666,13949,40545,61526,1874,17764,29475
78573,10650,38774,57203,9256,41678,60884,1394,14460,22489
78572,24758,45274,64600,19383,49875,72050,5375,26313,34941
78570,8732,35382,51009,7160,41074,56678,1572,11466,20922
78569,1355,43281,58425,976,50735,62993,379,0,46295
78567,106,24643,35770,64,30833,51756,42,11071,11410
78566,5246,52703,72069,4370,59325,75153,876,16500,49052
78565,42,0,0,0,0,0,42,0,0
78564,42,41087,50119,42,0,0,0,0,0
78563,104,62589,64784,80,63661,74314,24,0,0
78562,540,46591,58374,379,57917,71973,161,15046,25932
78561,133,26477,36133,100,26818,33763,33,23021,26597
78560,1368,33750,42123,1103,40131,43106,265,0,32868
78559,4265,38313,56682,2981,52771,67273,1284,22422,27815
78558,239,68977,71119,211,75389,74343,28,0,0
78557,3774,38273,48364,3220,38781,50689,554,0,31765
78552,12884,51270,69440,9442,57785,78796,3442,30061,40482
78550,16893,40105,55179,12136,46273,59735,4757,26563,39795
78549,286,16705,27587,224,24524,32922,62,7500,8311
78548,167,35781,49166,139,42250,50430,28,13750,33707
78545,76,0,23808,43,0,0,33,0,0
78543,2851,41197,57485,2465,42360,57801,386,24541,55469
78542,18707,46200,61363,16008,45830,63198,2699,29246,41018
78541,13635,37260,54643,9770,41877,58646,3865,26970,41661
78539,12831,61201,80989,9206,70674,90497,3625,36716,48460
78538,3125,35083,51839,2499,40793,59013,626,13456,21559
78537,12207,29705,39595,9753,32599,43252,2454,15106,21684
78536,126,57500,64081,95,0,67783,31,57188,52739
78535,236,55469,60920,149,56761,74763,87,0,37214
78526,13915,58156,66644,11966,60412,68164,1949,40574,52452
78521,25503,33616,45665,20476,37110,48819,5027,16445,28064
78520,18128,37803,51701,13325,43868,59209,4803,16065,27437
78516,10443,36747,50073,8280,43214,55464,2163,23750,27044
78504,18506,62975,89093,14848,68436,96524,3658,40250,52625
78503,6137,35130,54390,4936,32645,53133,1201,37388,59394
78501,20650,41345,58222,14324,49014,65802,6326,26906,38359
78419,210,73667,79165,174,59643,79181,36,76944,79086
78418,12127,77307,100679,8114,95857,119344,4013,42450,59347
78417,1379,55956,63691,997,61510,69309,382,41042,38577
78416,5310,42840,51424,3812,46584,58531,1498,22284,28904
78415,13871,50397,57502,10599,55388,61023,3272,30629,39681
78414,16261,86369,104999,11294,102638,119534,4967,54810,67608
78413,14818,70962,88303,9863,86221,102755,4955,45264,56882
78412,15836,48730,65328,9017,60328,77974,6819,33783,45547
78411,9362,54030,73689,6131,66226,85180,3231,34968,46739
78410,9377,74404,85153,6880,84054,93330,2497,49063,58363
78409,913,56208,59837,559,68060,74261,354,27054,35455
78408,4207,35627,41777,2747,38159,48466,1460,23382,28308
78407,642,41250,59335,463,41033,54569,179,33967,52907
78406,355,47125,65510,305,70272,72291,50,16964,17066
78405,5238,29379,40415,3369,36237,43999,1869,20148,32504
78404,6271,49112,72954,4243,58119,85186,2028,33679,43863
78402,110,0,47895,24,70938,56513,86,26852,45488
78401,1653,28750,56442,573,46375,94578,1080,19071,35220
78393,788,50903,62323,574,55278,71882,214,25800,35891
78391,62,44833,56755,43,44083,58065,19,0,0
78390,1826,42273,60411,1382,55000,70768,444,16852,24386
78389,714,33375,58849,508,58542,74554,206,20730,19229
78387,3209,48506,64316,2276,62079,77835,933,14552,28692
78385,129,40083,42733,115,41250,45370,14,0,0
78384,1756,32215,47275,1064,45375,56823,692,25938,30207
78383,1980,61291,89430,1422,69750,98738,558,39583,65709
78382,8033,53674,80940,5266,69660,95598,2767,28102,49987
78380,8124,51061,65381,5911,60417,78424,2213,14803,26535
78379,499,61078,81067,320,77143,92751,179,43125,58475
78377,1198,53000,66026,802,65000,69376,396,26429,57080
78376,181,50069,53444,96,53167,57315,85,0,49073
78375,1001,39316,53477,751,46065,61491,250,35049,29539
78374,6201,76398,98650,4694,84161,103949,1507,42485,78154
78373,2090,71182,89179,1399,88783,101997,691,0,62426
78372,1363,41328,63104,993,67822,75243,370,21010,27930
78371,75,0,39820,44,0,46725,31,0,30019
78370,1497,63036,81521,1164,80690,92770,333,27875,39689
78369,146,0,55069,95,78068,70613,51,0,26116
78368,3801,35131,56738,2322,46190,70174,1479,20480,33253
78363,10632,46783,60572,6851,55813,73476,3781,22112,34588
78362,3779,64592,75440,2811,66391,80680,968,46159,55669
78361,1563,36045,51969,1129,41827,57204,434,17286,33512
78359,644,35625,51555,497,39276,57924,147,20875,29100
78358,273,45897,62315,206,51250,76639,67,17880,18273
78357,857,58429,59384,663,61228,68656,194,19063,22398
78355,2406,25850,41159,1454,33138,54420,952,13587,18291
78353,214,0,32961,84,0,54629,130,0,18959
78352,65,0,27565,43,0,0,22,0,0
78351,149,31113,35897,147,31152,35960,2,0,0
78349,154,0,45836,149,43125,46653,5,0,0
78344,138,61176,67397,107,71016,85567,31,0,0
78343,1629,43021,65072,1322,52770,68911,307,30063,43790
78342,89,42824,54576,83,43102,57865,6,0,0
78341,686,54674,65461,516,73478,77500,170,12500,23754
78340,201,46303,54295,139,47048,58681,62,33409,44463
78339,166,54038,58637,101,0,68731,65,0,42952
78338,0,0,0,0,0,0,0,0,0
78336,4751,46483,64919,2854,54795,73397,1897,32253,49542
78335,0,0,0,0,0,0,0,0,0
78332,9006,43906,61130,6726,54340,69965,2280,19084,29876
78330,232,40000,54564,173,46875,63585,59,16932,28115
78266,2501,124131,154494,2029,139356,168130,472,48804,95876
78264,2890,48799,59194,1993,62844,69973,897,26072,33434
78263,1193,80990,94366,908,86604,105368,285,48681,58696
78261,5942,95581,119770,3897,118125,142820,2045,51151,70619
78260,7947,120670,142384,6506,133636,154591,1441,52764,80177
78259,9502,91616,112859,6256,115704,134535,3246,58194,68344
78258,16380,103908,134594,11224,130957,161656,5156,53937,72702
78257,3825,76458,141527,1809,131029,224342,2016,45867,66356
78256,4122,93866,125389,2123,120573,168296,1999,59850,79250
78255,4702,124901,145342,3687,144281,163087,1015,70536,79674
78254,17473,95251,103344,13970,101329,109151,3503,60944,68747
78253,11930,105820,117929,9809,109139,122429,2121,60675,81870
78252,2655,67930,77933,1895,70477,80360,760,52750,57797
78251,20593,66667,82640,13880,80993,95033,6713,43303,52017
78250,18665,71842,83067,14363,78506,89084,4302,51752,56388
78249,20991,72629,86942,12133,92829,106167,8858,52068,57641
78248,5427,124311,153133,3737,152633,188540,1690,45893,72795
78247,17644,78974,89766,12865,85017,95332,4779,57669,68659
78245,21283,72564,80285,16742,76113,84054,4541,40972,52598
78244,9796,61029,81748,7019,64675,88655,2777,42336,56805
78243,0,0,0,0,0,0,0,0,0
78242,9262,41598,47395,7093,44073,50779,2169,24578,29996
78240,23502,54646,71414,12465,73564,87051,11037,41923,51824
78239,7931,62271,77529,5665,68750,85898,2266,38731,50383
78238,9712,49317,58963,6030,56749,65294,3682,36982,45133
78237,11662,33477,43646,8064,36532,47971,3598,20629,28782
78236,355,79420,80836,340,79327,80616,15,122656,85827
78235,663,49922,71893,246,58929,112939,417,38618,44596
78234,979,79306,92793,936,80469,94217,43,0,43547
78233,16709,60155,68380,10806,67286,74412,5903,38756,53639
78232,15471,75090,96091,9723,93985,115386,5748,49208,60918
78231,3679,95918,132086,2629,111847,154226,1050,43901,74540
78230,18527,61948,90051,10486,87577,115938,8041,42871,53920
78229,14847,40213,50785,6433,41205,57591,8414,37560,44058
78228,18773,42445,52482,12644,49905,59678,6129,24183,32975
78227,14401,40282,55531,9842,45824,62152,4559,28280,35011
78226,2334,26728,40098,1440,34767,47399,894,16853,26133
78225,4921,37587,49062,2982,50868,56552,1939,28092,33695
78224,6005,50961,57788,4873,54021,59921,1132,37633,41071
78223,18203,43561,54383,11629,51486,60695,6574,25018,39385
78222,7630,55884,65588,5824,62697,73139,1806,19592,31577
78221,11828,45950,55897,8711,54014,62592,3117,23519,29277
78220,5436,33243,47407,3324,39921,52421,2112,19593,36203
78219,5513,37945,50166,3799,44899,57964,1714,24349,30154
78218,13421,42870,57032,8106,52606,65430,5315,28134,42672
78217,13919,45417,58230,7509,55969,67705,6410,38553,43039
78216,18652,48496,68834,9873,64609,88354,8779,35880,44138
78215,1914,72935,97865,382,138696,143702,1532,58500,86435
78214,7939,36421,51175,5165,45540,51094,2774,23413,48501
78213,16155,48340,60986,9578,55311,71806,6577,35930,43010
78212,10939,49305,94834,4857,75583,143661,6082,40821,55006
78211,9074,41695,50075,6655,43761,52128,2419,25083,35411
78210,11828,41109,55713,7568,46344,64104,4260,25174,36214
78209,18787,75484,144416,9678,140403,199501,9109,53029,83686
78208,1789,18855,31096,842,33529,39983,947,13801,22104
78207,15573,26915,39302,10152,34068,44873,5421,14823,25919
78205,1127,33411,49178,170,0,118403,957,24107,36881
78204,4310,40195,65387,2436,49202,69808,1874,22436,58202
78203,2088,32967,40138,1152,39167,46684,936,20648,26733
78202,4056,31802,57138,2179,38750,69700,1877,27162,41519
78201,16631,37518,53727,9790,46959,65039,6841,23548,34590
78164,1570,57875,90046,1116,63628,95235,454,31786,71891
78163,4893,103777,129848,4220,126613,142985,673,32463,40024
78162,130,38913,64122,91,0,72396,39,29196,44487
78161,233,55625,83236,147,0,107584,86,0,39366
78160,1747,69934,76513,1466,73889,82259,281,0,42517
78159,360,54375,66664,257,63510,81339,103,22917,26187
78155,17693,58900,77717,12431,69942,87119,5262,37310,51381
78154,14681,83042,100169,10821,98824,112371,3860,56220,61955
78152,803,95306,104826,593,96992,113441,210,0,80497
78151,657,40417,66585,517,41036,67206,140,0,50731
78150,0,0,0,0,0,0,0,0,0
78148,7817,64457,81249,5656,72485,90759,2161,40698,50318
78147,504,68529,82277,433,80179,90511,71,22125,32062
78146,224,58235,115850,140,61250,162973,84,0,37313
78145,24,36250,38492,20,40357,39725,4,0,0
78144,14,0,0,0,0,0,14,0,0
78143,42,0,46119,31,0,0,11,0,0
78142,36,0,65006,28,0,81057,8,0,0
78141,321,42679,52936,161,63542,74357,160,28913,31308
78140,1094,55125,64982,734,58300,66780,360,34419,56929
78133,7664,70938,87863,5472,82342,98412,2192,40969,55753
78132,11312,108276,136658,9334,119895,149722,1978,53072,71921
78130,29297,66574,86250,19672,78728,101227,9625,42326,51770
78125,27,0,39615,14,53750,48036,13,28906,30546
78124,2294,73724,93269,1762,75647,101106,532,38929,55834
78123,1035,80341,82969,740,83167,86779,295,0,32903
78122,223,61659,79952,159,0,98169,64,0,34692
78121,4207,101649,122699,3553,108526,133058,654,42949,54143
78119,1869,46734,72942,1180,85192,85861,689,33274,48530
78118,1117,54316,78439,769,55938,84833,348,51920,63819
78117,241,34602,70289,172,34533,76994,69,41042,53575
78116,130,0,299815,125,198125,310430,5,0,0
78114,7790,71643,95603,6339,81328,105349,1451,35856,49557
78113,1218,71908,101799,869,82466,108943,349,45759,83801
78112,2525,46349,59917,1706,60091,72298,819,22101,31185
78109,11936,68689,78542,9041,78558,85789,2895,39790,51465
78108,13401,96207,107137,11422,102240,112649,1979,59498,66505
78107,218,29519,71509,104,93370,131164,114,14844,17087
78104,60,69063,69475,60,69063,69475,0,0,0
78102,7012,46089,60647,4646,51213,68882,2366,31098,39745
78101,2356,93125,97613,1906,101183,105790,450,25893,47193
78076,4377,32560,50635,3030,37248,60518,1347,14248,24705
78075,121,0,76478,43,0,102181,78,0,62308
78073,2033,58038,70583,1746,57664,70717,287,31055,52341
78072,147,62344,91948,121,61719,97794,26,69167,64738
78071,1021,45042,75002,765,61103,86539,256,36214,39740
78070,5635,86997,116666,4580,98784,125290,1055,58990,74686
78069,1737,58698,73899,1377,59723,83158,360,23986,34684
78067,223,46339,184288,153,0,256923,70,0,0
78066,264,72679,85208,239,74911,89244,25,0,0
78065,3521,51598,67898,2605,58937,77886,916,22705,32731
78064,5109,66179,88327,4003,75398,100055,1106,35179,42711
78063,3875,63199,87619,2585,69835,101989,1290,46226,56265
78061,2928,47598,74284,2146,54710,87379,782,27500,33429
78060,0,0,0,0,0,0,0,0,0
78059,1762,66632,85601,1307,79199,101705,455,0,37875
78058,327,98160,199381,242,97708,109382,85,118750,454555
78057,258,0,45776,87,85518,84999,171,25000,25820
78056,806,116167,136832,646,126538,155071,160,68214,63193
78055,796,58496,81383,564,59845,89614,232,31538,59537
78052,1854,55944,74066,1438,57128,76170,416,33604,63680
78050,217,46098,49752,195,45720,48428,22,0,0
78046,17231,40890,55035,14949,44885,56836,2282,22645,30128
78045,19698,73541,89999,16532,74874,93820,3166,52536,57678
78044,196,34886,39601,117,46563,59713,79,25000,0
78043,12725,43968,57355,9918,46339,60175,2807,22755,42338
78041,14459,53514,73602,10825,61329,83163,3634,27615,40711
78040,11581,27319,39105,8656,33333,42564,2925,14186,23334
78039,743,73229,84029,589,94760,96475,154,0,30582
78029,0,0,0,0,0,0,0,0,0
78028,16597,55776,75613,11160,67846,86627,5437,36962,46934
78027,230,0,166681,230,0,166065,0,0,0
78026,2522,63596,75266,1897,81928,88100,625,31336,34008
78025,1986,54130,63772,1362,61938,71178,624,33333,45875
78024,578,61125,104987,454,65714,97908,124,0,127757
78023,8768,121264,144934,7635,126211,152928,1133,72785,82105
78022,1368,51655,61781,948,56059,70503,420,29333,35544
78021,41,0,0,41,0,0,0,0,0
78019,513,57463,79679,422,0,86141,91,0,46243
78017,1127,48143,61609,756,66719,67736,371,14453,49125
78016,3442,50176,74783,2655,64097,86416,787,16602,22788
78015,5658,126910,164652,4477,136813,170770,1181,56913,126442
78014,1721,46940,56241,1287,55056,63026,434,11946,23279
78013,2030,75060,106440,1432,93125,121598,598,46339,64273
78012,103,64583,55380,40,66250,75748,63,0,42446
78011,558,32083,43473,392,34091,49544,166,27045,28055
78010,1499,65388,88191,1240,71602,91295,259,26399,47742
78009,2511,59176,80817,1829,76693,91857,682,44828,47869
78008,183,0,99575,42,0,0,141,0,62991
78007,67,96845,106646,62,97143,112915,5,0,0
78006,12515,97910,144216,9572,115833,158453,2943,51604,93269
78005,465,56357,61964,422,56711,66947,43,0,0
78004,436,110357,107794,388,106538,110380,48,113065,86892
78003,3712,57005,71750,2664,58976,78695,1048,40682,49162
78002,1529,53299,60976,1247,62723,64433,282,41667,38836
78001,0,0,0,0,0,0,0,0,0
77995,3852,45303,63148,2756,59043,74282,1096,20929,31221
77994,136,72438,113779,105,0,48635,31,0,204510
77993,23,113625,117026,23,113625,117026,0,0,0
77991,100,104671,115156,100,104671,115156,0,0,0
77990,331,51128,59720,187,54896,71482,144,48750,43983
77988,96,0,61278,81,73750,71640,15,0,0
77987,90,71667,76038,74,100227,89054,16,6786,15838
77984,1675,71134,94807,1297,89196,109993,378,30530,38929
77983,911,50781,70150,528,80714,89060,383,37836,43268
77982,433,52868,56919,331,45536,55374,102,44408,49358
77979,6428,58057,72469,4512,67433,80373,1916,34722,51114
77978,221,73750,85695,140,78750,96191,81,41875,59232
77977,258,26293,36028,111,31827,51671,147,19714,24215
77976,17,0,144871,17,0,144871,0,0,0
77975,690,65682,89356,489,76850,105690,201,34464,48218
77974,159,53828,73184,130,0,73101,29,58125,73555
77973,7,0,0,7,0,0,0,0,0
77971,327,63299,82641,275,49617,80415,52,0,0
77970,96,63214,76588,88,63214,77823,8,0,42725
77969,64,0,86941,57,115074,94289,7,0,0
77968,1004,92625,110538,826,105167,129546,178,13689,20615
77964,3097,52830,74862,2043,68272,91647,1054,33155,37606
77963,2065,47526,69906,1314,71570,95888,751,17510,22829
77962,1094,60000,72636,802,68214,79302,292,39318,51408
77961,103,0,66355,23,0,0,80,0,0
77960,62,0,0,0,0,0,62,0,0
77957,2937,54461,68362,2131,71361,79083,806,31990,39048
77954,3374,55135,78192,2303,73060,95855,1071,17179,37239
77951,502,30545,37843,352,33472,43120,150,0,16173
77950,75,49792,53929,43,56719,63188,32,45833,41491
77905,5545,67681,81633,4101,78606,93291,1444,33199,48230
77904,10695,79938,107128,7618,96979,115851,3077,45861,83304
77901,14584,45898,58762,9183,50608,63820,5401,33498,45162
77880,807,76669,105915,540,100208,125255,267,75786,66800
77879,2042,60000,84495,1265,71023,103614,777,51172,51891
77878,145,32372,71028,72,0,106878,73,31750,35670
77876,70,112708,109609,70,0,100130,0,0,0
77873,543,47426,69714,258,76250,84540,285,39375,56293
77872,710,61480,76453,562,65000,84221,148,33077,46178
77871,1362,53241,71108,851,62898,90825,511,33575,38261
77868,5133,54460,71066,3964,57023,75375,1169,30982,52828
77867,109,53125,49253,99,53125,47102,10,42500,40480
77865,779,53283,72032,554,63500,80963,225,31103,41663
77864,2767,61523,72581,1962,64315,85112,805,23542,38298
77861,798,73143,97168,604,77500,112455,194,0,47403
77859,2644,48265,57055,1655,54490,67567,989,21078,38773
77857,361,39531,77552,221,76719,94229,140,20789,51226
77856,1976,61429,85350,1482,77917,97778,494,32250,44897
77855,64,0,0,64,0,0,0,0,0
77853,508,43333,67246,325,64375,90462,183,0,26016
77845,25639,80696,108667,17860,100586,130417,7779,38172,54877
77840,20655,25639,41414,6211,41749,62439,14444,21642,31491
77837,751,53250,56406,584,65026,62113,167,26917,36448
77836,4710,62357,79465,3216,76074,94896,1494,33701,45062
77835,1207,48162,69740,675,108508,101820,532,25278,27755
77833,10528,56651,82166,6873,71400,97602,3655,35776,51463
77831,1068,46047,76108,647,64779,102484,421,25347,30337
77830,1178,90705,113143,823,91186,90206,355,81544,164881
77808,4662,80179,100917,3752,93231,110933,910,39048,56223
77807,3679,68780,103679,2512,92306,130437,1167,35375,41079
77803,9736,42179,56513,7048,46145,59283,2688,31979,42642
77802,11116,56655,72749,6169,74528,87209,4947,41958,51734
77801,5821,32709,38911,2561,39564,48982,3260,22311,29271
77713,5822,70960,88243,3701,80759,100042,2121,53788,61369
77708,4882,48146,67946,3103,60625,72048,1779,35255,57888
77707,6839,52607,72703,4953,63003,83395,1886,28527,42073
77706,13286,62500,98682,7789,91381,127530,5497,40162,55876
77705,10827,42466,59428,6382,54422,75003,4445,26592,35797
77703,4613,26838,39989,3158,31392,47151,1455,14596,20607
77702,1360,66719,78197,860,81538,95393,500,37639,46764
77701,5117,39056,44865,3185,40693,47445,1932,23495,36754
77665,1931,59875,82980,1437,67596,94411,494,34085,46924
77664,1038,58284,64629,754,62500,73272,284,32679,41138
77663,382,0,43059,192,64792,63048,190,0,22861
77662,10343,60654,74427,7206,80052,90973,3137,25560,33413
77661,481,14635,32330,314,0,44917,167,0,8663
77660,443,53147,66525,310,65789,78158,133,31133,35774
77659,1797,84205,88378,1431,91196,94779,366,28438,60814
77657,7871,77408,89988,6004,97632,103447,1867,37332,41419
77656,6156,56761,68142,4514,64850,77584,1642,25390,38614
77655,155,61319,88445,78,104286,124029,77,39750,51261
77651,4707,75164,102529,3245,86804,116956,1462,50100,68270
77650,986,57429,63450,651,86932,85501,335,12320,18355
77642,13761,36017,50609,8926,43213,57676,4835,23783,35299
77640,6692,41317,57151,3942,48263,70688,2750,24893,36131
77632,8263,75127,88608,6382,82518,98016,1881,30608,48564
77630,10498,54708,74573,7410,69360,85497,3088,27273,40682
77629,340,67813,68845,274,69531,78477,66,35938,28858
77627,8426,77933,91695,5514,95878,110088,2912,38631,56153
77625,3732,56939,77828,2690,67770,87225,1042,21436,48965
77624,312,66500,79135,266,0,85061,46,43056,40235
77623,262,59265,71692,155,64896,77244,107,54922,63650
77622,455,94896,101935,337,86908,114539,118,45333,49398
77619,5747,56336,72838,3851,71769,77641,1896,41522,58965
77617,38,0,51303,9,0,0,29,0,55010
77616,93,46620,59342,37,0,0,56,0,71614
77615,373,95722,84467,223,90417,86714,150,95780,79331
77614,176,0,56263,140,0,66556,36,0,0
77613,507,46615,68525,292,78846,85662,215,43189,45252
77612,3601,59515,70240,2668,73137,82344,933,24099,33936
77611,3306,86680,100826,2466,92148,112570,840,45733,65304
77598,11962,52184,67517,5932,65307,83421,6030,41589,48555
77597,274,64688,88777,177,78274,91684,97,0,83472
77591,5187,51891,88445,3365,64441,109546,1822,37938,46868
77590,11618,47786,73204,7838,60086,87564,3780,28712,40264
77587,5048,45354,57681,3993,52592,63074,1055,26875,31149
77586,8869,96229,129035,5999,117386,143462,2870,54331,93123
77585,466,0,37727,344,0,42077,122,0,25461
77584,31048,107340,132545,23686,126948,150711,7362,57321,69236
77583,10563,89406,103319,8805,101013,110605,1758,51362,60545
77581,16912,95273,113360,12990,109335,127626,3922,46494,63905
77580,320,157887,133854,280,158592,148467,40,0,0
77578,7559,92891,110977,6062,108800,122731,1497,53359,55963
77577,514,75714,84754,389,87031,89491,125,40701,63248
77575,6013,53506,73084,4289,70496,89030,1724,21069,30073
77573,31934,111011,126421,23917,125858,143073,8017,52639,69934
77571,13195,77709,109948,9720,90320,125153,3475,47314,59076
77568,6468,50532,69225,4179,64237,85966,2289,25381,34962
77566,10865,83709,105142,7646,100565,118428,3219,48970,68958
77565,3204,71176,113259,1892,92348,138005,1312,49864,74537
77564,551,73872,80418,391,93993,96141,160,19861,41365
77563,4430,69699,88186,2991,81549,101807,1439,36234,55640
77562,3600,56927,72456,2551,65130,85664,1049,23281,35324
77561,40,0,75148,16,0,0,24,0,69883
77560,270,95759,98638,229,96408,107128,41,52321,44217
77554,4092,78582,112034,2246,111800,151266,1846,53125,63258
77551,8751,52222,75537,5188,66989,92098,3563,34663,48927
77550,10170,42179,62846,4623,58750,81627,5547,30370,45465
77547,2765,43341,57142,2269,49656,60646,496,26304,31383
77546,17987,105406,134135,14109,124503,150953,3878,47522,66552
77545,7242,81135,89256,5720,81617,91525,1522,73456,69864
77541,6813,50180,62531,4686,52925,66079,2127,29888,48969
77539,16255,73285,90073,11696,85095,100181,4559,52217,61765
77538,282,57375,81523,208,60000,89718,74,46042,58476
77536,11305,77163,95233,8623,91577,103008,2682,41157,65547
77535,9678,58813,80361,7219,72488,92851,2459,29674,37834
77534,908,100000,116702,759,109453,127531,149,56528,58982
77533,369,44632,74626,269,49453,88944,100,31250,34687
77532,10686,78489,95307,8112,89286,105788,2574,35183,54972
77531,6191,63169,83561,3953,70090,88580,2238,46451,68717
77530,8888,63155,74889,7299,65809,77395,1589,34391,51805
77523,7370,127339,136738,6530,132786,138138,840,33895,56947
77521,20786,67918,77677,14563,74837,84878,6223,41421,56930
77520,11882,51165,63770,8151,59433,71956,3731,26654,38702
77519,350,48529,66789,234,88224,86685,116,22250,26281
77518,3672,54242,73565,2684,60000,74974,988,38382,51672
77517,2074,62127,88653,1658,79130,94842,416,24936,63984
77515,11728,76923,95726,8121,90503,108760,3607,50145,59771
77514,2095,53378,67770,1529,61982,77740,566,27577,38130
77511,16877,64855,84296,12678,74284,92700,4199,41010,54154
77510,5422,82653,96813,4054,96386,110355,1368,38516,53094
77507,219,63178,57517,20,0,0,199,62912,55292
77506,10535,44929,54486,8361,48910,57855,2174,24806,36082
77505,7837,88917,107332,6063,102786,117436,1774,53882,65853
77504,8965,43991,63792,6005,53915,74112,2960,32013,39113
77503,7776,57584,63265,5701,64714,71288,2075,29077,36643
77502,10834,55551,65310,8715,61782,68635,2119,30625,38409
77498,15914,86934,113789,12669,98052,123463,3245,55843,70476
77494,38439,142037,168443,33865,148227,178692,4574,60544,81260
77493,12301,91670,107826,10327,102795,112428,1974,57500,66713
77489,12560,67431,79368,10051,68731,81893,2509,52372,60473
77488,5276,48436,65515,3465,61194,81112,1811,29004,34381
77486,2779,76635,82835,2066,79867,94779,713,0,47374
77485,1525,49028,65383,1106,55917,72027,419,30454,34900
77484,3772,75886,87632,3015,76975,96516,757,40028,44504
77483,104,78415,69099,93,0,0,11,0,0
77482,677,43393,64042,556,52581,67440,121,0,48427
77481,66,0,0,0,0,0,66,0,0
77480,3251,59598,72517,2296,66008,83033,955,30801,42499
77479,29628,139294,168713,25082,151300,180311,4546,71578,97882
77478,9073,97639,142362,6904,112979,156508,2169,55067,93108
77477,12951,61103,74848,9131,70190,81483,3820,47185,53551
77476,84,36161,54058,66,0,65685,18,0,0
77475,356,52102,76817,347,52201,78089,9,0,0
77474,5241,73105,82972,4015,85298,93717,1226,29063,42508
77473,24,0,28529,11,0,0,13,0,0
77471,12653,55333,68760,8991,60919,75568,3662,40409,48607
77470,184,45000,47180,150,48000,47121,34,0,47441
77469,19102,85401,106095,14185,97447,118995,4917,43966,60930
77468,13,0,0,13,0,0,0,0,0
77467,16,0,0,0,0,0,16,0,0
77466,236,60250,62797,149,69375,74695,87,0,32463
77465,2618,62656,67810,1926,76611,80405,692,20801,32757
77464,43,0,112123,25,54464,75200,18,0,163406
77461,4117,74092,89640,3335,78010,97254,782,28991,53182
77460,8,0,0,8,0,0,0,0,0
77459,23823,118130,141790,20266,122960,151035,3557,60565,78858
77458,145,97676,74714,78,0,0,67,43980,45691
77457,271,23750,36301,176,0,47100,95,9375,16296
77456,390,43790,61955,298,60174,72505,92,23026,27779
77455,684,62188,74345,497,77083,93649,187,14583,23038
77454,0,0,0,0,0,0,0,0,0
77453,136,0,54307,136,0,54307,0,0,0
77451,15,29375,29793,6,0,0,9,28125,26367
77450,25619,93930,126978,20789,107338,138419,4830,53351,73376
77449,37436,76481,88516,29442,83179,92863,7994,55499,62932
77448,56,0,0,15,0,0,41,0,0
77447,5367,82560,105925,4149,98076,116902,1218,43287,66082
77446,999,16664,29944,353,0,62691,646,0,11682
77445,5047,50605,62005,3408,56389,71131,1639,35546,41453
77444,222,0,60650,171,82621,65252,51,18487,32833
77443,126,0,0,126,0,0,0,0,0
77442,296,45000,54155,213,57634,65067,83,0,25493
77441,3795,159618,183309,3526,168049,191962,269,58589,69891
77440,28,0,0,0,0,0,28,0,0
77437,6442,51788,79394,4620,69919,94247,1822,20385,37608
77436,17,0,0,17,0,0,0,0,0
77435,1544,59079,78406,1062,76875,93548,482,25114,43632
77434,1602,42215,62813,1051,52672,69408,551,25337,46581
77433,27750,112167,136008,23603,120279,144027,4147,62488,84854
77432,14,0,0,0,0,0,14,0,0
77430,649,81188,96374,477,93359,114856,172,0,45119
77429,30278,109325,129665,24995,117948,137240,5283,64187,90560
77428,0,0,0,0,0,0,0,0,0
77426,916,82308,96122,730,78553,96044,186,85333,89853
77423,3631,67236,92569,2725,82029,102701,906,37103,58654
77422,4957,62966,75557,3601,70941,83397,1356,28092,49357
77420,777,44375,60060,511,62083,75429,266,20667,29031
77419,374,54516,61269,303,55547,64426,71,0,25321
77418,3797,57370,74352,2733,69441,84145,1064,31176,47297
77417,990,42656,59790,735,44338,56500,255,25781,65569
77415,0,0,0,0,0,0,0,0,0
77414,9286,48237,65278,5823,59331,76352,3463,27711,42769
77412,0,0,0,0,0,0,0,0,0
77407,17615,99499,114046,15600,105115,118055,2015,66313,78611
77406,18691,123360,131227,15966,131275,142167,2725,47276,62576
77401,7057,184332,268396,5704,223167,310938,1353,59972,87479
77396,19848,70111,93827,14511,81910,104772,5337,55861,58629
77389,12761,124315,157984,10318,134525,173744,2443,63498,87223
77388,16797,92610,108777,12346,103615,121076,4451,54486,65614
77386,18496,112537,137181,15244,121007,141927,3252,64318,108034
77385,8448,94957,116428,6185,117506,129298,2263,70926,78207
77384,8115,98542,116693,5362,122056,138924,2753,51250,73016
77382,12531,144318,204575,10694,170639,221840,1837,78088,98385
77381,13027,121069,168408,9827,150223,198312,3200,46912,71034
77380,13454,73013,120927,6938,93261,157352,6516,60250,80262
77379,27588,99614,129669,23048,110211,139901,4540,50360,65797
77378,5293,59358,73590,4069,61114,74222,1224,39122,68514
77377,12338,101901,120982,10066,106157,128403,2272,65994,82499
77376,297,26705,35439,214,26518,27602,83,0,55645
77375,19849,83050,104275,14723,96586,119691,5126,39574,52567
77374,222,0,42795,165,0,48765,57,0,0
77373,20656,73757,84757,15341,79759,91404,5315,48362,55347
77372,4504,64180,74870,3672,68429,80103,832,37833,44568
77371,2202,48712,60158,1545,62927,71281,657,20102,31638
77369,269,45219,44283,165,46844,57353,104,0,22225
77368,45,0,53309,36,0,0,9,0,0
77367,14,0,0,7,0,0,7,0,0
77365,11263,77414,107466,9094,103601,121063,2169,37015,47632
77364,1012,39461,54653,618,51923,69307,394,23542,30125
77363,1333,59792,89497,941,85781,113559,392,23173,30921
77362,1605,71774,82181,1369,75580,88221,236,0,43583
77360,2322,51909,56740,1578,58429,69158,744,22292,29557
77359,108,50486,47770,87,51215,49917,21,0,0
77358,1745,64516,86739,1171,91875,106712,574,41711,43663
77357,8798,63566,89270,7415,61929,93454,1383,33125,51036
77356,11799,96802,123165,8643,112402,146350,3156,40921,55774
77355,10138,93185,120421,8380,112670,132582,1758,41318,58699
77354,13208,91566,129256,10771,94989,143558,2437,41304,63127
77351,12128,50207,66645,8509,60633,76431,3619,29662,37969
77350,36,0,63339,20,110833,103080,16,0,0
77346,20907,107880,120081,16445,116376,129409,4462,56675,78295
77345,9440,140593,168286,7972,151533,181333,1468,51953,93650
77342,0,0,0,0,0,0,0,0,0
77340,12009,32403,44089,5501,54909,65296,6508,25050,25453
77339,16616,75388,102029,11042,96404,122139,5574,46697,60366
77338,15509,57566,64903,10615,65286,73156,4894,30479,41513
77336,4342,60802,86688,3567,72008,94686,775,31510,42164
77335,1240,47386,65730,914,60139,75868,326,25345,31051
77334,110,45352,0,64,0,0,46,0,0
77331,3178,49348,65576,2010,68728,84207,1168,32632,32883
77328,5620,48821,72534,4442,65188,80666,1178,36083,36939
77327,8900,44379,61615,6102,55349,71529,2798,19091,35926
77326,59,0,0,0,0,0,59,0,0
77320,9060,48226,67770,6442,58604,77581,2618,33622,42470
77318,7123,72014,92943,5510,90542,105015,1613,33369,47432
77316,8927,113602,141232,7584,136685,155457,1343,40594,56349
77306,4865,56881,69144,3850,65515,76110,1015,27467,38679
77304,14407,66010,96907,8695,92182,128430,5712,38267,47067
77303,7317,58417,78049,5603,67165,84761,1714,38077,49973
77302,6213,79070,101024,4952,80015,105686,1261,53843,75126
77301,10655,49842,65940,7882,56751,70717,2773,30502,42326
77201,0,0,0,0,0,0,0,0,0
77099,16151,41632,54373,11369,44468,60821,4782,28041,34548
77098,8825,98727,144360,3577,134938,204963,5248,73843,103018
77096,12797,66440,114411,8399,91801,141453,4398,43870,59452
77095,25143,84234,106478,19363,95088,113744,5780,64578,75435
77094,3991,164564,181372,3332,180788,199145,659,42366,88992
77093,13208,31321,43114,10158,34725,44139,3050,15727,27732
77092,14854,44248,62718,9788,47057,64753,5066,35408,52185
77091,10365,33497,48958,6448,36621,56079,3917,27019,32062
77090,15417,41441,68995,8395,44772,86488,7022,35409,45192
77089,17210,75622,87414,13615,80099,93095,3595,41864,53837
77088,17616,45445,59382,12897,52749,63447,4719,30064,43818
77087,11179,45763,56441,8350,51672,62141,2829,25269,34419
77086,8345,47495,57601,6373,50274,61946,1972,25348,35500
77085,5444,56715,73882,3923,58415,71446,1521,43995,75000
77084,34667,66471,82132,26294,74549,86736,8373,51738,60575
77083,22584,54360,73032,18222,59539,77936,4362,30084,46964
77082,21135,51768,74371,13369,59968,86030,7766,39990,51087
77081,18632,34817,49141,11549,31642,48974,7083,36063,45457
77080,14984,51963,72313,9808,57609,79802,5176,40136,53259
77079,12823,85803,146820,8507,129247,182297,4316,52340,73576
77078,4861,37763,50617,3318,43542,51675,1543,31025,46308
77077,28771,61550,98685,15630,80833,122175,13141,44114,68683
77076,10133,36722,45756,7591,41338,50552,2542,23522,25852
77075,13398,59249,71152,10554,64064,74354,2844,42274,52899
77074,13136,41154,54866,8921,42123,56674,4215,34605,47618
77073,13878,54631,66535,9594,59336,72673,4284,37990,47130
77072,19035,46127,58553,14985,49194,62820,4050,27411,36125
77071,10280,48020,68042,6211,61375,79999,4069,35769,47976
77070,21174,67390,93422,14687,77046,105741,6487,49075,59778
77069,8019,60239,102610,4607,79158,135078,3412,49583,55483
77068,3721,82911,100869,2772,89410,109009,949,58472,66984
77067,10140,44196,59270,7894,51022,64232,2246,26283,36019
77066,11763,65572,79152,9095,70524,84224,2668,49407,57974
77065,15777,63220,82994,9965,82358,100399,5812,43621,50103
77064,15593,72808,93459,11638,78835,99809,3955,51533,67036
77063,19782,48117,72669,9420,55355,90009,10362,41285,55476
77062,9597,97912,119795,6994,116603,135725,2603,59728,75879
77061,9024,41103,58170,5927,54631,67479,3097,24937,36051
77060,14318,31173,39289,9915,30932,38755,4403,27583,33173
77059,5868,139371,181700,4998,154194,196219,870,75851,89442
77058,8086,54866,76521,3781,76645,96297,4305,46654,56697
77057,20520,58900,102033,9316,87989,144702,11204,47457,65439
77056,11597,106974,183393,5485,156935,270290,6112,65636,104696
77055,16017,59102,118102,10593,60186,136499,5424,53997,76415
77054,14532,51833,57441,4164,62706,69993,10368,50137,51973
77053,9022,50693,64311,7074,55584,66117,1948,29886,39537
77051,6114,31942,41404,3827,36779,45220,2287,24564,32947
77050,1664,33537,45528,1419,28894,42664,245,35536,44445
77049,11143,62840,76899,8763,62745,77970,2380,56364,66798
77048,6144,45987,59204,4730,50000,60281,1414,25000,48689
77047,11370,65105,81089,7853,68634,86863,3517,51192,58591
77046,938,130092,148606,237,0,148637,701,130425,148595
77045,10091,60424,64489,7696,61415,67033,2395,36589,51122
77044,14827,81009,103280,12594,82330,107019,2233,47270,68368
77043,9422,66325,97439,6211,76488,111367,3211,48525,69502
77042,19074,48741,74292,9664,53976,93499,9410,42028,53154
77041,10870,84626,130468,8780,83964,139596,2090,69865,85826
77040,18259,60572,81348,11986,71095,89783,6273,44924,61014
77039,7995,36943,49267,6005,40066,53247,1990,23171,30380
77038,8705,42291,59165,7117,44120,62035,1588,25444,35915
77037,5221,41611,52352,4140,38208,46404,1081,26211,42045
77036,25439,35771,48890,15388,40803,54119,10051,26493,37208
77035,14159,50643,74065,8753,56775,86911,5406,36536,51808
77034,11584,54632,66626,8761,59372,71564,2823,39804,47242
77033,9116,36484,45483,6199,39514,47296,2917,28890,37995
77032,4402,33630,49906,3377,35299,51185,1025,16730,34522
77031,6119,43509,60645,4283,48476,67214,1836,31406,38797
77030,5089,86971,145401,2464,157981,225198,2625,42971,69333
77029,5695,40209,49793,3861,47666,57234,1834,22294,29213
77028,6227,27905,40111,4167,38560,46514,2060,17814,23699
77027,10699,99773,150918,4412,142760,232904,6287,75212,92946
77026,7537,29401,41861,4751,37648,45905,2786,18798,32225
77025,13741,72207,129669,6926,121725,183775,6815,50391,72777
77024,16019,122987,229420,10133,198750,306847,5886,69364,95555
77023,10119,39603,58005,6154,50838,68574,3965,26187,38170
77022,9380,36441,49291,5882,42519,52052,3498,23314,40786
77021,10506,38638,67401,5650,50585,72993,4856,24328,56506
77020,8846,36209,47676,5750,40846,50259,3096,21951,37238
77019,11510,116032,203213,5057,176439,283451,6453,85410,139474
77018,11445,92153,133497,7274,135471,168997,4171,36368,68729
77017,10232,50855,61338,7572,56807,64718,2660,28841,41032
77016,9599,36805,49399,6682,43253,55954,2917,22426,31495
77015,17789,50118,62143,13105,52294,64956,4684,33774,46434
77014,11505,50371,71837,8413,59055,83114,3092,30809,39633
77013,6169,36647,49410,4231,43057,53109,1938,26107,35336
77012,5816,37823,44709,4228,44554,49189,1588,25417,31613
77011,6225,36751,50608,4338,41285,53460,1887,30442,35493
77010,598,"250,000+",373083,268,"250,000+",470315,330,238036,294120
77009,14847,61296,111926,8807,69656,131664,6040,47485,78636
77008,17326,121408,174193,9038,191447,240222,8288,67258,99284
77007,20930,129703,170438,8482,186854,225049,12448,99039,131190
77006,13130,79808,121421,3825,146209,192466,9305,62353,90906
77005,10271,202526,293706,7134,"250,000+",362246,3137,68487,134576
77004,14577,55498,86651,5961,76710,116288,8616,45182,65225
77003,4784,80083,90445,1757,84815,102865,3027,75728,81293
77002,5341,80220,104876,850,158250,181164,4491,71316,89619
76958,59,52614,89992,55,53068,95693,4,0,0
76957,38,0,0,38,0,0,0,0,0
76955,45,75208,101533,45,75208,101533,0,0,0
76953,54,24417,35639,24,0,48971,30,0,0
76951,405,53194,76835,333,57150,85409,72,37708,37179
76950,1286,61310,69184,961,68015,77112,325,34635,44921
76949,6,0,0,0,0,0,6,0,0
76945,876,41207,62416,540,76447,87025,336,15862,22285
76943,1354,46992,54073,948,54216,61749,406,21373,36150
76941,583,53250,66432,381,74861,85317,202,27794,25385
76940,30,0,0,11,0,0,19,0,0
76939,0,0,0,0,0,0,0,0,0
76937,7,0,0,7,0,0,0,0,0
76936,1036,45250,58283,678,65948,63625,358,25465,44240
76935,603,66250,97350,478,107115,112227,125,33575,40460
76934,297,51331,53499,182,64545,68612,115,15852,28546
76933,593,53105,62178,428,55500,70156,165,33828,41129
76932,1176,60318,71525,922,61182,76199,254,0,52076
76930,30,0,48973,20,78250,71240,10,0,0
76908,0,0,0,0,0,0,0,0,0
76905,4521,66793,70342,3325,71814,79578,1196,33643,41484
76904,14479,70555,90276,8742,102593,115601,5737,41308,51292
76903,11403,40518,53924,7048,49809,61399,4355,22133,39494
76901,11096,58580,81104,7325,64970,92592,3771,35449,54096
76890,335,53984,78706,247,63250,88243,88,26597,50445
76888,80,0,34538,61,20990,28702,19,60673,53274
76887,71,78295,77962,20,0,0,51,127723,93214
76885,73,0,68610,47,83828,96951,26,0,0
76884,45,62656,81967,45,62656,81967,0,0,0
76882,108,50469,52059,77,50850,57643,31,0,38194
76878,656,56250,98984,435,54886,63325,221,44938,163990
76877,1539,39072,55462,960,52222,59718,579,26456,46616
76875,246,48821,63020,123,61563,78928,123,47869,47112
76874,14,0,0,0,0,0,14,0,0
76873,41,60486,58488,33,61042,66688,8,31250,24650
76872,359,61042,75456,248,69000,88856,111,19464,40554
76871,311,57813,81621,251,70273,94312,60,0,27858
76870,68,58750,63947,56,60000,65220,12,56500,58008
76869,24,0,35008,10,0,0,14,0,0
76866,250,79375,96586,190,87500,102509,60,78125,76677
76865,85,0,90004,80,0,94820,5,0,0
76864,292,39107,64042,197,59375,82470,95,18558,22775
76862,96,59286,66753,51,63958,79822,45,39750,51942
76861,628,61667,79843,481,76406,86286,147,30536,52027
76859,951,43068,50748,463,58988,74374,488,22375,26853
76858,131,39821,50756,85,47188,63311,46,29000,26654
76857,868,41143,79254,501,54519,114995,367,25194,30462
76856,1445,61011,79874,935,85966,104624,510,26792,34500
76854,160,27941,39323,88,0,44460,72,0,26490
76853,474,59167,68503,335,69279,81114,139,27788,37596
76852,132,53889,67458,63,72656,77148,69,0,58609
76849,1649,47305,78159,1020,63397,83209,629,27708,65622
76848,40,0,145188,34,0,0,6,0,0
76845,100,68125,101251,77,69688,120217,23,0,37761
76844,1246,50253,68614,836,61071,88407,410,20185,26639
76842,114,49167,51558,104,50000,53827,10,35625,27950
76841,18,0,0,18,0,0,0,0,0
76837,480,37981,53050,303,57750,67384,177,28036,28511
76836,1,0,0,1,0,0,0,0,0
76834,2267,45795,57989,1385,54732,74167,882,29521,32272
76832,182,40625,109169,119,91607,88057,63,16705,149046
76831,0,0,0,0,0,0,0,0,0
76828,106,62875,62055,37,93393,84181,69,0,50190
76827,289,0,43499,248,0,44470,41,37188,37627
76825,2550,49200,59331,1655,62212,68285,895,31141,40367
76824,13,0,0,0,0,0,13,0,0
76823,1168,51441,66596,878,62898,76585,290,31207,33162
76821,1864,44031,56154,1144,61518,70712,720,19569,31473
76820,53,156065,185038,44,156481,209050,9,0,0
76802,1955,68656,80079,1390,83072,93727,565,33966,44191
76801,9368,46793,65198,5914,59876,79509,3454,26859,37117
76798,0,0,0,0,0,0,0,0,0
76712,9926,80368,103178,7117,92963,116995,2809,43253,62806
76711,3653,46670,55507,2502,44811,56189,1151,43839,45649
76710,10943,44375,69262,6071,64922,91132,4872,31090,40249
76708,9641,51679,68572,6576,66637,81080,3065,25713,37269
76707,5437,27259,40775,3460,35693,47696,1977,16963,25444
76706,13488,33321,50959,6987,52243,71298,6501,15115,26055
76705,11050,43521,56740,7173,53491,64829,3877,31075,40391
76704,3186,21383,29837,1559,17105,25618,1627,22205,32944
76701,696,37171,68268,267,38359,64224,429,33958,67883
76693,707,41133,51274,458,63558,64885,249,0,23263
76692,3915,55283,75215,2609,66415,91033,1306,31296,41534
76691,2316,68112,84705,1696,85588,99864,620,25918,41376
76690,366,55000,66390,302,57500,68277,64,21500,44733
76689,1454,56058,70535,1123,64973,75993,331,20764,29441
76687,801,61085,69368,631,67026,79820,170,22986,29792
76686,90,56250,63179,49,54375,60357,41,67917,66551
76685,23,0,37961,14,0,0,9,0,0
76682,992,68289,77234,733,84943,82740,259,27176,59135
76681,272,50652,62357,201,51467,66808,71,0,47424
76680,64,0,125325,52,163068,136637,12,0,0
76679,434,67632,86094,367,79653,98349,67,21806,18964
76678,77,40927,54000,75,41008,54539,2,0,0
76676,110,40781,46625,52,66667,74950,58,0,21231
76673,482,45547,73031,363,49750,77702,119,41006,55218
76671,703,55069,83983,538,66176,93815,165,27250,51096
76670,523,48472,69921,385,59625,81710,138,25294,32778
76667,3775,42522,55565,2512,54241,65958,1263,25099,32595
76666,94,45000,58750,59,54219,63361,35,36354,50977
76665,1057,50565,69970,676,66731,87166,381,30687,35261
76664,1083,50491,68202,817,59293,77489,266,21136,31712
76661,2355,26359,35102,1132,28869,41051,1223,23656,29113
76660,186,42045,52739,149,41932,55676,37,28542,34562
76657,3784,80769,114889,3053,92047,129420,731,40230,44815
76656,825,71779,87613,619,87589,105757,206,27500,32500
76655,2938,100000,101598,2424,101640,105811,514,41917,54247
76654,56,27500,34405,21,0,64643,35,0,16263
76653,590,47059,61770,334,61667,80754,256,29500,36287
76652,464,55885,59451,386,56115,59375,78,36563,53071
76651,1481,58427,70098,1094,69779,78914,387,31350,39664
76650,57,56354,59400,47,0,58755,10,46667,39870
76649,297,43417,69530,177,77375,99702,120,19444,22801
76648,1014,48229,59359,728,61250,71394,286,14886,27623
76645,3753,52560,64694,2681,64047,72916,1072,27750,41239
76643,5167,71096,85072,3842,85515,96344,1325,45313,50863
76642,2403,46919,64089,1689,56714,77735,714,20625,31001
76641,625,49688,63630,478,53750,67441,147,0,51018
76640,1083,41295,62680,709,46726,75363,374,26389,31993
76639,649,37917,63094,355,81042,92882,294,17500,23837
76638,1134,89000,107235,912,95000,114596,222,49360,67519
76637,216,60000,62709,129,69861,74992,87,28625,42906
76636,577,82782,78834,439,86161,86646,138,32188,47648
76635,449,38533,55851,335,48646,65351,114,22500,26098
76634,2988,62450,78441,2203,71450,84644,785,39898,53722
76633,1746,102770,121854,1490,112833,135437,256,32019,42796
76632,512,45093,78117,364,46597,63752,148,25313,25978
76631,183,70125,73533,154,70500,72439,29,0,70248
76630,524,58846,61084,378,77782,73258,146,21579,25310
76629,864,42396,69136,507,71875,84092,357,9661,46255
76628,43,27917,44323,19,83125,74700,24,16500,20275
76627,493,61250,66144,389,68854,71519,104,27222,34298
76626,435,68188,85741,353,72569,95330,82,34063,39311
76624,833,77679,91260,666,97083,99043,167,0,51190
76623,83,0,130724,76,93750,141888,7,0,0
76622,504,63750,77272,389,86250,86596,115,47019,43001
76621,416,78889,92062,281,101875,116195,135,34023,41227
76599,0,0,0,0,0,0,0,0,0
76598,0,0,0,0,0,0,0,0,0
76597,0,0,0,0,0,0,0,0,0
76596,0,0,0,0,0,0,0,0,0
76579,1855,53821,64373,1426,62642,73250,429,19901,28272
76578,378,60833,76860,284,73929,87639,94,22500,33117
76577,1166,69392,85033,799,83438,99875,367,40096,43537
76574,6571,58631,72822,4465,70011,85445,2106,34700,42236
76573,10,0,0,6,0,0,4,0,0
76571,3096,88056,113159,2459,104693,128294,637,48223,51205
76570,894,38700,54611,637,50969,64495,257,22554,27116
76569,824,61300,74851,722,64643,78885,102,30227,37687
76567,3628,42353,71938,2223,63259,93002,1405,31469,37053
76566,73,106042,101063,56,93438,94957,17,0,80512
76565,51,65592,79778,38,0,99529,13,0,0
76561,382,61250,68512,268,73810,81763,114,25000,32904
76559,2170,58125,71707,1578,66827,77680,592,38118,40565
76557,2033,70260,96908,1402,81857,112759,631,36886,58411
76556,636,60342,89710,493,62209,96197,143,23750,66631
76554,835,57301,63843,555,72629,78387,280,25833,31160
76550,5248,58185,75231,3577,72319,90627,1671,27282,38940
76549,18213,54193,66814,12997,62433,73238,5216,42460,44759
76548,10945,72513,83406,7960,81346,90026,2985,46301,58941
76544,2978,44321,53696,2771,45783,55326,207,20625,29232
76543,12618,44131,51876,8270,46031,55457,4348,32033,37636
76542,18315,62083,74836,12740,71099,82548,5575,44556,51815
76541,7766,31515,43647,4164,36402,53963,3602,25231,29383
76539,3106,71738,85911,2483,80875,94871,623,37274,48913
76538,466,70313,74386,406,84286,78234,60,0,33753
76537,2030,79625,92300,1525,91277,102455,505,54911,59122
76534,1116,63145,77105,820,77639,87600,296,0,45433
76531,1537,49550,79226,1075,68116,82470,462,21548,68212
76530,616,57344,77752,386,70385,93301,230,33750,47672
76528,5708,54052,67076,3755,69230,83151,1953,29975,35007
76527,1187,65750,88574,953,75972,96260,234,40625,47692
76525,525,56914,77115,323,76250,92293,202,30395,47497
76524,1342,67788,109908,1089,83549,122737,253,25969,50494
76523,0,0,0,0,0,0,0,0,0
76522,14201,56002,68432,9928,63705,77321,4273,34005,43477
76520,2881,47991,61147,2005,53110,71061,876,29250,37529
76519,153,0,75467,119,0,81734,34,0,53529
76518,550,49211,59247,435,58177,65455,115,28173,35198
76513,14123,68099,94381,9270,85478,110904,4853,35849,59642
76511,775,42385,57792,510,62292,68833,265,28603,36543
76508,0,0,0,0,0,0,0,0,0
76504,9009,42911,50466,4821,51033,59427,4188,29090,37078
76502,15313,70762,88577,10452,84713,103806,4861,42236,53381
76501,6342,45846,58883,4485,60266,69581,1857,18018,30462
76491,211,0,72683,138,0,81953,73,0,51742
76490,49,30521,39076,27,0,63130,22,0,0
76487,779,83274,87785,513,107626,105283,266,45714,52568
76486,408,41806,62726,261,78750,80648,147,22022,30696
76484,331,66979,88440,274,67292,83796,57,0,108535
76483,447,38313,59177,250,59750,81837,197,20250,29754
76481,49,27212,31702,36,0,43150,13,0,0
76476,1064,72103,84981,800,87031,97469,264,29390,42854
76475,447,40579,49634,327,41472,54956,120,23333,33446
76474,137,0,74007,80,62500,102819,57,6425,33568
76472,615,72979,90093,379,98582,118115,236,45625,45004
76471,734,35500,60456,433,50515,68877,301,0,47158
76470,1304,32298,48975,724,49352,65876,580,17100,26181
76469,41,0,41898,26,51000,50458,15,0,27060
76466,91,0,0,53,0,0,38,0,0
76464,262,41310,51791,174,41548,55442,88,0,42895
76463,187,39375,64985,101,52750,88060,86,26786,37379
76462,1374,84470,100819,1137,96838,115728,237,24185,25064
76460,165,75324,66655,121,77361,80936,44,0,27380
76459,74,71250,78381,55,72188,82393,19,0,66768
76458,2144,50444,65731,1387,66875,81746,757,22471,36388
76457,1473,39984,63958,936,60688,83780,537,24607,26757
76455,356,55000,69985,255,64250,78491,101,34205,42867
76454,703,32031,42065,490,41413,49638,213,19327,21992
76453,595,70179,93109,482,75250,100168,113,60875,61509
76452,27,0,0,27,0,0,0,0,0
76450,5352,58427,84281,3810,74101,96920,1542,31067,50837
76449,1010,58548,95995,590,76719,109663,420,37143,75627
76448,2004,42680,71311,1305,71587,93589,699,20077,28274
76446,2755,54260,75689,1977,63782,87281,778,24419,36863
76445,164,30625,74071,92,0,111140,72,0,26704
76444,1427,47679,62829,865,61774,83387,562,19688,30584
76443,801,37552,46648,533,48988,53402,268,24808,33111
76442,3038,57384,65503,2119,66656,74463,919,30650,43225
76437,2165,58578,76397,1514,61011,80845,651,22147,44291
76436,55,91806,95402,55,91806,95402,0,0,0
76435,208,39500,57959,137,41250,60291,71,37292,53458
76433,611,75804,97882,534,88333,103704,77,48625,54300
76432,574,49625,63488,394,82500,78378,180,25789,30413
76431,1426,60449,73373,1069,67153,82623,357,31554,44822
76430,930,47436,70262,582,59500,88626,348,21486,38493
76429,129,43948,45741,23,0,56900,106,0,0
76427,365,55313,59521,275,63046,69531,90,24500,25564
76426,4203,61233,76399,2948,76216,86722,1255,39092,47201
76424,3149,45258,58095,2137,56151,69139,1012,17139,31479
76402,0,0,0,0,0,0,0,0,0
76401,10557,52961,72544,6327,78567,92453,4230,27024,41159
76389,574,90208,86382,456,100976,98531,118,23500,35978
76388,104,40938,53259,62,58750,68026,42,26667,31060
76384,4755,44719,57270,2784,55000,67825,1971,25361,36710
76380,1636,41186,57515,1058,60357,75452,578,17405,24173
76379,197,79375,79820,147,86719,89490,50,25000,44586
76377,192,36250,51551,103,48958,60778,89,23173,38187
76374,1759,39890,53873,1094,56765,65552,665,28854,28393
76373,68,54583,52713,68,54583,52713,0,0,0
76372,397,55481,68184,259,58850,82971,138,30000,38284
76371,589,58229,69483,442,70333,77012,147,28750,38439
76370,146,61667,59685,95,60938,59028,51,0,53600
76367,3638,57300,72623,2465,74931,84438,1173,48657,45790
76366,839,47574,80430,607,59188,100090,232,17330,25200
76365,1911,51451,70832,1213,77734,90938,698,24118,35315
76364,79,60250,72344,57,73750,87151,22,29375,33232
76363,125,62813,66915,105,76250,72545,20,23500,37360
76360,1563,40536,56720,858,62688,76103,705,18313,33125
76357,212,55357,76295,185,54821,80055,27,58125,50530
76354,5107,51574,65298,3712,66200,75709,1395,23449,34612
76351,803,49279,63829,403,85221,80668,400,24314,45413
76311,618,72931,77744,539,74115,80152,79,60114,57484
76310,7230,69634,82309,5169,82407,97806,2061,32284,41526
76309,5414,50272,70676,3486,68846,88666,1928,23580,36171
76308,8337,57223,77040,4856,73577,99797,3481,36745,43576
76306,5906,40892,50572,3665,51729,58743,2241,23664,35338
76305,1685,66070,74498,1243,71809,85738,442,29000,40129
76302,5264,46442,74130,3470,57288,84136,1794,33864,50635
76301,6201,28082,37708,3236,38009,46876,2965,20109,25720
76273,3610,70469,94948,2569,77801,111680,1041,33277,45942
76272,1711,81112,106237,1338,85405,117582,373,41776,62207
76271,634,85000,94545,534,90000,101917,100,43571,52262
76270,758,67917,77443,605,80038,77740,153,47321,76269
76268,81,53438,53643,48,64063,57550,33,40893,37845
76266,5458,76741,99332,4096,84858,108326,1362,50695,65995
76265,656,64713,94300,480,75441,104893,176,22656,58632
76264,600,57308,74012,371,74330,87367,229,46658,51165
76263,12,0,0,12,0,0,0,0,0
76262,14732,116663,165336,10596,138210,187570,4136,66538,106391
76261,113,67708,76238,86,68333,79603,27,0,64122
76259,1985,77847,84145,1552,81050,90840,433,51625,50240
76258,2537,66713,79272,1593,83011,100248,944,30714,42247
76255,2171,44725,59933,1568,49420,65638,603,24943,40737
76253,94,54750,81941,65,71688,103628,29,36375,33334
76252,942,90903,103127,661,112574,127244,281,35750,45865
76251,278,53750,78054,224,59167,83290,54,42500,49413
76250,359,82875,91679,233,118631,118821,126,30758,40409
76249,2835,82551,85610,2007,97472,97379,828,41958,49170
76248,13647,140982,177277,11317,160756,197058,2330,64013,77032
76247,4136,93722,111639,3320,101610,119883,816,63279,75994
76245,733,50903,62508,405,74962,89808,328,20545,27177
76244,24890,108595,122502,20077,117335,129115,4813,78610,87186
76240,11017,55975,77912,7728,72346,90816,3289,33887,43068
76239,583,60583,83374,399,69375,93878,184,39286,48466
76238,126,49167,59607,69,75625,74503,57,31914,41575
76234,6391,69514,97026,5021,79846,107363,1370,47500,52773
76233,1161,77235,93294,885,83783,103426,276,31979,45612
76230,3954,62572,76683,2763,77083,84249,1191,36161,49091
76228,463,62159,75150,355,80568,83711,108,33594,41500
76227,12223,102020,116524,9425,111637,124526,2798,57434,82646
76226,9365,151554,172943,8230,166172,182915,1135,60917,97293
76225,979,62212,81578,730,75000,94211,249,40521,39427
76210,15190,97070,112857,11688,105893,124004,3502,51500,69544
76209,9607,59617,71774,6181,73358,81905,3426,35570,50189
76208,7648,86735,112395,5863,90706,115718,1785,50398,98571
76207,5733,74518,90336,4217,83873,95677,1516,44178,66419
76205,7450,52101,73795,3993,75825,96267,3457,36431,44750
76201,10013,32704,48283,2803,65134,82783,7210,25986,33701
76182,11508,95657,120802,9071,108268,130574,2437,54107,80257
76180,15102,62595,78157,9503,78861,91625,5599,41961,50286
76179,23296,92773,103148,18511,99544,110056,4785,54195,64597
76177,3818,99018,108188,2657,114076,123144,1161,61502,68792
76164,4022,44257,50420,3068,48198,53800,954,20714,32713
76155,3239,62875,70165,1405,59298,72866,1834,61061,64594
76148,7684,75926,82787,6076,77579,85868,1608,51995,58589
76140,9603,56419,67849,6979,60137,72001,2624,42019,51122
76137,20835,77961,88529,14975,85333,95717,5860,54601,65514
76135,7748,66283,89784,5215,79724,100406,2533,47763,63647
76134,9347,54835,70007,6585,59940,76509,2762,33888,43508
76133,18593,62207,79592,12318,70523,91061,6275,37397,51284
76132,12523,55330,89915,6095,71314,121877,6428,44588,57307
76131,15265,92830,104731,12129,89851,106827,3136,87425,86520
76129,0,0,0,0,0,0,0,0,0
76127,51,88750,84231,34,70357,81238,17,0,0
76126,8455,93125,124043,6405,109547,143107,2050,48198,63438
76123,11462,84147,96270,9783,86142,99622,1679,58798,69743
76120,7362,66786,80813,4656,80000,92040,2706,42163,56925
76119,14780,39129,47642,10746,42867,51710,4034,22870,31439
76118,5480,73542,93938,4220,84899,102400,1260,50938,55171
76117,10601,47473,57950,7538,52665,62998,3063,31092,38487
76116,22025,49174,71739,10670,65896,93074,11355,33394,49376
76115,6142,39225,49002,4812,40824,51046,1330,25901,35591
76114,9281,55090,66374,5713,57805,71606,3568,38488,51859
76112,16697,46009,62639,9801,55539,73759,6896,32369,43948
76111,6966,51742,61898,4992,56054,66928,1974,32470,41202
76110,11134,56389,77577,7365,63503,89553,3769,36368,51553
76109,9288,83203,138081,5052,157368,206889,4236,41605,55064
76108,15347,70450,91645,10699,83616,106074,4648,43360,52951
76107,14592,67844,115668,6594,100089,160302,7998,47124,78142
76106,10848,44384,53002,8913,46022,53897,1935,28337,38003
76105,6637,38436,49077,4764,43338,50608,1873,17696,39507
76104,6693,35193,51706,3503,36742,54589,3190,30000,46968
76103,5268,46196,63292,3613,46716,67843,1655,28958,42796
76102,3795,73563,100760,1322,83214,137227,2473,70193,79988
76093,1153,47123,65989,824,47409,65107,329,0,65402
76092,9388,224265,295966,8463,235795,307142,925,0,183389
76088,4292,80893,96564,3426,94946,105150,866,43693,58131
76087,10259,92029,116700,8271,104343,126920,1988,50929,71712
76086,8314,57762,69934,5023,71371,83224,3291,28479,44572
76085,3322,75375,93710,2688,82448,104433,634,41069,43811
76084,2580,71375,85596,1999,74125,89297,581,49766,58243
76082,6258,73056,86359,4867,76318,92593,1391,45254,54898
76078,2773,75579,88412,2230,82639,93174,543,47337,60966
76077,163,0,69163,73,0,131277,90,0,0
76073,1945,85710,107343,1501,103750,124663,444,36528,48141
76071,1138,64583,87899,962,63143,89517,176,34615,58206
76070,424,90703,89097,267,81826,89577,157,0,0
76067,6799,55125,65670,4669,66661,74005,2130,35077,44108
76066,1281,61801,80324,1003,82383,92113,278,14146,36081
76065,12749,96778,119481,10774,107042,129140,1975,52356,56414
76064,690,59741,90246,592,63929,95378,98,58333,55758
76063,24595,99144,118295,19408,112045,128689,5187,51489,67642
76061,39,0,0,20,0,0,19,0,0
76060,3013,89097,102159,2363,100957,114808,650,31807,53410
76059,1740,42148,52882,1271,44847,59734,469,26199,32059
76058,6917,57874,72585,5318,63238,78655,1599,37356,50688
76055,1146,59444,75784,813,65847,88069,333,33811,44534
76054,4489,100271,114256,3186,107625,133073,1303,46762,67145
76053,10878,56563,72066,7271,67293,80113,3607,40485,51228
76052,7057,118864,143572,5935,133450,157127,1122,54393,64338
76051,21843,94212,119547,13880,119314,141938,7963,62125,77120
76050,2209,67271,81234,1694,75000,93183,515,26488,32768
76049,11604,86396,104093,9384,96278,114198,2220,33714,58729
76048,9933,54724,75969,6490,66965,91567,3443,28514,42051
76044,2041,75317,79146,1693,76457,83788,348,49063,53286
76043,2482,63462,85470,1963,82831,95933,519,28255,41615
76041,201,0,98213,171,134183,106950,30,0,0
76040,11799,61768,85027,7638,76413,100792,4161,40339,52711
76039,15650,69745,86923,9149,77238,98418,6501,55814,65926
76036,8872,78485,92698,7014,81808,97812,1858,52197,66572
76035,738,116250,141770,642,108750,150708,96,0,42418
76034,9215,171122,218767,8050,181534,228981,1165,86563,145757
76033,9625,56883,74206,6650,64117,86043,2975,33115,39824
76031,6115,57237,69093,4581,64649,75189,1534,28494,44757
76028,24470,81439,99055,19169,87878,107804,5301,44992,55524
76023,2325,66803,83039,1959,75257,88381,366,29464,46957
76022,5679,63782,74026,3429,80462,86534,2250,42199,52981
76021,14388,75735,92741,8995,99464,109955,5393,44891,59130
76020,10767,77359,91329,8139,88261,102150,2628,37296,51527
76018,8364,73760,83012,6880,75505,84251,1484,53226,62999
76017,16288,77109,97234,11627,93076,111701,4661,50455,56995
76016,11103,94168,112879,8836,99002,124233,2267,48997,64201
76015,6313,60986,74188,3888,71675,84213,2425,49072,55412
76014,10442,53896,61944,7540,54870,62284,2902,50299,51519
76013,13041,58887,78379,7971,77700,96337,5070,37863,48246
76012,10465,70569,92258,7129,87969,108935,3336,43143,53759
76011,9853,43350,54997,4763,46722,60651,5090,37110,46815
76010,18019,38461,49951,12488,43726,52592,5531,27040,40404
76009,6363,59103,71902,5375,59874,76135,988,26061,34808
76008,6479,137833,155934,5576,143873,165255,903,68221,77401
76006,11809,50077,72057,5387,65363,95448,6422,42416,50733
76002,9491,91413,102042,8224,91135,101320,1267,69399,78939
76001,11012,87616,105452,8885,91586,112510,2127,50752,58757
75980,949,36750,57412,710,40426,62354,239,25804,35810
75979,3727,40347,60115,2334,58750,72299,1393,21058,37975
75978,62,72500,72879,55,75486,80775,7,0,0
75977,199,28365,32706,120,52841,44423,79,16528,14906
75976,267,54125,71371,234,75625,78116,33,0,21421
75975,1454,50188,63243,1024,63559,72826,430,21731,34653
75974,1294,35978,48338,976,41199,54390,318,18077,24705
75973,1188,49097,67404,841,62188,82810,347,26250,29725
75972,2795,40222,49935,1945,44871,59945,850,18615,24175
75969,1378,71833,75191,997,78154,81123,381,0,58038
75968,868,38542,54041,595,62958,65951,273,21385,24882
75966,1647,36449,51731,1272,51125,58889,375,19792,25217
75965,7642,47083,71223,4280,75340,96916,3362,25415,37969
75964,6556,46215,61152,4959,54925,69071,1597,21206,32569
75962,0,0,0,0,0,0,0,0,0
75961,6063,36483,61113,3685,48207,80455,2378,22847,29276
75960,163,52102,56234,157,0,47375,6,0,0
75959,300,55743,71813,259,55481,76234,41,55885,43890
75956,3664,36413,49930,2387,50915,56901,1277,24330,35511
75954,1065,40566,61429,829,43688,68439,236,19438,32393
75951,6089,38975,65834,4198,44577,74986,1891,26012,44099
75949,3385,37254,53670,2513,44758,60344,872,16339,32212
75948,2717,38939,65362,1917,55027,75756,800,25049,40221
75946,1539,45313,60175,1097,62434,74416,442,17759,23724
75944,475,46458,57110,311,51635,67830,164,24167,34724
75943,462,45208,115456,330,85357,150950,132,17105,23757
75942,30,0,0,30,0,0,0,0,0
75941,2536,51618,65312,2158,55885,60470,378,25724,86301
75939,1859,46891,67074,1370,59053,75382,489,17057,35184
75938,1060,41604,55734,730,51389,69505,330,21250,24878
75937,374,39605,52992,291,50313,63838,83,12375,14964
75936,334,53750,69554,240,66167,82227,94,35000,36286
75935,4802,40806,58254,3508,52757,65828,1294,27500,30850
75934,72,83438,71543,72,83438,71543,0,0,0
75933,393,24583,42367,260,35417,53017,133,9479,20244
75932,604,49583,67731,491,58942,73377,113,0,38710
75931,868,49421,65401,613,58813,73255,255,0,46520
75930,734,29038,50061,520,41250,59362,214,20811,26898
75929,743,53472,65683,571,80397,69253,172,21905,53831
75928,479,22170,39097,390,0,42310,89,18495,25020
75926,511,55057,76380,353,56534,87051,158,0,50470
75925,1447,40776,60292,1070,49674,69186,377,19728,29054
75904,13009,51014,66747,8864,58765,78050,4145,29940,38953
75901,10262,50503,65526,7577,57748,73290,2685,26779,39866
75862,4188,41069,57955,2947,45931,65808,1241,26506,37752
75861,715,48365,58623,490,52000,63411,225,28359,40721
75860,1698,56296,71946,1179,62865,78817,519,28938,50492
75859,894,43640,68691,651,43646,76535,243,0,47556
75858,0,0,0,0,0,0,0,0,0
75856,64,0,0,64,0,0,0,0,0
75855,1208,41131,59520,906,47917,68227,302,24500,32243
75853,294,36930,55866,189,56125,73287,105,19088,24507
75852,478,50764,70288,313,65134,83451,165,37557,41133
75851,947,53480,59885,668,64009,70582,279,23650,32594
75850,474,0,73480,450,0,74071,24,0,62383
75849,17,35750,31471,17,24583,28229,0,0,0
75848,42,39167,39307,19,0,22321,23,0,30700
75847,713,39375,51833,476,51250,59387,237,22443,32349
75846,1183,39851,73343,789,47411,73335,394,33671,71511
75845,1276,52200,68894,936,65047,80705,340,23056,28578
75844,2310,41904,62676,1706,55000,73316,604,27449,27330
75840,2278,60147,83269,1592,90694,103033,686,27262,33758
75839,2161,48986,69431,1636,57820,82350,525,21544,27891
75838,243,41250,67681,213,42361,72632,30,0,32530
75835,4630,37356,59439,2925,47635,64187,1705,18226,48009
75833,1025,47933,91044,709,62569,76537,316,24286,118960
75832,0,0,0,0,0,0,0,0,0
75831,2209,42395,60021,1606,55571,66885,603,23472,41154
75803,5726,45641,61242,3929,52619,66526,1797,26448,44662
75801,6049,41335,57295,4179,50112,67066,1870,26237,33794
75792,953,47917,62473,684,52500,71067,269,22422,30630
75791,4649,68539,85505,3805,79838,90520,844,38673,52710
75790,1348,57269,82505,959,74234,96400,389,39570,45628
75789,2926,58071,71913,2193,69176,80834,733,22204,40608
75788,25,0,0,0,0,0,25,0,0
75785,3382,50899,62744,2398,56761,66960,984,40990,51493
75784,225,52250,69790,180,51667,76917,45,52554,40518
75783,3160,55377,68088,2219,59209,78516,941,27404,40224
75780,63,48839,53329,51,49375,57963,12,0,30067
75779,24,130357,103413,24,130357,103413,0,0,0
75778,1011,39856,76794,671,45515,90405,340,34286,41370
75773,4939,53709,80924,3368,67080,103200,1571,22820,30655
75771,7109,78037,92230,5561,88131,99656,1548,37089,60628
75770,1002,56667,91944,765,66917,106390,237,26083,44569
75766,9982,47010,62177,7547,52924,68623,2435,24965,37369
75765,2958,52212,81484,1938,70326,105096,1020,26519,33715
75764,80,66346,68199,70,66538,68536,10,0,24660
75763,2437,59987,68882,1862,72027,74584,575,41122,49113
75762,4975,72338,104709,3869,87758,121054,1106,45567,47232
75760,1019,65142,79621,692,73705,99923,327,0,36658
75759,32,21923,21003,26,22308,24219,6,25000,7050
75758,3446,52889,65521,2430,61512,78201,1016,23889,31491
75757,4576,71029,89823,3554,81123,102342,1022,31429,40405
75756,1564,71208,103270,1286,78214,104900,278,31250,90873
75755,1824,58088,66782,1214,67171,74485,610,27852,49833
75754,2769,81427,85762,2150,93468,92803,619,47675,54594
75752,2770,53625,65776,1990,59799,76433,780,26071,34381
75751,5840,41240,62837,4082,56130,74426,1758,19121,30927
75750,1175,64597,84667,908,79792,94897,267,49911,48068
75709,1888,62670,74487,1150,64750,80319,738,52914,64165
75708,2625,55100,66418,2131,62292,72245,494,24216,38407
75707,5118,70174,98610,3390,90927,124401,1728,29722,46334
75706,3089,62003,71832,2270,75986,80335,819,33566,42203
75705,868,45179,56745,643,63590,66995,225,0,22471
75704,3031,40583,55153,2132,53482,63947,899,24618,29882
75703,16365,64510,91177,10446,85868,112744,5919,41125,51613
75702,8027,41064,50514,5441,47806,57976,2586,22388,31380
75701,12409,51440,70474,7329,64505,89866,5080,25103,40905
75693,2249,65819,85661,1985,62902,89390,264,27794,37769
75692,1458,63500,69039,1152,68140,76992,306,25982,33303
75691,1411,80838,79418,1030,82500,85588,381,36840,55919
75686,4619,50656,64640,3162,63147,77563,1457,22563,33849
75684,2402,46107,73754,1752,58512,83670,650,21210,38292
75683,1513,42049,54169,1071,58750,67306,442,15909,19397
75682,175,79821,94272,150,102917,104556,25,0,32412
75681,1045,43906,72137,627,60104,86822,418,25882,47166
75672,5937,56497,72531,4305,68677,84513,1632,30427,38688
75670,6358,36065,55636,3773,50691,72272,2585,21349,27639
75669,337,70979,71289,319,70942,71499,18,0,0
75668,1086,48167,50532,755,53750,56586,331,20817,32983
75667,475,41654,61439,336,48750,75549,139,16850,26570
75662,8723,60318,71586,6275,67044,79952,2448,36339,45008
75661,929,53243,73118,698,54543,85412,231,0,33530
75657,3220,41115,59731,1866,50962,72448,1354,27027,42093
75656,1764,47542,53852,1426,49500,59086,338,22500,28995
75654,4550,50323,65453,3354,63740,75823,1196,25597,35537
75652,4672,56721,82473,3423,66634,94313,1249,31078,47341
75651,917,50083,71231,617,75766,91461,300,0,29470
75650,3647,68504,81510,3010,73902,88259,637,41888,46608
75647,4466,47240,72658,3015,59358,85513,1451,26947,40647
75645,3811,61625,78572,2754,80232,94108,1057,24625,35282
75644,4500,45467,64405,3187,55605,72653,1313,28695,41047
75643,857,54375,64797,544,70119,79012,313,25757,37922
75642,6,0,0,6,0,0,0,0,0
75641,63,45375,53983,40,39375,53303,23,20536,23600
75640,1818,80958,83805,1480,97746,94423,338,26570,34864
75639,1065,32101,57322,613,34757,53084,452,15708,56618
75638,2242,42609,52542,1371,58723,65622,871,23004,27571
75633,5000,51910,69344,3417,59649,76324,1583,24691,40044
75631,1050,61618,77812,808,75625,91959,242,21000,29697
75630,1015,32238,50094,628,46571,56832,387,23313,38370
75605,13500,62048,84870,8451,85985,101981,5049,32945,51196
75604,11635,52087,69751,7889,57998,79589,3746,36488,42647
75603,2330,54718,76903,1816,63527,86056,514,36844,42120
75602,6847,44230,67506,4659,53779,81353,2188,19979,35722
75601,5658,46774,70899,3534,61526,84370,2124,29180,46724
75574,620,55625,61125,411,70509,74796,209,21875,30573
75573,13,61250,64115,13,60694,49192,0,0,0
75572,1438,51136,58750,943,69904,68251,495,23378,38426
75571,1101,52798,72617,820,71429,85856,281,26662,32213
75570,3050,54229,64757,2058,68018,74344,992,24139,40987
75569,1367,38708,52690,932,42402,54480,435,27625,28793
75568,1019,40871,48495,541,52019,66107,478,21458,28561
75567,1728,54583,61507,1238,69375,69704,490,29551,35342
75566,286,48276,59595,186,56196,77723,100,0,25876
75565,125,33125,54066,93,47847,64439,32,19375,23925
75563,1877,42542,47020,1233,52664,57889,644,20179,26010
75562,66,38939,41726,33,47946,45421,33,0,0
75561,2075,48265,57736,1397,57250,67510,678,29028,34300
75560,526,42862,53963,404,44964,61539,122,20093,28875
75559,2178,46011,58340,1459,50944,61729,719,27171,48908
75558,743,67438,71843,620,67375,65382,123,0,91939
75556,459,62639,63114,356,66250,71983,103,16442,20757
75555,696,43163,66751,391,85063,90351,305,32321,35782
75554,887,52163,64791,706,63514,74264,181,25795,27437
75551,4246,54844,74747,3124,65417,84787,1122,33512,43227
75550,272,50278,55533,183,59191,68891,89,20875,28066
75503,9979,74391,103484,6937,89683,124306,3042,34276,50953
75501,13062,40333,60007,8050,55706,74098,5012,23914,35001
75497,1694,58505,74713,1223,62433,84046,471,38145,50051
75496,1137,73011,78389,897,84631,90551,240,24833,31764
75495,2737,91110,111888,2253,103815,127308,484,36915,36763
75494,3632,55646,76850,2686,65701,84456,946,35667,52324
75493,153,43750,52775,150,43971,52845,3,0,0
75492,171,54583,63057,106,71250,69467,65,0,43095
75491,1761,74073,84776,1233,89313,101747,528,32905,37559
75490,974,84512,96320,725,90562,104592,249,56875,70115
75489,397,61094,66938,288,69583,77056,109,22031,37376
75488,263,57617,61060,178,59844,73747,85,33015,34491
75487,605,54063,62464,491,54315,68471,114,24565,30948
75486,847,66375,84992,630,79531,104287,217,27361,27891
75482,9336,53287,71235,6581,68225,82493,2755,30931,41502
75481,141,54583,66043,126,63750,65787,15,0,61687
75480,821,62206,89812,527,103606,112406,294,60040,49311
75479,690,54257,65752,521,66027,74199,169,30208,37281
75478,354,45185,61795,285,45052,65430,69,38021,38648
75477,420,62763,77642,339,64671,83795,81,0,48390
75476,469,48162,72029,319,84583,93808,150,20000,23718
75475,53,34250,36540,32,33333,37359,21,38875,35290
75474,5748,53953,67883,3894,68872,80260,1854,24273,39419
75473,1300,64433,78642,1017,71487,90823,283,24844,33351
75472,1402,54342,63576,948,57292,69067,454,39167,46900
75471,545,49350,102198,483,68750,109598,62,29792,30895
75470,77,67969,57299,59,70625,62117,18,0,41506
75469,128,67917,88483,111,69375,94959,17,45625,39935
75468,393,57281,73721,369,54764,70669,24,0,0
75462,4654,53955,67775,3466,63125,80149,1188,21831,30626
75460,10067,36539,47952,5903,46656,58576,4164,20494,29371
75459,1822,68704,80019,1393,70938,83101,429,58173,66917
75457,2154,59298,85968,1624,69286,96739,530,34554,44537
75455,9384,53246,63055,6919,59797,70655,2465,30889,39240
75454,3401,108487,120768,3120,114651,123255,281,0,59937
75453,970,68333,74242,736,71852,78943,234,37500,42989
75452,1480,63125,88710,1199,79125,99404,281,25288,36539
75451,556,38621,53043,368,60714,69357,188,0,20967
75450,112,110481,94621,82,111202,109065,30,0,55143
75449,483,46118,54722,344,53594,64017,139,20875,24997
75448,258,37760,52253,224,38415,56642,34,18500,23344
75447,435,90114,105697,347,94494,125638,88,17159,27066
75446,1346,48929,63967,861,67462,77842,485,22679,39007
75442,3353,72872,86494,2387,89349,101446,966,21923,45375
75441,137,0,28625,34,50263,48191,103,0,0
75440,2580,53191,85260,1885,74432,98790,695,34975,43230
75439,431,60139,69721,323,63533,75134,108,36081,36714
75438,364,90167,86683,279,75625,89015,85,46250,56715
75437,425,67125,80053,359,77292,90389,66,16000,22712
75436,805,44514,62022,555,64950,77645,250,14365,27236
75435,499,34911,44877,308,41750,49419,191,23958,37553
75433,1185,66645,75244,880,80417,88952,305,19199,33090
75432,1220,50735,74275,791,86250,96388,429,24327,31900
75431,607,51108,55333,570,51193,55051,37,0,38392
75428,3595,40545,57483,2136,65123,73236,1459,20949,31256
75426,2072,33444,42372,1239,39491,52460,833,29290,27368
75424,1047,68795,88223,804,77857,93436,243,58438,64839
75423,1124,65700,84480,778,76500,97273,346,48125,52557
75422,1172,53000,73903,891,57188,83818,281,29750,37772
75421,215,53359,58343,178,51786,54496,37,95650,76851
75420,514,57975,64709,202,92614,98570,312,48261,41707
75418,4835,51168,78021,2974,65850,98859,1861,26662,41939
75417,957,40221,60023,682,54545,72444,275,16827,22580
75416,1096,62500,81972,807,78481,98780,289,20446,27355
75415,81,71542,120690,77,69208,126073,4,0,0
75414,1264,70421,73338,958,72163,81203,306,29844,46604
75413,108,57500,57233,80,73333,65456,28,0,33739
75412,294,56875,60897,135,88750,96113,159,27426,30997
75411,333,0,53200,205,80393,75696,128,25000,15670
75410,1881,60644,61244,1272,72295,70501,609,26757,40027
75409,5461,87589,86256,4604,88075,88244,857,61039,69229
75407,6031,69672,89382,4917,76815,94965,1114,43603,42451
75402,6424,69632,95173,4431,75625,102655,1993,43616,71171
75401,7462,43104,53742,4869,49486,62121,2593,28070,34326
75390,0,0,0,0,0,0,0,0,0
75287,28296,53575,82109,12358,70477,114140,15938,45910,56158
75270,0,0,0,0,0,0,0,0,0
75254,12011,56902,85724,5158,56217,101518,6853,54561,71488
75253,6702,43574,52830,5559,43258,52889,1143,30957,37978
75252,12413,67928,110274,6777,118253,151861,5636,47523,58942
75251,2266,75769,76387,663,86148,87113,1603,75154,71950
75249,5574,63214,76204,4468,64786,78915,1106,46042,53731
75248,16983,86326,128371,9952,114280,162757,7031,60516,77947
75247,158,18245,24963,29,18438,22362,129,18179,25548
75246,1319,43153,59118,404,52857,74868,915,35469,52164
75244,6113,97263,135026,3525,122779,169386,2588,64533,86925
75243,28350,44542,63356,15392,48733,73344,12958,34802,48652
75241,10701,35845,50476,7126,40377,58331,3575,20274,29006
75240,10283,50767,78837,5343,51270,90348,4940,42560,62929
75238,13292,67789,108747,8810,93462,135033,4482,40280,55003
75237,9197,30638,38930,4603,35723,44450,4594,21327,30424
75236,5869,45625,64725,3638,54583,72380,2231,30773,49338
75235,8583,50254,60263,4024,54884,65342,4559,42458,53798
75234,13859,72054,92950,9519,78509,99293,4340,61082,75263
75233,4908,55393,65016,3774,58545,67547,1134,35750,46118
75232,11467,43816,58181,7687,49174,62273,3780,29321,46314
75231,17849,42541,70119,8693,45929,85927,9156,38642,53654
75230,13459,95119,188452,7205,165694,277148,6254,50908,85599
75229,11095,105606,172883,8531,114356,190444,2564,67202,104428
75228,25843,46061,59484,16344,51605,64940,9499,33539,46088
75227,19059,46754,56756,14357,50205,60437,4702,30762,38704
75226,1960,53405,59144,623,58125,63556,1337,48750,54462
75225,9035,163935,289628,6548,"250,000+",356558,2487,50700,112602
75224,11879,43912,57259,8132,49815,61740,3747,30570,42449
75223,4705,57243,78258,3049,58854,88941,1656,39000,51567
75220,14495,47003,88202,9593,49616,97262,4902,37079,66747
75219,15484,75476,112212,3958,121386,163078,11526,66272,94590
75218,9826,90522,129243,6257,108098,157898,3569,62889,77551
75217,23659,41513,50238,19035,43260,51797,4624,22099,35818
75216,18827,29448,41699,11467,37790,51215,7360,15360,23706
75215,6601,31558,52954,3702,34796,61498,2899,18936,40367
75214,16061,92676,156805,8544,168036,226736,7517,59766,75718
75212,8183,40024,52406,5852,47771,57565,2331,19035,36704
75211,22763,46226,60192,17120,47036,60633,5643,35373,51192
75210,3108,26801,38886,1889,35228,44106,1219,19361,27033
75209,6807,99003,161269,3394,163304,226319,3413,57875,96347
75208,11241,66230,102480,6726,78818,115051,4515,54016,81325
75207,1979,85075,97079,217,148125,181593,1762,77321,86304
75206,21248,75569,107893,7339,115990,159423,13909,61902,79590
75205,9065,159076,279528,5662,"250,000+",365848,3403,66479,130634
75204,18839,81914,114592,5033,111595,144948,13806,75402,102829
75203,6759,37418,53455,3495,39652,54213,3264,33512,48744
75202,1736,92500,110301,512,132292,163973,1224,78077,86130
75201,11332,94872,134162,2460,140785,177755,8872,85438,120845
75189,10067,96938,104471,8347,99240,106926,1720,57755,85196
75182,1873,143295,164192,1813,136152,160023,60,0,204033
75181,7431,88990,93287,6183,95764,97871,1248,48750,57385
75180,6635,51945,65938,5274,52465,67191,1361,32804,44089
75173,1477,93854,102149,1259,103839,109045,218,43958,56200
75172,1607,55827,52204,1117,56888,56040,490,30547,35812
75169,5110,49685,68944,3456,64583,81214,1654,23679,37840
75167,3762,99868,121682,3237,110295,131712,525,43250,58387
75166,1467,101150,112036,1190,111379,123833,277,41492,55503
75165,15206,73221,89643,11494,82910,99041,3712,45317,52899
75164,310,48895,69062,187,59803,87595,123,46761,38964
75163,1178,42500,48446,739,50401,65060,439,13485,20440
75161,2448,61121,76703,1782,84773,91994,666,24102,32998
75160,7941,57740,74933,5590,62946,83755,2351,43605,50141
75159,5553,63297,78625,4508,62883,81018,1045,36250,45309
75158,1328,69853,94897,1034,77288,105857,294,29583,49248
75157,106,51250,56344,61,78938,80070,45,13750,22133
75156,6792,50767,72962,4500,62642,81826,2292,35944,48184
75155,945,52277,66151,737,63750,72109,208,27083,40961
75154,13504,81323,101622,10660,92124,112395,2844,35496,50744
75153,151,83125,72427,123,49732,66738,28,0,23743
75152,1668,71830,90843,1407,76779,91972,261,52708,78084
75150,21308,59189,69096,14808,65419,75737,6500,39381,47173
75149,18502,52304,61871,14168,57643,66325,4334,34805,41162
75148,2655,47712,62664,1836,59803,74457,819,16962,32709
75147,2396,44474,69727,1669,57930,72317,727,20145,60469
75146,7089,65513,71285,5432,69467,75103,1657,53425,53732
75144,1257,53486,68151,936,58225,77162,321,30116,38915
75143,5340,51913,71843,3761,58117,80638,1579,42581,49210
75142,6246,61629,79222,4931,70880,85608,1315,29078,42614
75141,984,34470,51522,668,41087,46634,316,24545,55159
75140,2290,43471,60990,1698,57564,73111,592,16743,21907
75137,6762,75298,88860,5110,84464,101033,1652,42304,47553
75135,2236,79426,87841,1889,86620,92849,347,39250,40652
75134,7328,52265,63379,4833,59449,70227,2495,50229,44713
75132,866,88981,96164,651,88380,96521,215,76932,82756
75127,757,50502,67621,591,51270,63101,166,28000,80105
75126,15405,92808,102473,12632,104096,110595,2773,55422,59138
75125,2387,70192,69251,2059,70815,72267,328,0,47959
75124,1806,63764,73486,1370,68411,84987,436,21750,32342
75119,9537,65304,81170,7212,83872,92562,2325,31598,42149
75117,1446,71080,104945,1160,74655,114994,286,26419,53735
75116,6811,45427,56176,4890,51564,61397,1921,34009,40278
75115,18989,71292,84375,13093,82061,94930,5896,52049,56472
75114,1877,92679,100419,1575,95770,105515,302,65758,66781
75110,10234,43736,64553,7220,54029,75621,3014,26105,36959
75109,1623,61078,80758,1236,77875,94515,387,29940,34363
75105,79,26094,33837,43,42188,44798,36,21048,20744
75104,15697,76528,92423,11268,85603,101773,4429,47028,55356
75103,5797,59129,85491,4343,65433,98364,1454,29307,44987
75102,463,51705,72668,325,66394,88376,138,35606,31863
75101,231,43990,48628,169,46750,51215,62,42500,35306
75098,18172,99224,111469,14924,106333,116819,3248,62397,71933
75094,6309,140257,152346,5704,143849,154573,605,103099,123599
75093,19566,113428,182662,13878,144473,221127,5688,68286,85971
75092,10849,56611,72340,6735,74068,86370,4114,35664,47710
75090,8421,44828,59996,5990,53444,66068,2431,24739,41516
75089,11895,107417,114203,9917,111819,120696,1978,61111,72938
75088,9308,94946,118188,7955,98795,123331,1353,69375,72390
75087,12963,105238,131585,10265,116901,146493,2698,53961,72266
75082,8670,112622,137836,6591,129307,152447,2079,78769,90293
75081,15082,82848,98954,10198,92045,108546,4884,56861,75180
75080,19538,73438,98729,12304,99471,120860,7234,44901,57309
75078,10001,155405,190429,9209,159345,196192,792,86000,111582
75077,12871,115313,139943,10007,140092,157399,2864,55755,75811
75076,3237,57476,80720,2029,72054,91936,1208,45541,59140
75075,14784,79627,105314,9603,101223,121698,5181,58726,73157
75074,18574,70345,91168,12221,74752,100963,6353,50407,65086
75071,20073,113015,132568,16644,125735,142785,3429,47230,75517
75070,37715,108939,130535,29789,122143,143662,7926,61773,77606
75069,14063,60955,97128,9122,72901,118877,4941,38876,54599
75068,21753,103863,115562,17243,111590,124598,4510,57074,69747
75067,25200,65173,80023,15100,75850,92866,10100,49417,56715
75065,4655,80020,99017,3616,84883,107957,1039,51358,63654
75063,15862,95310,117337,10450,118315,137968,5412,67981,76874
75062,16330,57320,76323,11362,61715,82003,4968,42481,57048
75061,17547,49695,63732,12310,53582,67535,5237,35131,47194
75060,14175,59539,75095,11226,61656,77580,2949,36023,52640
75058,940,105500,135675,783,115313,151054,157,42688,50939
75057,5685,63721,77098,3707,64954,79025,1978,58115,67156
75056,22310,93382,120960,15018,113292,142605,7292,61222,72921
75054,3803,136250,147473,3401,142324,154956,402,78125,68891
75052,29461,80799,91743,22737,88727,98295,6724,59185,63696
75051,13453,41455,52889,9352,49953,60841,4101,27209,31836
75050,15316,61441,74808,10429,67511,82106,4887,44732,53847
75048,8815,108258,129769,6840,112986,134151,1975,84024,110342
75044,15607,72101,96598,11563,82975,106742,4044,50406,62855
75043,21160,66461,79213,15519,79310,87838,5641,39159,49992
75042,10909,53251,67359,8232,55432,69995,2677,34076,51337
75041,9459,53446,70556,7297,52243,69545,2162,41806,66141
75040,18599,64957,79035,14198,69243,84801,4401,49114,53087
75039,10075,92120,121558,4932,110962,145749,5143,73662,96374
75038,12698,61021,82446,7561,72386,93821,5137,50945,62711
75035,25783,136579,157641,20931,153022,173296,4852,73818,84627
75034,41335,116213,153302,29523,146235,182869,11812,56173,74543
75032,11546,118593,162457,9808,130522,164980,1738,53577,140431
75028,17046,130075,146953,13901,142861,160998,3145,52329,78485
75025,18800,118725,143652,14778,136017,159513,4022,58908,81034
75024,17490,102030,135699,11348,125591,160383,6142,70218,88019
75023,18497,91916,109304,13931,102467,121635,4566,50347,65411
75022,8760,169473,189841,7595,183176,203472,1165,68052,90485
75021,3445,53967,68188,2627,60711,75062,818,23385,41018
75020,8856,53190,70275,5757,68092,82339,3099,31532,43917
75019,16190,122033,159434,12523,144926,180588,3667,64118,84997
75013,14967,140098,162876,11413,165653,180181,3554,71687,100419
75010,12411,85777,109217,7303,113899,135195,5108,61919,70024
75009,4850,108000,138052,3998,116667,149393,852,73138,81470
75007,19744,93770,109456,14643,104185,120124,5101,58125,72491
75006,19537,69501,95871,12708,76752,96820,6829,54985,90047
75002,22483,104501,131987,18848,113842,141330,3635,63465,79278
75001,8404,72050,87684,3146,82727,98836,5258,66944,79609
74966,1418,47773,62477,1017,51997,73238,401,25341,32693
74965,1842,39828,49660,1309,52875,58076,533,20880,25470
74964,971,36050,47768,671,49375,56767,300,17955,23879
74963,221,47917,65441,189,60536,72259,32,21250,24116
74962,1652,43165,60672,1183,47227,71813,469,22651,27588
74960,4573,31808,43966,3197,41505,51131,1376,17201,24602
74959,2504,43722,56237,1659,52723,60386,845,25224,44692
74957,427,40156,52671,303,56563,62297,124,23750,26613
74956,662,40726,56283,532,50500,63858,130,19333,22047
74955,5863,39750,50420,3863,50129,57249,2000,23095,34235
74954,1727,45149,56465,1263,51821,61970,464,28060,38753
74953,4296,43019,59660,3057,57352,67209,1239,23616,37255
74951,606,39712,46438,428,58611,54024,178,18667,24815
74949,98,37500,40854,47,50875,47130,51,26964,35069
74948,4467,40383,52556,3128,50288,60845,1339,20256,31953
74946,32,26667,27450,21,30938,30543,11,21250,19873
74945,124,33333,45019,94,37500,48264,30,0,34850
74944,529,27031,43463,311,49583,64141,218,25000,13367
74943,43,34792,47488,35,47917,52666,8,0,24850
74942,62,36786,41895,45,41719,52387,17,9271,14129
74941,941,54028,65631,715,63125,75203,226,21818,29415
74940,924,48000,67353,743,52679,74527,181,22554,23380
74939,229,37841,39018,149,38977,41100,80,21250,35141
74937,1959,38191,52403,1301,41960,61151,658,26870,32180
74936,465,46936,57485,329,53542,64891,136,45300,37718
74935,68,37500,47553,53,41250,49058,15,28125,37520
74932,927,38162,50870,627,46510,61148,300,23233,26901
74931,459,44732,66536,349,60170,78771,110,16250,23519
74930,845,39938,49973,555,52226,59534,290,25625,29054
74902,1596,48375,55667,1181,55761,61770,415,32083,33397
74901,712,26852,45790,421,32102,53286,291,18618,33050
74884,2251,38528,48161,1422,48200,57137,829,21458,30759
74883,843,34938,60677,504,50250,83612,339,20110,26051
74881,2022,48125,60236,1323,61086,71575,699,22134,34454
74880,704,36875,54033,494,40577,59508,210,23611,36854
74878,733,59250,64875,567,64245,71769,166,36250,40184
74875,370,48125,56962,270,53871,65446,100,24500,34054
74873,3931,53976,65613,2900,64821,75456,1031,26031,35230
74872,1225,45083,61722,845,60982,74130,380,24255,30228
74871,949,59844,75021,690,66667,83302,259,33125,50810
74869,252,51212,50616,160,56842,56923,92,45536,38739
74868,4824,38833,52886,3524,44127,59190,1300,22230,30935
74867,206,38750,51777,146,57500,61977,60,18750,26628
74865,624,54224,62412,513,60875,67135,111,27083,38029
74864,1795,45994,60903,1296,50250,67995,499,27454,38985
74860,637,47318,70785,472,54773,81424,165,28021,35563
74859,2389,39225,53112,1718,46346,60414,671,22716,31775
74857,3775,67947,87476,2573,78973,98229,1202,51166,61612
74856,303,64688,95151,244,82273,97841,59,28750,82980
74855,1704,48253,62725,1222,58909,74690,482,27143,30548
74854,638,50521,60625,452,53864,63099,186,26071,47117
74852,441,47625,61221,313,63550,72811,128,33409,32591
74851,3590,69651,80473,2740,76750,94502,850,25505,32806
74850,102,42083,51973,73,39688,50648,29,40938,46010
74849,1297,33375,46493,939,36159,49861,358,21731,27387
74848,2205,37807,57061,1447,45614,68224,758,23233,32066
74845,150,34583,49231,103,48250,56466,47,12750,28383
74844,139,66563,76523,118,78750,83769,21,25417,26995
74843,161,46750,61118,131,49375,63892,30,32500,49007
74842,45,37813,44173,31,44688,56610,14,0,0
74840,681,58304,73225,497,69271,82904,184,29583,44965
74839,244,35625,50310,185,33125,55146,59,16750,18147
74837,124,37500,42507,75,29583,43629,49,48009,38431
74836,77,0,43904,32,0,0,45,0,0
74834,3046,54714,71976,2162,67386,79319,884,30238,52029
74833,249,48438,55084,171,60179,64350,78,20000,34744
74832,267,39688,51311,169,57813,65938,98,25395,25255
74831,229,44375,62869,155,50893,78411,74,25455,28311
74830,72,42000,48325,46,56875,58687,26,18750,25169
74829,162,38333,38212,122,45667,44430,40,0,15668
74827,142,40313,52104,112,62895,60648,30,14773,18667
74826,584,84000,77876,497,100893,85136,87,21875,32129
74825,844,34833,52527,646,37500,57658,198,28438,32875
74824,460,54038,74076,379,62679,83838,81,21250,27995
74820,11616,51312,68980,7238,67254,86306,4378,26907,37896
74804,7716,50529,67780,5246,67129,82627,2470,28866,34053
74801,8391,43306,60270,5450,56702,68654,2941,25796,41056
74766,553,40362,53144,385,47171,63376,168,22115,28072
74764,1423,47679,62665,1074,68370,72492,349,23681,27970
74761,32,0,31575,22,40833,36682,10,15000,20340
74760,138,0,40302,87,59375,58876,51,0,8616
74759,558,41204,57239,370,46618,66740,188,34375,37542
74756,266,50139,77706,157,56563,82192,109,26875,70387
74755,22,34615,38573,21,0,0,1,0,0
74754,188,39318,44298,116,39138,57097,72,11750,14897
74753,0,0,0,0,0,0,0,0,0
74750,111,33631,46547,81,34438,49764,30,22500,37273
74748,177,53125,61817,138,60000,63512,39,0,54403
74747,106,16649,27154,41,26250,38129,65,16144,19323
74745,3912,32958,48127,2640,40702,54808,1272,17754,27752
74743,3404,33839,49635,2088,54104,61714,1316,22428,28715
74741,433,72188,76225,327,81750,89153,106,23750,32234
74740,867,36063,49758,597,40868,59204,270,21786,27740
74738,245,29135,46036,156,50595,58288,89,15703,23012
74736,345,36250,53549,276,40294,56751,69,26528,28190
74735,582,53125,59506,386,62206,71671,196,23056,33768
74734,458,50000,57750,317,61359,68176,141,16741,29140
74733,1428,55381,65411,1032,56871,71405,396,40667,47282
74731,556,44429,60850,375,63958,73525,181,21645,34418
74730,1990,47740,57698,1422,52500,62351,568,24239,38230
74729,1047,47344,54553,743,57250,63304,304,23462,31544
74728,4355,44331,53019,3113,56218,60144,1242,20441,31862
74727,911,38160,57553,617,47750,67404,294,23824,35148
74726,743,37240,57004,511,58098,70164,232,19333,25620
74724,94,38750,49693,70,38750,52503,24,38750,41133
74723,473,36131,54729,330,44306,64590,143,17446,28546
74722,71,0,78703,70,0,69134,1,0,0
74720,198,38500,51401,115,59375,68579,83,16563,25252
74701,9634,44728,67508,6321,57363,75959,3313,24647,44808
74653,1580,51774,61950,886,59779,71908,694,36333,46308
74652,373,57813,66953,274,61250,78626,99,29375,34345
74651,332,75714,82306,256,116250,91884,76,20625,49563
74650,219,39063,57789,137,65625,74775,82,28500,28190
74647,1217,49046,61375,806,59400,71331,411,30231,39688
74646,49,0,73386,19,117841,93863,30,0,60417
74644,205,49356,56862,96,51250,59623,109,49234,52998
74643,190,73750,86122,114,88750,105493,76,50577,56147
74641,255,51964,64314,174,56250,71745,81,33750,46031
74640,85,57917,74561,51,78750,86978,34,24000,55935
74637,653,38992,65555,432,56750,84064,221,19417,25571
74636,100,66000,75612,68,70313,74110,32,56875,60750
74633,205,87292,115820,188,88462,119164,17,0,37788
74632,226,58750,75376,155,85625,95373,71,18750,30923
74631,2877,43590,54450,1877,52770,60499,1000,33750,37856
74630,186,33056,50652,113,49250,63794,73,19076,28536
74604,4992,61273,83988,3411,77432,101143,1581,27519,43356
74601,7298,42639,57793,4464,50631,65017,2834,29167,41542
74578,2298,41222,60313,1650,48452,57659,648,22500,60993
74577,133,42917,40465,67,33438,41130,66,45769,39789
74576,147,68738,76846,113,68885,72133,34,31250,92509
74574,407,35313,51696,265,59107,64092,142,20395,25044
74572,298,38214,51904,208,43125,58529,90,19167,33630
74571,1602,38013,55329,1101,50688,65764,501,22806,31044
74570,393,60625,66586,280,73125,72902,113,16771,48996
74569,278,40870,56417,206,48750,66004,72,25000,28594
74567,83,40234,42857,54,38750,49043,29,40234,31334
74565,219,58594,67894,145,71875,81748,74,26500,34727
74563,839,39612,64023,625,51438,77004,214,17727,24316
74562,363,47188,66993,260,60556,76323,103,25750,40214
74561,767,43092,61612,523,56902,77698,244,18750,26485
74560,200,48333,54563,152,60833,62215,48,25625,29467
74558,167,36250,42702,134,41500,48915,33,15208,16252
74557,217,41042,54216,149,46250,61030,68,21875,37838
74556,150,49848,58864,95,63403,66255,55,47865,41185
74555,252,38750,53294,167,54821,67563,85,18750,24296
74554,805,40574,49821,538,48214,51641,267,30733,37665
74553,489,50446,62340,371,56776,70834,118,26250,29212
74552,448,44167,57450,316,56875,70168,132,19375,24903
74549,23,29583,53213,18,29000,54589,5,0,0
74547,1246,52558,61808,883,58563,66327,363,25417,46112
74546,266,40938,47558,185,44917,53101,81,24375,31921
74543,128,48889,69695,83,0,79954,45,49306,50771
74540,69,25250,39030,36,50833,53950,33,15625,21036
74538,1602,41477,56147,1071,53355,66590,531,19750,31835
74536,723,45515,51454,464,60000,64649,259,14570,25552
74535,57,23438,25749,40,23750,28743,17,18906,18706
74534,56,0,43145,32,81667,69891,24,0,7483
74533,360,47134,73744,293,51750,81501,67,20313,34799
74531,330,38977,68552,245,53750,82037,85,32614,29172
74530,80,42500,46934,41,55417,60373,39,26964,32805
74528,72,33750,59863,41,55625,82571,31,14453,29826
74525,3516,40735,61766,2414,49754,72420,1102,21530,33035
74523,2292,35529,48717,1489,46202,59112,803,22292,28210
74522,136,60000,60661,99,70313,69766,37,0,28873
74521,90,45833,67864,70,58333,76356,20,35833,36295
74501,11226,47146,65094,7323,60840,79657,3903,24739,34468
74477,10,0,0,0,0,0,10,0,0
74472,243,47083,58472,178,53929,66316,65,26406,30335
74471,580,45000,55260,368,52500,68354,212,17800,32532
74470,770,45385,60103,452,75065,68924,318,24286,45918
74469,728,33148,49739,497,50179,61616,231,18102,23448
74468,108,31250,43350,83,29688,44464,25,22188,28304
74467,5930,48062,63007,4023,58384,75253,1907,24897,33010
74464,11237,42112,55784,6805,56804,69833,4432,21091,32253
74463,72,27500,36385,36,28750,41061,36,24643,31708
74462,3062,41656,55762,2150,56607,64253,912,22967,31643
74460,79,33125,47092,41,45417,57529,38,25000,34658
74459,39,0,64554,23,113125,97987,16,20000,16494
74458,20,47500,48595,17,53750,55465,3,0,0
74457,149,62188,76581,102,61250,81630,47,0,65626
74456,100,38750,56898,61,0,77539,39,0,24613
74455,1162,39345,48305,870,44000,52501,292,29167,30479
74454,1389,51885,67204,843,65125,77350,546,50317,47300
74452,153,32026,55463,90,31121,47026,63,0,66987
74451,1666,48716,55255,1188,53333,65001,478,23594,29402
74450,605,45972,64868,411,66250,83368,194,22917,24415
74447,6199,36700,57882,3714,44482,63026,2485,25431,46813
74446,181,44583,50904,112,52045,60789,69,26250,31638
74445,1197,60655,66607,823,68011,73613,374,43864,49058
74442,378,44750,59848,271,61477,70572,107,21985,27922
74441,1904,40924,55268,1359,49129,64414,545,20511,26659
74438,47,51875,64394,39,36250,57872,8,68750,63500
74437,4080,40857,57039,2824,58300,67499,1256,23390,29985
74436,2023,52064,66915,1300,66848,86217,723,24062,31429
74435,1273,53932,59638,958,58958,64679,315,30469,41846
74434,3725,53233,68764,2569,69040,84200,1156,21119,28297
74432,4332,49031,57217,2956,55642,66824,1376,23993,33586
74431,298,41500,55852,207,69375,66219,91,23393,29824
74430,260,53750,63936,184,62500,69804,76,45278,45608
74429,5490,62026,73498,3836,82394,87254,1654,30000,39083
74428,488,53466,68409,315,65781,88203,173,0,32016
74427,502,55784,84668,356,60481,98511,146,37500,50912
74426,3843,35908,52892,2516,47375,60715,1327,20654,35939
74425,407,50815,53581,258,54074,53974,149,24712,51279
74423,309,50938,60831,245,60885,68148,64,19167,29953
74422,297,74464,85847,229,90417,99420,68,38750,39265
74421,1560,55819,64047,1144,66176,73374,416,25870,34147
74403,11959,45294,60025,7843,57108,71768,4116,28633,35692
74401,6648,33444,53649,4060,44942,64399,2588,23122,33344
74370,1457,39390,51475,962,47625,60540,495,22762,31217
74369,767,45170,54389,523,53542,61977,244,26369,36974
74368,31,30250,34532,26,31500,36731,5,0,0
74367,213,48906,54690,138,65769,65649,75,19271,30984
74366,558,35125,47627,364,44688,54830,194,25303,32798
74365,1640,51143,57814,1260,55306,61943,380,27321,39206
74364,748,42321,60975,583,59087,70208,165,30625,28351
74363,1024,44097,57232,700,54091,67561,324,22321,29851
74361,6767,54394,66657,4757,59976,73846,2010,28897,46511
74360,16,48333,44450,9,63750,62422,7,0,0
74359,216,28750,39882,173,34583,42144,43,15139,24965
74358,82,39375,40955,57,44688,44646,25,29375,29596
74354,6810,41890,55830,4337,52544,65839,2473,24164,35072
74352,2460,43008,62573,1671,60457,73320,789,26274,36564
74350,290,34500,41713,163,37250,46693,127,29531,30930
74349,130,28500,37762,77,35625,45923,53,18750,24294
74347,1010,31371,54981,559,61172,77633,451,15048,25924
74346,2513,38674,52238,1789,48963,61516,724,19949,26473
74344,6676,46831,65894,4274,57750,77563,2402,30482,43841
74343,1240,37308,51716,897,44375,56631,343,23945,32031
74342,992,30833,43925,707,42431,50423,285,18445,24118
74340,101,35938,51707,54,43750,73761,47,21458,25562
74339,834,33482,42689,563,37850,48081,271,21827,28074
74338,2005,49425,57203,1498,56597,63943,507,24494,33952
74337,1888,47232,58225,1271,60586,69686,617,24036,34387
74333,351,43750,58872,252,46136,53449,99,33750,66249
74332,620,50395,61668,475,53317,62627,145,30708,56428
74331,3457,46512,64723,2206,59789,79325,1251,24685,38216
74330,1208,49722,64284,961,58185,59351,247,22708,81981
74301,4317,44679,57538,2766,52256,66500,1551,29076,38113
74146,5431,37313,47798,3438,43782,54890,1993,25694,33128
74145,7894,46206,59907,4204,63581,74895,3690,27434,39737
74137,10851,90829,137047,7486,119010,170681,3365,46641,60983
74136,13547,44966,76296,6803,69583,103115,6744,32622,47816
74135,8827,54609,79492,4455,85149,106189,4372,39006,51182
74134,6375,59416,79384,4488,75042,93934,1887,35360,40690
74133,19695,66949,93163,11405,88670,116783,8290,42373,58044
74132,3691,67106,101752,2546,90541,124345,1145,42207,47947
74131,1116,54000,78383,743,77422,96065,373,26583,42066
74130,713,40694,49789,411,48625,59689,302,24539,35280
74129,6978,44826,56728,4324,52667,61849,2654,26818,45350
74128,4225,44991,53552,2715,50647,59184,1510,32191,40043
74127,6618,41433,51343,3809,48962,60140,2809,29448,37304
74126,3751,33893,46042,2540,40871,52469,1211,22776,28736
74120,2479,59505,90707,944,108889,135397,1535,42973,60482
74119,2030,41250,54616,404,90417,95186,1626,33000,44376
74117,12,0,0,12,0,0,0,0,0
74116,1369,42271,57031,818,47132,59995,551,29950,48771
74115,8323,36250,44012,5093,42100,49279,3230,26058,32201
74114,7064,76378,126130,3981,98597,158548,3083,49222,82501
74112,9103,48572,60682,4693,57469,72069,4410,38000,46077
74110,4891,32487,40851,3110,37440,45208,1781,20349,30285
74108,3011,42762,62600,2035,56440,63166,976,24228,55266
74107,7976,45067,58208,5120,53416,66439,2856,29289,39114
74106,7212,30761,41689,3823,37702,47177,3389,21980,32567
74105,12362,57072,109173,6154,91840,152376,6208,40048,64860
74104,5085,45716,66165,2205,73075,89644,2880,33627,46509
74103,367,67625,131713,84,0,299563,283,63646,81892
74085,901,30184,53066,713,31728,59367,188,16875,26645
74084,198,40147,47607,100,50833,62302,98,25833,31634
74083,406,70333,70772,281,70917,75315,125,0,56585
74082,25,61563,57488,20,65833,68505,5,0,13420
74081,705,50781,59071,505,53950,65404,200,30313,40072
74080,990,77800,80815,775,89375,90135,215,43068,41933
74079,1574,52292,72871,1068,66389,83950,506,27500,43218
74078,0,0,0,0,0,0,0,0,0
74075,11328,36461,55047,5295,56575,76586,6033,21246,34935
74074,12506,47161,69159,6105,89456,106689,6401,22750,32076
74073,2000,62875,82953,1537,75043,97128,463,26219,31974
74072,780,48438,62720,586,53625,68648,194,29583,43718
74071,81,26250,38570,47,0,44689,34,0,23988
74070,5685,56250,71564,4254,68856,81640,1431,26899,38077
74068,14,0,0,14,0,0,0,0,0
74066,12240,58744,73352,8562,74657,85904,3678,30341,40134
74063,12285,59548,74622,8954,73237,86268,3331,31435,40348
74062,345,55337,75157,244,61500,89651,101,28750,37457
74061,744,55636,72771,553,71382,86405,191,20845,22907
74060,183,40536,44331,109,47321,50188,74,24286,34095
74059,1940,50952,64296,1353,59454,75392,587,26115,38626
74058,1557,42326,66701,1011,60781,84932,546,25871,29744
74056,2210,37396,49593,1463,41776,55494,747,26645,35775
74055,17274,74930,96635,12323,93359,113549,4951,42167,51131
74054,270,46875,54398,216,57647,59762,54,28333,27852
74053,1858,80714,91564,1429,89716,99696,429,36528,54974
74052,376,31923,43895,257,36875,48096,119,24205,31267
74051,844,52426,65707,535,67083,77446,309,50087,43279
74050,147,35885,38439,100,31818,41746,47,36198,31402
74048,2415,38340,53979,1634,51053,62286,781,22055,34829
74047,2462,68646,82333,1844,79423,93074,618,32404,45160
74046,48,55625,57277,44,56250,58164,4,0,0
74045,126,61250,84359,90,103929,108970,36,20000,22833
74044,2835,56191,67935,1897,67951,76583,938,30227,47087
74042,169,32396,50188,125,38750,58366,44,20625,23645
74041,918,68478,77519,728,72895,83361,190,34762,46619
74039,1305,56964,63252,1029,61641,68129,276,29643,37878
74038,841,55329,60220,620,70093,69145,221,20972,30105
74037,6658,81865,106136,5256,100226,119024,1402,42625,52315
74036,2587,58894,71823,2029,63973,77528,558,35048,43787
74035,1447,42153,52721,944,47697,59232,503,31083,36760
74034,37,26875,46486,24,55000,63104,13,15313,15808
74033,4305,66628,86361,3338,73816,90148,967,47216,68255
74032,698,53750,59419,489,60439,67120,209,33125,39619
74030,1727,30650,47941,873,42188,61971,854,25636,30643
74029,1896,48718,66464,1017,61210,75859,879,36741,53373
74028,659,36458,52581,524,45132,58096,135,19688,27359
74027,391,44688,52593,268,45833,58317,123,31023,36388
74026,282,40833,57731,202,47917,68133,80,25500,30979
74023,4132,47654,59507,2809,56470,68936,1323,26281,37477
74022,801,40150,58388,433,61676,78379,368,24184,33883
74021,7671,75276,85307,5751,88684,97200,1920,34663,44822
74020,2889,52563,63101,2136,60946,71494,753,27543,34633
74019,7409,70836,88558,5691,83056,97185,1718,40711,54943
74017,11021,55885,68112,7573,66860,79921,3448,27448,38469
74016,2296,51607,55760,1501,55597,62272,795,36250,39919
74015,3554,56801,78498,2226,75673,93560,1328,38571,50065
74014,14978,83623,93191,11543,91241,102046,3435,50738,59387
74012,23245,69416,109309,16850,80704,127548,6395,44232,56388
74011,10813,82572,103664,8362,92676,115220,2451,46782,58776
74010,3785,44003,61733,2657,57523,74596,1128,22069,27275
74008,10826,80208,105887,7830,99072,126774,2996,33598,48699
74006,10708,65143,88908,7043,85706,107574,3665,35389,50707
74003,5496,42097,58878,3560,48870,67371,1936,28347,38362
74002,710,55341,64645,513,66875,77472,197,21417,30453
74001,153,48750,54167,117,52188,58489,36,30000,35608
73951,407,34671,52109,302,37250,57893,105,24583,33040
73950,504,63000,70721,380,67857,79267,124,22500,39148
73949,749,52173,71229,443,71250,83103,306,50674,54039
73947,236,85000,85134,188,106705,99862,48,0,25833
73946,13,30417,34046,11,31250,38782,2,0,0
73945,991,48299,60571,551,62431,76727,440,24970,39646
73944,166,45714,57620,120,70083,63700,46,36250,35370
73942,4097,51344,59054,2822,63381,66225,1275,40417,39727
73939,420,53167,70305,290,69545,86387,130,27167,33384
73938,278,58864,65135,224,58409,70003,54,57500,43674
73937,84,44000,46792,49,48472,52955,35,40893,38163
73933,618,44875,68176,385,50179,68604,233,25341,62718
73932,725,53646,62814,525,56681,68181,200,41625,44810
73931,291,38807,61458,118,72500,98017,173,24388,36523
73901,78,60577,45750,69,61442,50406,9,0,0
73860,450,53971,65171,335,66023,73891,115,22153,36127
73859,481,46131,64696,343,63359,75416,138,30208,35731
73858,683,47240,64297,389,69940,88193,294,24265,31338
73857,279,75547,86899,211,81838,93834,68,30278,65381
73855,42,0,46317,21,65536,49167,21,11458,43462
73853,148,79583,89891,130,77917,88207,18,82222,100178
73852,702,62857,79532,517,75750,91817,185,28365,43116
73851,32,0,71322,24,92500,86325,8,23750,23938
73848,670,43676,54378,508,53750,61419,162,28125,28842
73844,111,44671,71216,86,0,77708,25,0,48884
73843,296,48077,51806,189,52841,58167,107,19940,37336
73842,218,49643,67994,137,73125,79593,81,31094,44228
73841,190,51136,90119,137,66985,110074,53,32708,34306
73840,236,55500,65008,152,79643,86103,84,22105,25112
73838,157,62083,96084,128,61389,93089,29,63281,107683
73835,105,35893,57272,63,70625,81440,42,0,21024
73834,596,49022,60091,363,77582,77495,233,25208,32976
73832,428,50667,72177,252,66630,79818,176,0,61235
73801,6141,53947,69962,3943,71718,83102,2198,41527,44238
73773,810,70015,85378,453,66319,111316,357,70140,51699
73772,1366,45729,79362,923,53321,88284,443,41875,60772
73771,182,40357,48268,114,41224,59239,68,20000,29874
73768,611,52386,70713,460,63750,78887,151,23750,44023
73766,493,60298,78295,333,73897,92176,160,38704,45841
73764,122,0,48495,47,65375,70132,75,23750,32319
73763,690,50853,56437,396,54625,67588,294,41094,39086
73762,654,70833,102940,472,83182,120609,182,42500,50762
73761,127,63750,70617,104,72500,79954,23,0,28404
73760,135,67604,65918,97,72708,72835,38,0,40761
73759,625,46250,59900,347,72875,72926,278,33500,38501
73758,52,50625,59542,36,75909,71414,16,36250,32831
73757,82,130455,123956,72,131023,138739,10,16250,17520
73756,146,86071,80855,99,95469,89876,47,0,57647
73755,322,35921,65277,228,50769,80411,94,15833,28568
73754,411,57679,67518,263,77614,81412,148,31184,42194
73753,179,82250,87727,140,87222,97352,39,38438,42015
73750,2644,68182,92874,1916,73750,97927,728,49636,77393
73749,234,59500,81309,119,115625,104390,115,46058,57231
73747,126,0,76394,68,0,92376,58,0,57657
73746,14,0,28186,10,0,0,4,0,0
73744,55,0,56155,38,90000,74137,17,0,15959
73743,25,70625,72220,18,70000,78611,7,72813,55786
73742,1388,52500,75988,1002,57328,81709,386,29688,53588
73741,187,62750,62797,145,56875,62941,42,0,54057
73739,182,77000,70949,143,76250,70632,39,80750,72113
73738,393,55156,62042,220,90469,81445,173,31563,37368
73737,1478,55000,69661,1071,71250,78748,407,26806,42119
73736,263,113125,112920,214,143375,129460,49,36583,40606
73735,255,82054,93589,205,100179,108048,50,20833,31496
73734,382,45000,76080,199,85156,116786,183,23688,31782
73733,61,69750,79193,48,0,88525,13,53438,43500
73731,74,52321,63316,27,51705,55259,47,68750,67945
73730,306,41136,71721,172,72857,100891,134,23924,34280
73729,228,55435,65857,143,56685,75368,85,39375,47120
73728,785,62260,66706,520,75833,84611,265,16908,29100
73727,63,0,61757,24,128750,126408,39,0,21136
73726,179,55417,60681,123,56406,63886,56,51250,53639
73724,434,60909,74739,233,98350,100222,201,34479,45199
73722,115,88875,96637,91,93125,105622,24,0,59992
73720,62,43333,53331,22,76667,85295,40,27500,35748
73719,27,82250,80770,23,95625,83487,4,0,0
73718,195,64750,83418,142,71667,97639,53,31875,40151
73717,2380,50750,69023,1338,76090,87898,1042,30365,42431
73716,249,67813,74835,171,95739,90460,78,32321,40581
73705,0,0,0,0,0,0,0,0,0
73703,11808,63498,80539,7485,71940,95061,4323,41078,51213
73701,8975,42473,54761,5788,49366,60821,3187,29402,40178
73673,226,46000,49189,60,60714,69213,166,45545,41952
73669,599,54632,64820,416,64143,72400,183,27417,47381
73667,232,58000,66206,134,59000,70977,98,48750,50364
73666,93,70125,81337,61,70875,91052,32,44250,62819
73664,621,95433,98875,468,120221,116092,153,34688,44627
73663,467,46094,68616,346,51161,77818,121,30179,40352
73662,1712,45938,59899,1180,57321,72612,532,14851,28478
73661,170,58158,84679,124,59079,80362,46,38750,74965
73660,131,36058,46303,73,43977,63300,58,14583,22476
73659,46,66250,113241,41,0,105068,5,0,0
73658,98,55833,82263,53,69583,92700,45,34375,69971
73655,339,50733,59623,263,51991,64429,76,28500,39234
73654,355,80417,104886,259,80417,119976,96,71250,63438
73651,1570,31167,45365,1057,49005,52434,513,19596,24121
73650,300,55375,139866,230,57375,73553,70,35500,355196
73647,179,64750,71120,139,74712,81072,40,25357,35115
73646,174,67045,109441,111,82917,100026,63,0,124652
73645,542,42614,62705,363,63750,78232,179,25114,29954
73644,5424,50704,66419,3321,63089,77600,2103,26850,42000
73642,59,40625,67651,24,61250,88717,35,0,53206
73641,189,45893,49617,140,47500,52433,49,45625,41443
73639,205,43295,52100,132,53000,60414,73,30750,36477
73638,54,37083,97472,29,0,156107,25,35625,29456
73632,1207,50446,57323,706,63971,72062,501,21686,36554
73628,621,59821,77549,463,63224,84821,158,35000,42333
73627,221,35795,47943,156,35909,52605,65,29583,36752
73626,355,60066,68973,316,61711,72355,39,26875,32379
73625,231,63750,72687,137,62750,78861,94,0,59152
73624,731,47554,56093,514,48583,57720,217,37981,47032
73622,142,41250,43209,55,37434,51556,87,43036,36748
73620,452,54539,61371,312,60500,73002,140,0,32437
73601,3991,51060,73884,2643,65088,85193,1348,38913,46969
73573,1022,46534,75864,626,63485,102281,396,36111,32863
73572,1398,49381,61020,951,59306,70511,447,29350,37038
73571,32,0,112247,32,0,112247,0,0,0
73570,371,40139,52264,222,36100,52123,149,43750,49767
73569,213,39107,52274,137,45893,64032,76,23750,27516
73568,413,28750,43795,282,40938,48588,131,22083,32559
73567,291,48917,62283,213,64188,73621,78,0,18195
73566,670,34293,49924,445,42281,62346,225,15375,22173
73565,384,33750,43776,205,37188,52924,179,22969,30820
73564,196,51250,74630,125,88036,97263,71,24063,32262
73562,216,81071,101618,175,88036,108339,41,29531,66285
73560,298,50929,55018,268,51086,52303,30,33333,38530
73559,209,30139,40710,120,44375,50213,89,18872,26454
73557,184,100250,130403,131,102176,151119,53,41875,78215
73556,52,43750,49346,32,39286,47791,20,30000,45065
73555,59,0,49063,35,68542,65480,24,28125,25121
73554,1328,47039,58529,903,59361,73944,425,20350,22835
73553,14,152813,115300,13,152969,122608,1,0,0
73552,449,62639,69849,309,76328,79272,140,31250,47183
73551,23,39792,51800,14,38750,33643,9,95893,80056
73550,918,51538,64767,556,60893,75559,362,33529,46276
73549,88,80000,86568,65,96750,102165,23,40972,38865
73548,155,0,40074,76,43654,53263,79,0,27385
73547,537,46750,50703,256,65682,71077,281,33875,31911
73546,523,38973,49511,335,51210,60611,188,23657,27080
73544,113,57266,113616,103,60104,120120,10,0,46620
73543,907,67321,74748,649,84107,81674,258,0,43833
73542,1596,39551,48855,977,48073,57812,619,24921,33137
73541,1367,48233,85555,876,87551,117726,491,22924,26128
73540,113,50179,72762,87,76875,87163,26,24375,23777
73539,120,66349,70870,87,66131,64436,33,80625,79967
73538,1871,75409,88295,1467,85091,99053,404,36667,40397
73537,249,45673,56726,163,48625,65615,86,16500,32772
73533,10574,51514,65267,7111,62275,77012,3463,27476,37986
73532,205,61339,70017,130,75000,85108,75,0,43859
73531,107,89375,79192,84,96042,86124,23,33393,47252
73530,168,40625,73940,134,69167,86130,34,18929,22724
73529,1840,51744,66693,1267,62075,79482,573,23694,36656
73528,183,56806,62263,131,69063,74498,52,25833,29075
73527,1603,74023,81875,1129,80721,92051,474,47500,55576
73526,817,64728,77335,621,69088,82681,196,39792,57344
73521,7898,50460,67015,5045,64649,73365,2853,32330,52058
73520,46,48750,64350,33,65625,80697,13,16250,22854
73507,8756,51182,68439,5308,71679,81492,3448,34344,46435
73505,18319,52877,76393,11711,63367,87085,6608,41140,51077
73503,1595,50444,60321,1478,51054,61862,117,45195,40851
73501,7425,41047,52584,4345,55320,61920,3080,26591,37287
73491,276,53750,61590,214,71250,69282,62,23750,27255
73487,57,24063,32625,31,35250,35552,26,20714,27092
73481,348,41364,50804,232,61250,60030,116,23798,28247
73463,1326,55577,73954,890,58816,75947,436,39500,66211
73461,260,41042,51607,201,40179,53692,59,30179,35900
73460,1871,39004,51751,1197,50959,63094,674,26429,30684
73459,428,52143,63016,287,55938,68103,141,35781,47682
73458,382,48500,71835,254,67500,84485,128,37813,44460
73456,737,35938,48300,491,48194,58419,246,18587,26335
73455,234,48393,51308,170,55833,61298,64,16750,23269
73453,245,77292,76466,198,88929,86059,47,33295,36055
73450,561,42279,54778,388,37500,54080,173,47083,51873
73449,1281,55502,65226,1028,57197,72183,253,35115,36627
73448,1949,48640,62484,1350,58077,68765,599,26442,38641
73447,517,48185,54622,349,53807,63503,168,24407,34590
73446,3193,50691,68937,2408,51561,63176,785,31375,82586
73444,38,0,58513,22,69423,92359,16,0,0
73443,1295,52788,68242,1002,56786,72977,293,32313,41006
73442,137,60750,90102,113,65313,106584,24,13500,12496
73441,66,41500,44836,39,41250,44074,27,0,45937
73440,133,40875,53919,90,55833,69878,43,22396,20516
73439,3058,44330,57024,2084,51630,67696,974,23496,31770
73438,1516,41447,60761,854,58300,70559,662,28750,46910
73437,31,51458,62358,31,51458,62358,0,0,0
73434,198,45625,57571,161,52688,66011,37,10750,18078
73433,1040,49700,69999,720,53203,70041,320,46500,68168
73432,464,56739,61853,338,64333,70405,126,26250,35678
73430,473,72039,68847,300,77500,81808,173,36417,43072
73425,31,11484,19223,25,0,19416,6,0,0
73401,13649,52663,68493,8390,66237,82894,5259,31341,41316
73179,1910,92429,104987,1374,93653,105304,536,68611,101846
73173,1101,123104,138324,930,121741,128787,171,79803,145620
73170,14624,81808,100854,10187,98312,118024,4437,49026,57320
73169,804,67875,83787,684,70781,88311,120,52188,47265
73165,2067,108458,137680,1736,108000,141807,331,0,101195
73162,11456,80363,93675,7410,99097,111471,4046,44775,58270
73160,23131,67478,78151,16136,77578,86631,6995,46098,54412
73159,12288,51143,60494,7470,60153,68630,4818,33523,43195
73151,607,183491,232506,543,185764,241682,64,0,154655
73150,1902,74586,106067,1367,101776,119320,535,73042,69790
73149,1804,37567,46584,1147,38926,46890,657,31125,43568
73145,542,56808,70909,497,57365,75792,45,0,16971
73142,6486,82103,118354,4019,96490,143475,2467,60813,75660
73141,982,43963,55602,527,54408,65357,455,30375,42714
73139,7347,45107,55766,4249,57361,63578,3098,27450,39901
73135,8554,62500,69239,5802,69563,74745,2752,45513,54826
73134,2874,53891,69186,1130,71389,94122,1744,47664,53030
73132,10578,51398,70382,6474,68333,83561,4104,34281,46597
73131,1562,92783,135588,1023,154856,184488,539,0,42194
73130,7756,60258,73708,5418,71068,81645,2338,42925,50738
73129,6238,35135,44128,4504,37011,46805,1734,26534,29586
73128,2121,65568,79109,1217,84730,101743,904,0,35406
73127,8530,38423,51645,5311,43395,58648,3219,28834,36907
73122,5289,44571,55305,3395,54177,64009,1894,32867,37700
73121,1306,60952,75419,928,67171,86037,378,30000,47587
73120,17214,53114,81199,8064,73766,110304,9150,39162,54429
73119,10359,38724,44924,6294,41618,47764,4065,26874,36486
73118,6651,58387,90445,3018,82633,126721,3633,47277,59192
73117,2825,25661,41298,1261,34604,44716,1564,18015,35829
73116,4250,80722,168499,2319,116382,219918,1931,54688,104759
73115,8148,43380,52761,5165,52637,59421,2983,31995,37488
73114,7921,38523,51421,4033,41502,55971,3888,35537,45797
73112,14760,48258,63864,7545,55922,76966,7215,38348,48843
73111,4784,32624,44404,3114,35833,49518,1670,19099,31571
73110,14245,43645,56260,7615,52963,66531,6630,31101,40992
73109,7531,32277,43083,4420,44983,51136,3111,22348,28391
73108,4938,29742,36431,2893,32547,40181,2045,20766,29204
73107,10620,46392,58386,5249,48989,65350,5371,42274,49219
73106,4672,40278,68574,2243,69403,98855,2429,27594,37988
73105,2924,51792,64799,1381,58887,89571,1543,32422,42062
73104,1693,53358,78663,581,61042,90000,1112,50357,72443
73103,2979,51990,90409,1004,114063,146810,1975,41323,61438
73102,1134,57278,92017,289,106736,150856,845,46950,71650
73099,22668,76507,89343,16828,88377,99089,5840,48183,58069
73098,1435,53047,65075,981,62986,71151,454,38667,50683
73097,44,0,0,44,0,0,0,0,0
73096,5143,50308,70865,2987,84234,95124,2156,24282,35430
73095,830,65339,82503,632,68049,90333,198,31300,55421
73093,1165,73170,80631,848,80240,89696,317,58359,54800
73092,304,45000,56099,227,52614,60773,77,26827,36531
73090,272,83125,85076,220,83667,86538,52,61250,75688
73089,4432,87347,102740,3771,89837,110109,661,40536,55348
73086,3215,55412,67335,2140,63789,76496,1075,43438,46859
73084,2736,35811,50067,1380,55787,68755,1356,21825,29344
73082,1191,49596,67919,824,57000,81332,367,27917,33941
73080,3670,60645,74953,2630,68425,80604,1040,28958,59204
73079,172,63214,67931,130,72500,76858,42,31875,40298
73078,3843,84238,100230,3138,87271,109422,705,62830,57380
73077,2647,56135,70392,1831,71383,83386,816,25833,39155
73075,3754,44559,60197,2230,53404,72926,1524,31496,40234
73074,413,51806,61025,298,66250,70169,115,19531,30569
73073,311,60718,62977,239,61232,70710,72,24286,37308
73072,18322,67864,96555,10291,96298,130615,8031,41743,50339
73071,17544,50057,64003,10105,70355,80041,7439,32209,39596
73069,10627,47791,62904,5548,66102,81810,5079,31246,40827
73068,4197,69625,79548,3407,74432,81383,790,34444,64604
73067,855,59343,71435,698,66071,78918,157,22841,34524
73066,147,57250,53929,119,58250,55257,28,0,36404
73065,3488,82359,90566,2646,91316,102054,842,45397,54464
73064,8665,81313,93416,6524,92807,103921,2141,45515,56848
73063,290,53611,67556,212,70673,80078,78,35370,29613
73062,562,51048,61951,390,63214,77338,172,19659,25727
73061,679,84886,82985,485,90366,94160,194,42083,51327
73059,1208,60465,76278,813,77917,92957,395,24479,41071
73058,52,0,89919,32,116000,117256,20,0,46180
73057,995,51486,63784,801,52048,65349,194,23611,48160
73056,184,62813,76992,92,87500,96478,92,51406,57505
73055,3783,49944,64272,2635,62702,73337,1148,34070,38859
73054,1760,50781,79030,1144,69125,96974,616,38958,43831
73053,255,46250,64051,185,61875,76258,70,19375,30839
73052,2510,46580,64035,1676,63545,77321,834,25164,34103
73051,3016,57813,76239,2238,71250,88519,778,29097,34461
73050,15,0,46747,15,0,44613,0,0,0
73049,2042,64337,86355,1480,71576,96572,562,50213,55221
73048,1086,50000,74885,660,67727,94073,426,26971,44484
73047,1341,55664,71788,988,70132,79880,353,25536,46863
73045,4296,63480,77873,3125,69446,89133,1171,30970,43467
73044,7792,57431,79777,5254,72313,96165,2538,25352,41141
73043,78,35833,42147,48,0,46275,30,0,28913
73042,401,49917,64010,261,67656,80520,140,25500,31024
73041,150,75781,104729,114,86250,129242,36,0,26131
73040,700,48587,69514,422,48235,72123,278,0,61988
73038,793,51042,62009,541,64671,74412,252,24196,32763
73036,7033,46517,61330,4433,62748,75806,2600,25609,33647
73034,16703,98537,131229,12299,125046,155564,4404,43853,59448
73033,144,46000,66379,102,56250,77162,42,23750,35148
73032,101,50625,75626,39,62188,84305,62,0,69860
73030,1599,50452,68381,1107,64671,80492,492,37583,38928
73029,619,55469,68595,411,66971,82709,208,40851,39649
73028,1482,49007,72518,1031,57056,83575,451,37440,45942
73027,518,50417,57291,260,42500,47874,258,67705,63329
73026,3828,87721,109357,3077,98734,122218,751,39625,50416
73025,4565,151347,203871,4235,153867,214688,330,48750,61533
73024,251,49564,66622,174,58125,81963,77,29327,29896
73021,85,43681,67324,70,44306,73660,15,28750,37753
73020,8602,81975,95513,6702,95206,106346,1900,51321,54697
73019,0,0,0,0,0,0,0,0,0
73018,8028,51359,71741,5206,68091,87377,2822,25485,40469
73017,500,41923,49767,364,51000,57977,136,20000,23763
73016,682,97813,107658,576,110568,118148,106,38750,46009
73015,1106,37583,54473,729,47772,61393,377,26696,37502
73014,445,63882,90652,320,71667,104143,125,52768,50907
73013,19354,92926,133045,14036,110615,155062,5318,45614,70376
73012,14503,103259,123717,11074,117285,136152,3429,56853,81543
73011,160,29375,45851,134,28636,47765,26,0,33665
73010,6681,76730,91554,5491,85333,99624,1190,33409,50281
73009,479,51563,68170,326,64643,79158,153,24297,42482
73008,7761,51988,65143,4878,66122,77227,2883,31172,41727
73007,907,133576,167327,642,150227,176122,265,35125,145842
73006,1235,44777,51645,796,55592,59557,439,24303,32975
73005,3454,43421,54814,2331,48902,61637,1123,30425,37025
73004,330,70333,92195,250,95000,111067,80,23026,31239
73003,8690,66593,88069,6105,81243,100638,2585,43330,53219
73002,369,55536,66029,259,68319,79688,110,23750,32925
72959,1210,43271,63557,651,60469,89984,559,27865,32391
72958,2809,42417,48074,1817,50583,59303,992,19142,26591
72956,13885,50812,67513,9982,58839,72448,3903,28680,52922
72955,142,35561,50544,142,24286,44721,0,0,0
72952,946,47813,60264,525,65096,68520,421,35824,48805
72951,359,33558,44320,238,36053,49697,121,19083,33020
72950,279,54141,89809,188,53125,68043,91,0,134778
72949,3906,36028,50206,2586,54406,63802,1320,12788,22258
72948,122,0,34721,46,0,60796,76,25000,18939
72947,1553,36415,47865,1088,46696,54462,465,19650,31940
72946,1389,55679,64837,1066,63194,75317,323,0,29697
72945,168,31566,36096,54,34250,44906,114,31366,31325
72944,1028,44265,50157,761,55564,56563,267,21250,31010
72943,1022,48854,53931,669,59088,60976,353,31336,38365
72941,1928,59571,72734,1463,67004,82924,465,32178,36966
72940,787,54493,78304,593,86806,93873,194,19524,25570
72938,445,43563,71902,338,53167,88089,107,12425,16850
72937,1443,45145,60779,1016,51079,72786,427,16146,28481
72936,5632,58875,69794,4105,71627,79992,1527,32198,39690
72935,216,37143,57689,159,0,65696,57,31964,35207
72934,446,24518,34335,290,0,44530,156,0,15383
72933,1970,43646,66301,1413,54185,77974,557,22056,36024
72932,626,45364,56074,456,49853,65858,170,26786,28886
72930,77,0,37440,73,0,38582,4,0,0
72928,318,35000,50019,208,54500,64228,110,18598,21465
72927,2981,42110,53618,2098,51339,65090,883,18125,25163
72926,277,27468,41495,176,46875,54080,101,17188,17787
72923,2167,44361,64604,1217,48261,56425,950,31959,74130
72921,5091,50710,68564,3753,59929,79444,1338,28827,34958
72916,3975,74489,158011,2832,97847,203226,1143,34972,44791
72908,5855,54552,79428,3627,74918,96924,2228,30389,49313
72904,7767,34671,43635,5268,38787,48698,2499,23563,27524
72903,11296,50307,73355,6631,62288,92435,4665,33408,45428
72901,9223,37728,51744,5366,47312,59866,3857,24750,33685
72865,482,51250,59543,336,49750,63899,146,0,36788
72863,728,49231,64055,565,59464,69003,163,31932,44991
72860,81,0,56809,47,74107,62645,34,0,0
72858,1344,53125,127783,1090,46136,137761,254,0,77830
72857,717,58482,59358,486,75946,72202,231,25742,30701
72856,136,45682,45662,102,53125,54883,34,16250,17997
72855,2498,41176,55311,1635,49306,64650,863,21483,36485
72854,396,39167,41934,214,29679,36243,182,0,48167
72853,878,31806,49976,574,40391,61370,304,18250,28463
72852,71,38551,46807,71,38551,46807,0,0,0
72851,225,64442,64639,184,64577,70332,41,0,39090
72847,1094,50035,58909,751,52428,71977,343,25179,29621
72846,1463,41004,56777,1126,44594,64603,337,21825,25843
72845,345,60750,69018,268,71223,83116,77,0,19948
72843,956,48068,95570,746,53333,111467,210,18472,37994
72842,410,39676,77184,283,0,96413,127,17063,29720
72841,81,25982,35223,81,25982,35223,0,0,0
72840,764,32396,40312,500,42778,47284,264,22500,27025
72839,180,42206,56458,137,41232,54090,43,65260,53305
72838,80,33333,47460,43,0,67981,37,0,0
72837,3065,41655,65798,2012,63843,76795,1053,24701,43527
72835,323,28750,37141,231,33347,44320,92,11563,13774
72834,3690,53486,65505,2772,62045,69266,918,23905,50710
72833,1322,48500,58439,976,44333,58181,346,42667,42571
72832,358,31667,37135,226,45238,44573,132,16316,23244
72830,5886,37704,56364,3879,48823,62620,2007,22978,40618
72828,77,0,34773,39,0,0,38,0,0
72827,119,0,31630,83,0,41480,36,0,0
72826,24,0,51008,24,0,42050,0,0,0
72824,667,57098,64141,564,57411,63567,103,52995,48617
72823,2220,47058,63309,1509,58102,77877,711,25046,32085
72821,734,26149,38477,391,40938,48614,343,20647,25564
72802,8430,56105,73051,5914,67901,85365,2516,27165,42679
72801,6070,34511,52319,3432,44658,67450,2638,21528,30631
72776,294,30547,45911,130,49286,69556,164,19653,26582
72774,2318,55625,70885,1728,69861,80680,590,30438,36512
72773,547,53750,67025,428,66378,79375,119,18549,22605
72769,568,46575,63077,458,45423,60482,110,58977,69735
72768,452,51618,71062,346,46000,72175,106,31000,48988
72764,19105,50183,70848,13870,52280,80095,5235,31239,37910
72762,14885,63059,89703,11182,71698,101239,3703,37150,52000
72761,7669,57225,72002,5992,64258,78845,1677,26913,39022
72760,114,51250,63090,91,71181,71822,23,21875,28548
72758,15071,75513,115643,10921,88138,133325,4150,52341,65534
72756,16049,53368,76763,11089,66660,88430,4960,37241,47854
72753,3659,63361,72664,2920,66334,80998,739,22886,38998
72752,163,0,39469,73,0,36719,90,0,39157
72751,3503,90688,86596,3014,97862,93832,489,37153,38457
72749,71,0,66245,71,0,66245,0,0,0
72747,115,0,46868,69,0,32591,46,0,0
72745,4823,75434,84558,3625,82705,93093,1198,46056,56405
72744,1850,50463,63535,1375,55507,73838,475,19394,28615
72742,408,47073,50681,342,67581,55676,66,0,24797
72740,3095,40818,61825,2285,47188,64016,810,22500,51556
72739,210,57639,66613,140,66750,81359,70,31136,34261
72738,854,73583,87608,736,78935,94955,118,0,41781
72736,2343,62821,82353,1931,66819,90199,412,31083,41910
72734,3312,55940,68251,2583,62717,69278,729,21614,59766
72732,1783,70071,91623,1375,82386,94624,408,34375,76822
72730,3264,62989,77942,2485,76806,90452,779,30341,37613
72729,56,28000,28411,25,24583,28128,31,28625,28639
72727,2410,61107,65820,1682,71180,77148,728,30781,38472
72722,988,52500,67633,681,55815,72105,307,0,56277
72721,189,81018,83144,131,80946,70626,58,0,111419
72719,5140,85106,91370,3697,95276,101173,1443,52198,59699
72718,1359,131729,146680,1233,132271,145512,126,0,141374
72717,438,38929,50410,360,50806,54101,78,23077,33258
72715,6765,69051,115108,4795,82698,142106,1970,37849,47022
72714,5263,73098,92303,3883,86657,105357,1380,38269,54875
72712,21868,87336,123968,15140,110044,143332,6728,55056,78188
72704,11276,69778,86924,6391,91415,105678,4885,49031,60666
72703,14750,49529,84143,7124,82849,121746,7626,33129,47971
72701,16655,41851,65939,8210,66688,99859,8445,24556,32131
72687,3135,38325,46702,2201,44298,52621,934,20136,30347
72686,50,70484,55654,38,0,0,12,0,0
72685,520,38000,42020,367,47212,46248,153,0,30832
72683,123,67159,60342,115,73281,60075,8,0,0
72682,73,46298,53425,73,46298,53425,0,0,0
72680,324,36667,46585,264,42692,49858,60,24219,30433
72679,7,0,0,0,0,0,7,0,0
72677,133,40875,49597,98,39500,55663,35,18625,19394
72675,598,37708,44804,387,53472,55884,211,13750,22487
72672,85,0,32731,31,44750,52400,54,17024,21439
72670,0,0,0,0,0,0,0,0,0
72669,46,33036,36748,31,33482,34235,15,30938,41933
72668,91,77527,67798,45,63750,56002,46,0,0
72666,52,0,13142,19,0,0,33,0,0
72663,101,0,43120,59,0,54137,42,9886,12624
72662,1115,45917,57422,764,51466,63302,351,0,40863
72661,297,24902,32497,161,29375,37011,136,17500,26671
72660,327,67589,65861,275,69077,73680,52,17045,22790
72658,510,44286,49555,326,51196,51539,184,27100,37423
72655,183,36722,46310,130,0,55040,53,16250,24900
72653,12827,44832,64926,8190,54173,77051,4637,29243,41748
72651,406,60159,54662,291,47578,51986,115,0,54517
72650,1716,33788,42606,1202,44444,53529,514,11788,15340
72648,167,71743,71775,124,84286,85856,43,0,31170
72645,793,30964,47466,531,40739,45724,262,18988,50795
72644,1095,36268,46259,816,37289,51167,279,23373,31615
72642,1007,50253,68447,599,55433,80382,408,36154,50925
72641,1066,30430,47146,614,50167,61807,452,25022,27006
72640,169,66250,59920,131,85542,66992,38,0,0
72639,233,46875,58615,182,67600,60103,51,45739,46920
72638,2529,46648,49829,1674,57995,62425,855,19043,24742
72636,3,0,41600,0,0,0,3,0,41600
72635,1504,38761,48677,1081,41973,54866,423,22279,31789
72634,1749,39177,52928,1045,55083,65261,704,30132,33524
72633,726,51632,62149,542,58750,75354,184,15900,21740
72632,1878,43944,58944,1095,68875,77499,783,18832,32364
72631,2140,47200,59274,1305,61615,76126,835,24256,31267
72630,108,36167,41547,83,41250,46494,25,19750,22632
72629,208,29375,42620,118,0,57839,90,22121,22667
72628,385,42950,55794,263,51507,70411,122,13472,24284
72626,764,30547,45895,503,39063,49927,261,24511,36606
72624,145,50781,61798,117,77679,73108,28,25000,14539
72623,361,54338,78270,294,54510,81548,67,0,60006
72619,804,36563,57591,440,45000,78732,364,21935,32036
72617,67,75859,63945,65,75911,65580,2,0,0
72616,3880,53913,77331,2791,63930,94548,1089,25413,31427
72611,537,48882,92494,445,61726,106592,92,17143,22842
72601,12056,47147,61904,7884,63968,75761,4172,27456,33833
72587,8,0,0,8,0,0,0,0,0
72585,103,0,234804,85,0,280732,18,0,0
72584,140,45694,46599,91,53698,56836,49,0,0
72583,700,28036,49425,509,0,59761,191,17596,19427
72581,600,36950,43751,413,45782,49463,187,33594,31134
72579,574,51667,77718,480,68710,89082,94,16417,19691
72578,78,86182,85588,65,0,0,13,0,0
72577,293,46827,57746,156,54833,67593,137,45417,40212
72576,1553,31372,43933,817,47438,57119,736,17558,27516
72573,94,0,61759,47,107750,107909,47,13807,15611
72572,118,51542,56733,102,51667,54469,16,0,71175
72571,158,48022,48658,130,48545,52738,28,0,0
72569,233,0,49527,162,0,55189,71,0,22052
72568,458,40833,44089,346,37436,46872,112,0,32146
72567,94,27000,51468,47,39904,78055,47,19653,23730
72566,335,0,41280,189,51625,62697,146,13160,13554
72565,264,52794,53456,215,54926,57644,49,17153,32824
72564,105,0,73029,70,60000,94386,35,0,30257
72562,922,33955,64725,637,49946,81816,285,19515,23963
72561,211,48047,51624,153,60938,59964,58,23056,26528
72560,3405,34577,52151,2104,51270,69066,1301,16742,21925
72556,1331,45972,56807,749,56761,74161,582,30792,34306
72555,101,51544,43598,81,52708,49225,20,0,0
72554,1059,46422,53717,718,55000,61196,341,25795,37331
72553,15,0,40900,8,63750,54900,7,0,0
72550,290,62073,84731,192,78188,74120,98,26383,95398
72546,61,0,58672,50,58333,64170,11,0,0
72544,435,35596,41574,210,57500,57715,225,19471,24206
72543,5391,49223,66361,3417,58340,69718,1974,31430,58057
72542,1818,37277,52176,1202,46111,64234,616,22826,28111
72540,31,57917,63077,15,57917,75673,16,0,51269
72539,84,0,52986,73,0,58722,11,0,0
72538,338,37028,61319,277,0,67056,61,0,0
72537,428,43816,50225,329,44655,52384,99,0,43053
72536,151,40250,48950,119,41488,57444,32,0,17366
72534,549,39922,60003,506,55345,63765,43,0,15733
72533,141,33173,34058,88,45200,40392,53,20268,23542
72532,450,39324,42321,289,41875,49264,161,21733,28381
72531,379,41061,56893,264,40427,63200,115,0,31531
72530,660,35500,54965,403,53542,68584,257,22455,26198
72529,2186,35078,46340,1243,49085,57814,943,25378,30750
72528,32,0,0,0,0,0,32,0,0
72527,193,92635,137769,152,93423,158315,41,57135,59702
72526,59,26875,42007,30,33500,45430,29,24250,27521
72524,137,17708,20767,62,0,27955,75,9145,14825
72523,467,30703,40134,232,48827,54991,235,19857,23964
72522,172,41771,50875,80,63333,66299,92,41042,37463
72521,2153,44272,67189,1691,49358,75183,462,24531,30731
72520,218,0,14456,77,0,7478,141,21283,18267
72519,1086,36500,47374,695,46005,56889,391,32702,29247
72517,111,0,50321,56,59444,82575,55,23098,17480
72515,0,0,0,0,0,0,0,0,0
72513,1022,34464,45426,632,45150,55849,390,14861,26008
72512,1061,34821,47055,662,44896,56411,399,24267,31530
72501,9937,49739,64254,6515,59269,78648,3422,27068,35180
72482,477,27254,36785,287,36528,42217,190,14833,22328
72479,601,49243,52474,329,52083,64195,272,34286,38015
72478,84,26149,30130,35,0,39640,49,0,0
72476,2708,37184,52962,1805,55679,64458,903,18581,27139
72473,995,43688,53016,614,54130,64570,381,26780,32981
72472,3771,38532,48062,2314,50542,58902,1457,18244,28688
72471,464,45161,64968,346,57619,71034,118,24063,46075
72470,90,47500,61356,56,59167,70727,34,43500,40729
72469,410,38750,48399,262,58750,59768,148,26818,27726
72467,25,0,0,0,0,0,25,0,0
72466,515,32321,55437,354,46023,70467,161,12560,17448
72464,62,31500,34781,50,31700,37852,12,18750,21983
72462,187,32750,40980,134,45234,49372,53,12750,17353
72461,1663,42113,53444,1010,49967,66652,653,23859,33014
72460,298,21409,27729,193,22295,32126,105,20523,18574
72459,596,35278,44069,359,39693,53831,237,19681,28863
72458,216,63667,61028,184,70909,67290,32,20833,21647
72457,78,52500,81123,48,81250,117338,30,14474,22913
72456,231,33988,44695,136,41250,59632,95,19943,22957
72455,5239,45713,58289,3544,54504,68872,1695,17155,33282
72454,1998,39491,53423,1354,45682,62421,644,24048,28409
72453,86,39500,44244,52,40417,54052,34,0,29244
72450,15108,48543,61527,10914,55486,69517,4194,25268,34735
72449,94,36250,47291,62,38214,55213,32,34286,31944
72447,759,39547,53458,493,56563,63982,266,25000,28861
72445,18,51875,50650,11,51563,52773,7,0,47314
72444,650,39231,47560,463,51250,57360,187,17132,22784
72443,1249,45938,58318,958,55167,65157,291,17375,32510
72442,1566,55734,86512,1102,76848,90935,464,0,71812
72441,31,25000,14294,8,0,48588,23,25000,2361
72440,110,46500,60614,82,67500,69768,28,23000,28743
72438,988,32083,58160,621,45685,76965,367,16832,22893
72437,1472,50721,63216,1040,59565,74844,432,27788,32539
72436,322,48611,50464,251,51534,55403,71,24205,31206
72435,284,72500,66589,165,71125,75285,119,80212,54533
72434,855,44750,50334,585,52404,53009,270,23409,44407
72433,1194,31351,46167,712,45643,55481,482,21818,31322
72432,2573,46578,56110,1985,48368,62772,588,25750,29436
72431,176,50000,67961,149,0,74726,27,14297,16167
72430,181,32026,36922,126,41250,41487,55,30260,24627
72429,107,48036,49494,53,53750,56204,54,36250,42909
72428,52,0,33517,17,49063,68382,35,13958,16583
72427,83,19861,23653,60,25833,25805,23,16094,18039
72426,79,51250,63780,50,78500,79756,29,0,36234
72425,124,0,42220,112,32500,42952,12,25000,26700
72424,26,0,31062,21,0,35138,5,14375,12140
72422,1853,35963,46612,1245,45568,54834,608,14818,27359
72421,179,24969,35815,112,35000,43352,67,22837,21146
72419,688,47880,69277,440,54844,67306,248,15455,70613
72417,2113,58568,67304,1474,79500,81363,639,29221,34023
72416,1983,55825,69829,1496,68810,79606,487,35404,35983
72415,469,49647,78731,382,59737,88803,87,29063,30710
72414,137,39375,50087,76,53750,66487,61,0,24982
72413,241,61188,58547,151,60313,61698,90,66250,50566
72412,216,50673,43524,134,65833,62490,82,0,12529
72411,971,52786,57897,796,54438,62412,175,23125,33875
72410,184,32955,37455,164,32300,38301,20,30313,28520
72404,11585,59984,94546,8262,78081,112762,3323,29847,47299
72401,22747,43330,64420,13949,57351,78929,8798,28482,38636
72396,4801,46075,66086,3388,64600,78575,1413,28784,33002
72395,518,62616,64217,362,58281,67793,156,62987,54397
72394,165,33177,38166,75,60179,51552,90,0,27011
72392,232,39758,58095,157,41875,68592,75,0,32487
72390,2993,23560,37319,1891,34194,46040,1102,14600,21996
72389,152,0,73409,123,45938,60134,29,126985,129710
72386,662,51090,63892,520,58500,73624,142,15000,25779
72384,354,35568,41119,203,45462,49865,151,22063,28464
72383,54,0,0,11,0,0,43,0,0
72379,6,0,0,6,0,0,0,0,0
72377,50,12315,13708,0,0,0,50,12315,13708
72376,622,33929,79660,378,50614,78486,244,21824,34145
72374,260,73556,69128,223,74583,74322,37,0,0
72373,432,24167,34350,186,33696,44909,246,19255,25385
72372,792,28269,49530,453,56719,69130,339,16458,20412
72370,2963,36553,54449,2044,47781,58978,919,20618,32890
72368,532,57955,128944,375,73363,157278,157,0,60482
72367,8,0,0,0,0,0,8,0,0
72366,929,36635,47846,684,45769,52152,245,30583,33567
72365,1061,26382,39141,641,41875,49974,420,13942,20146
72364,5724,72791,82200,3897,82770,93474,1827,41120,54190
72360,2300,19306,38127,1341,41454,48536,959,14304,22917
72359,218,29028,28363,91,28021,25960,127,32660,30085
72358,431,23867,40016,252,24417,47133,179,0,28956
72355,950,56875,68617,586,90083,95713,364,19539,24971
72354,969,36119,59405,691,44792,71941,278,21680,27391
72353,51,0,0,51,0,0,0,0,0
72351,322,31250,44852,196,27000,45775,126,35625,39329
72350,422,29231,43556,233,34479,52318,189,23036,31812
72348,1142,41591,58010,722,70682,73289,420,19355,30974
72347,318,43036,59118,228,45556,66939,90,0,29463
72346,215,0,59083,141,0,64667,74,25714,36096
72342,2013,35113,43387,1003,48068,57698,1010,17028,27514
72341,140,43621,43303,115,44073,46803,25,14792,26224
72340,53,57125,104549,35,0,149860,18,0,0
72339,91,26440,33718,74,26722,37555,17,12917,15006
72338,6,0,0,0,0,0,6,0,0
72335,6131,37867,52213,4030,41974,55475,2101,19655,38553
72333,247,33920,44308,145,41734,63734,102,11181,12257
72332,45,16875,19138,37,17411,19319,8,0,18300
72331,1113,41577,44872,646,58333,57105,467,16797,26821
72330,183,41691,57886,142,40000,51916,41,0,76688
72329,47,0,0,47,0,0,0,0,0
72328,15,0,0,0,0,0,15,0,0
72327,604,46944,66941,372,56000,76223,232,17500,43317
72326,945,36088,44007,580,48676,56491,365,15337,24168
72325,8,0,77425,8,0,66238,0,0,0
72324,977,48859,59379,754,53578,67987,223,17159,27456
72322,60,24643,28175,35,31354,32317,25,19375,20564
72321,75,73125,79096,61,81719,86025,14,54000,48907
72320,1,0,0,0,0,0,1,0,0
72315,8840,43097,61614,5990,53333,70849,2850,26757,36494
72311,58,0,57926,51,0,63429,7,0,0
72301,9894,32620,48916,5961,41008,54845,3933,23019,37167
72227,4852,72754,115608,3019,116793,151240,1833,39375,54948
72223,10087,93380,157570,6589,139458,203902,3498,51729,69201
72212,5103,103295,136447,3510,123362,168151,1593,43655,65761
72211,10214,62940,85772,5303,81414,110244,4911,42569,58101
72210,6465,53750,75387,4178,75000,91689,2287,40192,44437
72209,11567,38614,47523,7587,44392,53650,3980,30201,32678
72207,5174,74369,119032,2614,112500,169204,2560,45561,66393
72206,8426,38919,57988,5053,58295,67211,3373,20296,38903
72205,10486,54585,77166,4635,76394,104723,5851,43901,54778
72204,12210,36121,49350,6948,47611,58069,5262,24095,34966
72202,4961,43391,67225,1667,65375,114085,3294,33688,42959
72201,853,95417,146510,228,"250,000+",286175,625,66012,95561
72181,2,0,0,0,0,0,2,0,0
72179,160,41719,51354,108,48750,58448,52,40915,34996
72176,2992,56897,73496,2306,60278,79065,686,34703,47628
72175,151,32350,40663,84,32200,51370,67,32969,26761
72173,3213,57680,69385,2491,65566,77633,722,30000,40130
72170,158,47955,54399,77,83208,84936,81,19063,22010
72169,32,0,49519,14,58750,79729,18,0,25867
72168,122,0,42520,67,0,51143,55,11950,13378
72167,675,51313,93799,477,66513,114466,198,21250,32732
72166,39,62917,74064,35,0,77671,4,0,0
72165,30,0,0,14,0,0,16,0,0
72160,3958,49437,65692,2483,61625,83785,1475,17418,32672
72157,517,55371,56082,348,59286,66330,169,28292,32486
72156,152,115673,92016,77,116298,116158,75,0,67229
72153,1265,46339,58085,957,62542,67295,308,16856,23960
72152,250,19058,37355,96,19575,50472,154,17500,28332
72150,4875,58324,78697,3415,77733,97283,1460,19518,29237
72149,0,0,0,0,0,0,0,0,0
72143,12814,43415,61017,8460,60070,74995,4354,25352,31981
72142,932,61500,81337,701,76477,94072,231,34219,35324
72141,223,34632,35459,183,36016,37820,40,0,0
72140,130,55000,76244,90,76250,91509,40,0,41315
72139,104,22500,31734,61,17375,33541,43,25096,22460
72137,822,42567,70288,571,44250,59339,251,18375,88916
72136,599,50685,59434,430,51875,68771,169,27868,35583
72135,1254,72857,146777,908,115700,180348,346,30822,57355
72134,211,82995,63409,140,84434,80685,71,0,29344
72132,1165,57182,69379,779,59327,80480,386,48393,41951
72131,1949,46771,63386,1310,60341,75283,639,33281,38619
72130,213,38466,52316,161,44306,65612,52,0,11150
72129,455,67759,67450,305,74375,81286,150,0,39175
72128,274,58571,63681,190,66750,72189,84,37941,41099
72127,806,60769,75059,536,80500,92422,270,31212,38788
72126,1245,54050,63609,1002,57700,71215,243,20536,26626
72125,307,34205,49077,228,37262,56648,79,20694,25397
72123,157,26625,33673,100,31667,37375,57,18438,25688
72122,260,0,55402,224,0,58488,36,23500,36200
72121,1328,38362,50422,1051,42695,55509,277,23640,30325
72120,13326,64695,77803,8783,79171,88868,4543,41103,52591
72119,0,0,0,0,0,0,0,0,0
72118,8716,43595,57003,5143,49955,64947,3573,31477,43830
72117,5794,33764,45847,3510,45250,54673,2284,25203,29532
72116,9460,70071,95247,5388,95205,120376,4072,44451,57371
72114,5074,23274,33547,2287,27008,34415,2787,20799,31916
72113,10975,63852,90893,6752,91972,117121,4223,38027,46914
72112,3831,36291,47918,2228,49653,59536,1603,19760,29774
72111,490,64891,74038,415,77868,82929,75,0,24845
72110,4589,40919,60496,2938,48608,64186,1651,21488,50370
72108,20,0,0,20,0,0,0,0,0
72107,135,52420,66472,78,90707,79301,57,51197,48916
72106,2049,46467,64746,1495,62731,70465,554,32500,46231
72104,8313,43610,58478,5602,56198,66720,2711,24640,39926
72103,4726,54802,67614,3360,65379,78389,1366,31217,37680
72102,1228,49420,61530,1029,49630,65912,199,23661,27026
72101,1305,52150,68547,958,66250,81356,347,19464,28732
72099,0,0,0,0,0,0,0,0,0
72088,1408,42500,53633,726,56620,66564,682,30385,39866
72087,1108,61144,89799,989,62172,96242,119,40875,35082
72086,4188,50161,75887,2749,70917,91057,1439,26961,42998
72085,88,38333,73450,65,51875,93238,23,13750,15387
72084,416,50469,60335,271,51211,65292,145,36350,48514
72083,73,31875,65253,51,0,71439,22,0,50914
72082,838,26440,36083,525,30361,41867,313,18720,25527
72081,2710,43043,65862,1912,52222,79807,798,20962,28410
72080,153,28750,51073,40,0,87380,113,28508,38220
72079,318,48718,62126,230,63281,71251,88,0,38108
72076,14801,48078,61442,9687,64164,74091,5114,29852,34127
72074,55,0,56678,39,76719,68005,16,0,29069
72073,340,62273,78985,228,72292,101899,112,23750,32340
72072,157,48125,50194,108,55833,59784,49,0,29055
72070,632,56667,65584,477,67689,60922,155,24160,37928
72069,585,53719,73322,332,104688,98389,253,36042,37375
72068,153,52019,55021,97,53750,62015,56,0,33129
72067,1204,37134,54180,682,55150,67854,522,25121,35690
72065,1711,65879,74973,1289,68924,79508,422,41484,46574
72064,1123,51373,59664,826,66429,72277,297,17390,24373
72063,889,43508,78026,685,61688,95080,204,13700,20760
72061,67,63750,64615,51,67768,76659,16,0,26225
72060,315,38315,56313,205,54375,68715,110,34444,33199
72059,22,0,0,11,0,0,11,0,0
72058,6122,63125,78304,4657,77534,91967,1465,22451,30585
72057,500,91250,101364,432,138125,114693,68,0,13368
72055,369,51437,63014,256,53750,74812,113,21382,27066
72051,208,41667,46004,152,55968,54350,56,18967,23350
72048,29,0,88283,22,143571,110159,7,0,0
72047,252,49286,57577,198,56250,62603,54,25556,39150
72046,1639,48750,62277,968,61500,82668,671,24946,32192
72045,827,44769,47469,449,51335,55732,378,0,37655
72044,416,51818,58960,314,57250,67755,102,18333,31886
72042,2265,50152,59365,1340,62645,71337,925,22215,41417
72041,652,49500,48157,320,44375,56558,332,39167,39008
72040,1123,39625,64362,668,72424,86320,455,24006,31642
72039,757,62083,95241,594,80294,114510,163,16250,25022
72038,21,0,74386,13,0,0,8,0,0
72037,6,0,56150,4,0,0,2,0,0
72036,329,17850,29377,156,54167,45324,173,15216,13937
72035,0,0,0,0,0,0,0,0,0
72034,19442,52896,77047,11513,77237,98202,7929,31751,44030
72032,12287,49051,63773,7883,65830,75295,4404,29537,41288
72031,2872,37674,51043,2042,42895,57664,830,20714,30935
72030,280,34833,42313,146,56154,60068,134,25873,22967
72029,720,28864,46831,393,44943,59816,327,14449,28673
72027,629,55625,62421,402,63125,78881,227,19920,32872
72026,138,51389,56778,106,52130,68267,32,20500,18722
72025,277,40893,45209,186,46500,55258,91,25694,24669
72024,1598,47632,67583,1266,55313,74829,332,25972,31306
72023,14076,62839,75033,10252,77227,85593,3824,35233,43219
72022,6801,73256,85965,4303,86973,106277,2498,38952,49267
72021,1688,31533,45472,898,55944,58968,790,23671,28154
72020,1348,38088,52426,886,43074,61276,462,21857,32952
72019,9926,73066,91169,7312,93359,103965,2614,42032,48749
72017,228,26000,48736,105,54250,76838,123,20179,24747
72016,1113,44127,63206,879,58625,71165,234,23178,22600
72015,11137,59302,69360,7271,71397,80403,3866,32143,45270
72014,10,0,39360,6,0,0,4,0,0
72013,893,44937,64275,711,51382,73526,182,27143,26624
72012,4411,63069,76174,3279,69598,87176,1132,23899,36325
72011,1341,62944,80443,1023,69806,95215,318,25753,26000
72010,2467,40363,53820,1544,53416,60996,923,20432,39709
72007,2888,67545,80693,2195,87454,93756,693,28245,37828
72006,1178,33289,52600,690,45208,61371,488,24872,38076
72005,42,43125,41045,31,60417,50697,11,11964,13382
72004,387,29375,38388,189,37417,46714,198,24444,30441
72003,317,49375,48755,218,58026,57964,99,16953,27435
72002,6432,69175,87454,4828,82619,100923,1604,37074,42841
72001,317,26789,43153,247,32716,50881,70,0,15701
71999,0,0,0,0,0,0,0,0,0
71998,0,0,0,0,0,0,0,0,0
71973,599,34219,52808,460,45081,62337,139,18194,18513
71972,155,56683,54697,114,60000,66611,41,0,19815
71971,246,38553,41194,132,50924,53039,114,19107,27480
71970,294,39643,75843,207,54777,93530,87,26625,33762
71969,129,36250,43867,70,44375,52729,59,35417,33354
71968,1799,73211,76311,1317,85077,81896,482,47250,59913
71965,108,26548,40423,72,34500,55192,36,25000,7450
71964,1870,42037,53961,1272,37334,56678,598,39002,40448
71962,357,29784,46149,271,44688,57077,86,8804,11638
71961,446,37197,47417,340,42902,53950,106,18529,19909
71960,695,40208,46979,478,53750,56916,217,16250,18745
71959,273,43438,65745,230,56071,71933,43,10268,14351
71958,923,36563,46213,602,50313,55307,321,21958,26655
71957,1208,47944,57727,954,57586,66282,254,18333,23772
71956,573,40184,45457,345,45625,49619,228,16587,38786
71953,5491,41037,60028,3548,48095,66888,1943,29281,45907
71952,16,0,66600,8,0,0,8,0,0
71950,291,51875,106348,219,71042,134553,72,22609,20556
71949,582,29904,38357,363,41940,50217,219,12384,18699
71945,705,21730,38110,443,31250,47779,262,18550,20787
71944,310,41000,51395,216,54250,64137,94,10769,20411
71943,1721,32073,50677,1188,41375,61434,533,24464,26664
71941,912,56438,70653,653,62614,73740,259,37891,61150
71940,716,45500,47974,522,56250,57949,194,13393,19430
71937,896,43077,69647,670,50565,83109,226,24706,27909
71935,237,34844,42803,126,37143,43094,111,32969,42473
71933,571,30677,48760,371,48125,63958,200,18654,18248
71929,1692,55283,62073,1414,68364,70203,278,16591,19190
71923,6094,38597,57082,3570,57977,73618,2524,22156,31914
71922,60,30000,34825,50,31875,37788,10,23750,0
71921,1189,51838,66835,891,62232,72548,298,24896,46353
71913,19677,48765,66801,12558,60579,78583,7119,31057,41338
71909,7904,56595,65086,5223,71329,76828,2681,33697,40744
71901,11911,46027,61904,7172,60620,78741,4739,20108,33656
71866,226,56932,67985,167,86688,80298,59,0,33132
71865,98,51500,48226,54,51500,58870,44,0,35161
71862,312,34455,40645,160,51090,48879,152,27500,26355
71861,865,45573,45350,575,56736,53746,290,19539,28102
71860,909,28307,44264,505,36555,52256,404,23421,33425
71859,268,31579,51940,211,53594,59231,57,25673,24949
71858,835,40788,47148,528,42700,49988,307,0,39994
71857,1877,38151,45466,1236,51517,52269,641,32616,31177
71855,144,50625,46628,64,56250,54866,80,0,40039
71854,13965,44473,61811,9124,57586,74003,4841,23762,36452
71853,163,17370,48402,66,59375,86344,97,15755,20181
71852,3763,41128,56664,2617,51351,66508,1146,25391,30779
71851,804,44531,55437,557,48802,60198,247,24028,44283
71847,191,31058,44568,105,62946,63100,86,16488,21151
71846,875,43170,60941,641,46458,69536,234,21125,35459
71845,806,31923,54006,481,37083,53717,325,22689,54180
71842,898,46076,85351,649,57159,105012,249,19940,33722
71841,339,50060,52706,250,54792,60181,89,0,24373
71839,143,25871,30835,82,0,36917,61,25871,22659
71838,451,31693,48395,233,51589,68676,218,25000,26719
71837,1600,47450,53906,1209,55096,63931,391,15927,21300
71836,1155,47543,61449,781,67813,73840,374,17181,34572
71835,397,52986,58753,274,65417,64584,123,34301,42237
71834,529,55305,48972,400,55759,55280,129,21438,29412
71833,870,38108,54231,459,54583,80081,411,17950,25035
71832,3584,48772,61910,2781,57138,71172,803,16209,27338
71827,345,76094,63343,254,81500,68003,91,33750,37057
71826,471,30893,46552,365,44327,54661,106,14444,18630
71825,147,58281,58789,130,60441,63758,17,20750,20794
71823,16,36250,39444,4,58750,68525,12,0,28175
71822,3619,49554,62149,2292,70208,78373,1327,25760,32852
71820,31,0,0,31,0,0,0,0,0
71801,6165,50100,63007,4487,58428,73513,1678,25349,32777
71772,0,0,0,0,0,0,0,0,0
71770,1256,34643,50340,870,46050,59943,386,0,25285
71766,221,41442,48356,169,43750,52076,52,35278,32175
71765,1069,31721,53650,558,70357,62163,511,30097,23502
71764,626,52237,51538,493,57875,57748,133,14205,26968
71763,759,43264,59250,497,69489,77631,262,19917,22950
71762,1055,47917,58365,681,60750,69921,374,16293,32026
71759,304,44313,56714,280,52619,59969,24,0,18733
71758,42,0,0,23,0,0,19,0,0
71753,5976,36435,62196,3822,46043,61769,2154,25254,59446
71752,307,27734,39116,178,35556,43590,129,23456,29864
71751,401,38622,47625,331,38714,49321,70,36842,39601
71749,1155,31673,60519,729,32477,57504,426,29434,65473
71747,393,39464,44814,253,48348,57493,140,17639,21611
71745,128,71250,62354,94,87652,71269,34,23750,30994
71744,1142,51275,61765,758,62391,80779,384,17183,23414
71743,1395,52396,53051,968,65227,64576,427,18480,24305
71742,1987,35770,44937,1279,49577,57396,708,17336,20716
71740,571,54282,83446,412,73191,108969,159,12484,16278
71730,11816,46724,67376,7659,60299,78653,4157,26487,43959
71726,557,26228,36448,276,34688,46753,281,25295,26133
71725,151,0,39768,95,33750,40556,56,0,38430
71724,193,62940,54548,119,39583,56369,74,63221,47686
71722,37,0,48414,29,0,57590,8,10000,15138
71720,999,30694,47441,628,48708,60507,371,17284,25295
71711,17,0,0,17,0,0,0,0,0
71701,7192,39580,54217,4734,54066,64433,2458,23263,32233
71677,68,30179,33866,54,30385,34815,14,0,30207
71676,197,32159,43318,141,54010,56350,56,11875,10505
71675,737,39792,58696,505,61625,72407,232,27500,28452
71674,272,32237,45682,170,43750,60541,102,15000,18864
71671,3207,41388,53678,2006,55166,64603,1201,25050,33556
71670,531,35972,63372,288,51500,88626,243,27054,33441
71667,2684,50105,64419,2059,56996,68605,625,27768,37671
71666,38,0,24166,13,65179,52646,25,0,0
71665,2093,44435,58061,1379,59523,72836,714,20423,28113
71663,234,41750,52496,140,48000,64467,94,30000,34667
71662,35,0,0,35,0,0,0,0,0
71661,112,32000,33938,76,44167,40743,36,18333,19569
71660,392,58889,59726,279,68271,70046,113,0,34246
71659,181,0,0,171,0,0,10,0,0
71658,277,35321,36490,216,37000,40446,61,18750,22484
71655,6017,43197,63231,3529,65203,74387,2488,21542,45504
71654,1888,29808,45990,1310,43202,53890,578,19063,26471
71653,1707,44955,71281,1187,58229,79399,520,17217,47710
71652,496,47500,50094,336,48833,53583,160,18375,20289
71651,46,45469,50278,10,0,0,36,0,31189
71647,836,50217,64193,517,80221,85200,319,22236,29131
71646,2390,39569,60148,1598,55259,76141,792,20172,27491
71644,226,38077,52026,127,62917,71973,99,26250,26083
71643,512,27000,39699,299,39926,52124,213,13831,19135
71642,270,0,62033,144,55625,100772,126,13654,17760
71640,1279,24028,36363,762,30625,45038,517,15587,22627
71639,2386,37419,47933,1510,46795,58904,876,23225,28220
71638,1195,33811,48833,743,41065,59577,452,21136,29040
71635,4395,49979,63069,3004,59835,75305,1391,25625,34859
71631,231,37708,48624,135,43008,62239,96,16570,29478
71630,234,29167,42587,175,37344,49255,59,24063,21369
71603,12637,43218,57845,7657,55432,73349,4980,23918,32886
71602,6044,50932,64321,4041,67944,74283,2003,26587,38832
71601,5584,29948,45683,3382,35608,43506,2202,20000,47477
71486,2196,34035,48470,1388,50258,61047,808,23061,25236
71485,894,83015,91602,687,96128,109130,207,0,27908
71483,3800,34357,56950,2243,52008,70355,1557,23485,36183
71480,335,12358,37960,116,79167,74518,219,11575,18595
71479,271,53866,81446,204,54593,92976,67,0,42781
71474,147,76250,82396,114,79000,89365,33,40750,39618
71473,158,0,49958,95,69844,65889,63,25337,25935
71472,144,0,56805,79,110369,81509,65,0,26780
71469,955,35301,47735,513,66458,69071,442,17927,22940
71468,242,24800,41643,104,53571,61103,138,0,26978
71467,2004,67917,87134,1366,78125,94045,638,0,71217
71466,270,51100,54551,210,63145,58065,60,0,0
71465,1114,38571,67765,926,50784,75513,188,17955,24462
71463,3034,41700,59871,2197,56452,71901,837,18339,23308
71462,733,38920,50052,508,50234,59312,225,19769,25944
71461,1264,40000,51922,700,52403,63720,564,24201,36139
71459,3395,46264,52955,2612,46757,54849,783,42366,46450
71457,9425,30018,51909,4856,54563,73005,4569,17924,28722
71456,522,51222,67075,387,57227,81503,135,16458,24049
71455,30,0,0,17,0,0,13,0,0
71454,901,41233,51392,510,46875,63117,391,26506,35461
71452,29,0,57503,25,0,0,4,0,0
71450,387,33295,39502,205,43164,60907,182,25000,14821
71449,3388,31786,54526,2012,56183,73542,1376,16996,26515
71447,697,35904,46390,534,35844,48751,163,38750,33175
71446,7989,49258,63109,5162,64643,75723,2827,30166,38298
71441,330,140129,101948,289,140424,112869,41,0,0
71439,755,42357,53958,368,60833,72647,387,40672,34732
71438,594,55455,65265,411,58138,69038,183,49583,54813
71435,1542,45500,60405,1077,51862,67887,465,34602,40438
71433,1530,39949,52095,1073,48165,56337,457,20089,38710
71432,343,60114,62462,251,76563,77822,92,17949,19673
71430,1380,43103,49704,1182,43578,52751,198,21442,26986
71429,1344,46333,64540,768,45000,76169,576,35625,46749
71427,170,27647,50199,127,0,59595,43,0,22428
71426,74,25000,33399,52,31250,40310,22,15000,15973
71425,13,0,0,13,0,0,0,0,0
71424,623,49843,79666,314,103782,105965,309,48690,50394
71423,1395,54375,68367,972,59250,77709,423,50203,45889
71422,630,30000,42440,446,45000,48908,184,18800,22249
71419,660,52750,56921,478,65611,64978,182,30813,32918
71418,2244,33309,61218,1596,40856,75336,648,14525,22556
71417,1880,32222,48652,1146,53750,62043,734,22995,27097
71416,637,24497,37400,349,34311,49891,288,20402,22262
71414,57,13854,25049,12,0,0,45,12813,16627
71411,1518,30844,40461,747,38633,48251,771,16875,31807
71410,31,43750,53971,28,44286,58625,3,0,0
71409,2310,46500,57239,1435,51817,64166,875,34830,44352
71407,441,0,131821,362,210337,152073,79,29596,34153
71406,35,0,0,35,0,0,0,0,0
71405,2096,60132,78881,1477,77188,95293,619,26609,37856
71404,314,54392,67966,256,63359,75745,58,22955,28000
71403,1571,66176,89375,1161,91281,110623,410,23684,23098
71401,45,90156,72829,35,0,0,10,0,0
71378,1033,26189,46631,755,33194,55391,278,14737,21345
71377,75,52284,47528,64,0,0,11,0,0
71375,433,24923,41497,196,31364,58271,237,24275,27350
71373,2215,37689,48288,1543,42958,54651,672,18309,25693
71371,716,65455,93931,590,84722,104190,126,0,28800
71369,876,21827,44528,479,36875,60524,397,19375,25188
71368,601,41375,46313,489,52804,49785,112,23846,23420
71367,595,0,60244,332,54878,67169,263,0,51501
71366,629,31222,41783,345,34609,51697,284,25849,29401
71362,696,42419,57863,419,69408,74888,277,26127,31604
71360,12683,53673,74509,9000,67842,83293,3683,29848,48183
71358,710,57713,46804,636,57940,48811,74,30714,26777
71357,752,33438,45076,477,52971,56053,275,21143,26034
71356,224,27500,33927,164,31429,41102,60,0,13690
71355,1070,38770,50363,627,53854,64451,443,18438,28132
71354,721,38906,74556,618,46250,81115,103,21917,30784
71353,735,29801,59166,555,42788,68441,180,23750,29546
71351,4590,39804,50494,2698,45746,58245,1892,21027,38011
71350,1659,26421,50065,1063,27245,52865,596,22813,44754
71346,867,47730,70796,509,94659,95614,358,23902,35237
71345,47,0,0,47,0,0,0,0,0
71343,2484,40833,56337,1781,54640,66962,703,19938,27367
71342,2548,51786,67594,1945,63646,79007,603,20639,29441
71341,1073,43750,62737,792,56250,66390,281,16875,23629
71340,367,23194,56262,270,0,69961,97,14554,18129
71339,85,0,146069,85,0,146069,0,0,0
71336,703,40666,54308,357,60483,77861,346,25417,28056
71334,3213,35358,55987,2101,46875,69739,1112,18951,27844
71333,202,0,42211,91,51250,70245,111,11625,18741
71331,489,126771,115703,307,70250,108249,182,146003,128276
71328,3026,62819,79427,2171,74222,94101,855,26555,39150
71327,1222,46786,65415,743,58505,78111,479,19018,43996
71326,339,43542,54055,210,70372,69916,129,0,24698
71325,559,24067,38505,265,46406,63260,294,13611,16101
71323,803,23170,31418,450,12016,33718,353,24056,27014
71322,2735,24607,44588,2193,26568,47590,542,20972,23589
71316,6,0,0,0,0,0,6,0,0
71303,8344,59460,85744,5210,64853,93639,3134,42293,68992
71302,5192,26879,42600,3462,38448,50465,1730,14216,23910
71301,8163,33780,62798,4648,47756,77280,3515,18495,40585
71295,4834,34565,52279,3425,45413,61887,1409,17846,27323
71292,7545,41956,63490,5211,52853,76642,2334,23845,32327
71291,12966,58561,73920,8066,76298,89115,4900,28110,44942
71286,176,50893,52616,93,51696,41975,83,0,64539
71282,3348,31654,47812,2212,39563,58414,1136,20872,26062
71280,1689,56809,70425,1310,61512,76814,379,38399,40255
71279,47,0,0,0,0,0,47,0,0
71277,607,25875,44741,249,61250,70483,358,20921,26765
71276,25,63681,67100,21,0,0,4,0,0
71275,1044,43409,57371,731,60288,70395,313,20583,25904
71272,0,0,0,0,0,0,0,0,0
71270,12138,36142,57906,6730,51573,77645,5408,22318,32067
71269,4481,41195,52960,3068,46868,59934,1413,21655,34406
71268,1017,64280,72546,754,83205,85995,263,25815,33205
71266,664,54147,62757,488,66500,69870,176,50000,42972
71264,598,74500,77641,386,99918,104095,212,28182,29444
71263,2871,42538,59788,1948,52992,74930,923,17621,26418
71261,537,25337,38521,401,26673,45402,136,17500,17802
71260,1149,33344,54539,664,41721,74966,485,14832,26280
71259,762,48500,51396,605,53646,53849,157,35625,38840
71256,297,40052,64282,203,44861,78574,94,19200,33419
71254,1455,20729,53270,818,32028,78240,637,11250,20976
71253,80,28333,33828,37,33125,42984,43,27596,25949
71251,2976,37600,54730,1958,55776,66937,1018,21515,27173
71250,110,0,17345,21,30781,46605,89,25000,10440
71247,655,32639,39029,448,50124,44319,207,23264,27050
71245,1593,23462,30318,694,0,33078,899,23958,27593
71243,95,55847,90517,84,0,86752,11,0,27318
71241,3582,52161,72711,2302,69141,92186,1280,21754,33200
71238,861,63494,94483,641,72049,117158,220,21250,28416
71237,573,32108,42454,327,31981,51547,246,35750,29760
71235,2014,50208,60779,1037,64650,83737,977,35261,36331
71234,1386,62404,76972,1071,62015,79188,315,53550,49177
71233,123,0,70210,110,0,70598,13,0,0
71232,2419,32818,48661,1551,45375,58537,868,20430,30824
71229,593,73033,78884,266,73000,107003,327,73035,56011
71227,1497,49442,72398,1005,58003,85122,492,27095,46167
71226,742,39500,54872,376,50000,63280,366,30000,46214
71225,2670,65061,97860,2216,64600,104377,454,57000,62486
71223,120,31818,37906,78,34265,43926,42,23929,26726
71222,1299,28512,48092,771,48920,65705,528,15761,22305
71220,7888,31684,46042,4828,47412,58468,3060,21017,25047
71219,459,61157,74125,357,66793,76331,102,14438,66253
71209,0,0,0,0,0,0,0,0,0
71203,14785,47668,62896,8747,53903,77685,6038,34847,39689
71202,8090,23370,32392,4783,24826,34749,3307,19491,28083
71201,8827,46745,79201,4484,75357,115736,4343,25205,40462
71129,5016,40012,61255,3127,56331,71979,1889,25339,42154
71119,4829,38573,65020,2626,59154,92611,2203,23917,31917
71118,9030,44799,56081,5642,59094,64896,3388,24770,39143
71115,7057,50632,79584,3091,75876,116200,3966,41507,49123
71112,13666,52072,65210,8986,60242,71738,4680,35284,49181
71111,17971,54316,165198,11153,82429,236987,6818,34650,46239
71110,1241,51414,65771,916,51452,68984,325,44688,55075
71109,7033,25999,38361,3912,37079,50256,3121,18506,22441
71108,6622,30821,39046,4181,36901,45672,2441,22480,25907
71107,11754,40994,60794,8263,47476,69305,3491,23942,37626
71106,13877,58970,108070,9499,86940,133224,4378,24704,50264
71105,9704,53085,76816,4692,75607,96741,5012,41246,57282
71104,5843,46519,61250,3110,58646,79814,2733,29821,38596
71103,2820,36814,47450,986,39231,46304,1834,33962,43998
71101,2945,18957,36897,1091,36653,49544,1854,15076,28502
71082,2017,25141,37369,1122,31290,45271,895,13783,26337
71079,56,40648,31248,35,0,0,21,10625,8262
71078,2807,73393,85695,1952,83986,93373,855,44222,61846
71075,2525,26318,37517,1458,32258,46712,1067,16343,22269
71073,909,31855,46568,574,50037,62029,335,20456,18985
71072,609,37813,83870,337,38940,54970,272,28947,119206
71071,1075,34680,48369,809,39325,53384,266,25850,31576
71070,579,59063,91089,402,90094,119651,177,20272,25593
71069,294,34643,46211,186,47292,57719,108,18750,25582
71068,1734,25554,48564,954,33013,67668,780,23864,24898
71067,1070,50441,55934,714,55717,65995,356,25500,32051
71065,507,27847,52262,293,52292,73812,214,10536,14516
71064,1151,34346,46267,602,44783,65170,549,20329,24631
71063,375,37303,69191,237,51406,71293,138,25758,57451
71061,723,42431,56072,357,68281,74887,366,28103,36141
71060,847,54007,60597,651,59453,68803,196,24792,29374
71055,8100,29921,48460,5023,36269,59563,3077,21623,29197
71052,3748,29066,41657,2474,39329,49397,1274,18132,26284
71051,990,70516,82850,756,71984,97240,234,35125,33254
71049,1280,56882,73417,872,68906,82018,408,27222,53435
71048,79,74836,91829,38,113676,110416,41,73783,74602
71047,4479,47160,60030,3457,49323,63803,1022,27274,46336
71046,600,44004,51591,324,57736,66653,276,41250,33910
71045,311,61035,66743,199,71875,80333,112,60240,42597
71044,246,51196,78603,148,65714,108364,98,19688,33512
71043,400,48132,42912,115,0,49474,285,48272,40230
71040,2859,23954,37060,1625,33396,47200,1234,13665,22926
71039,617,39750,54878,426,53707,62380,191,24707,34807
71038,1904,25776,35149,1167,31064,43097,737,19427,22042
71037,7077,58229,72867,4885,67750,85831,2192,34387,43104
71034,139,51382,65805,109,62813,70851,30,0,25653
71033,1446,54010,85729,1033,72244,87880,413,30625,76630
71032,997,45156,71204,709,51806,68145,288,36944,77543
71031,287,28825,42221,228,29432,47107,59,16354,22783
71030,532,49545,57245,367,44420,53326,165,82646,60918
71029,76,45357,60520,55,49107,75442,21,16458,21438
71028,595,22743,33844,343,32137,46828,252,11071,16171
71027,551,44364,50310,426,60128,58374,125,16086,22827
71024,582,38099,46651,413,39158,52290,169,19363,29685
71023,1276,26523,41996,810,44139,54188,466,17659,20138
71021,359,20665,22940,188,22632,26918,171,15353,17499
71019,2873,34459,51948,1874,53804,64074,999,14928,28004
71018,693,26146,35118,457,32519,41247,236,20536,23250
71016,761,35417,53392,455,68625,67853,306,23704,28880
71008,353,26683,57042,165,65625,84908,188,18807,25301
71007,477,57868,56818,416,63178,55022,61,0,31739
71006,4758,76687,95452,3928,77952,99216,830,52500,61405
71004,240,31105,38930,133,30688,46835,107,0,26313
71003,445,43897,53600,311,61106,63564,134,19847,29393
71001,1768,33052,42957,1059,34788,51574,709,24572,30040
70836,0,0,0,0,0,0,0,0,0
70820,6667,31442,68116,2770,56364,108262,3897,18619,38070
70819,1453,65774,69839,1150,66598,67364,303,0,71695
70818,3334,72778,90403,2513,86382,101335,821,47788,50946
70817,12239,91639,115152,9237,108031,125420,3002,52538,78004
70816,16626,53831,73743,9084,71716,91901,7542,39912,50000
70815,10629,50862,66655,6355,66091,80233,4274,28651,43864
70814,4265,46394,62992,2581,63952,79234,1684,34174,36708
70812,3236,38235,56192,2420,42250,62349,816,26543,35864
70811,4754,48381,51138,3421,53359,56358,1333,24743,31710
70810,15231,92255,123640,10422,118365,149714,4809,50222,64151
70809,11295,67371,108944,6380,95595,139855,4915,47951,67263
70808,16316,64712,124827,7754,116411,187687,8562,47618,66153
70807,5271,33973,48968,3489,49640,60348,1782,15561,25942
70806,12813,42941,70027,6022,70230,99380,6791,28223,42173
70805,8806,24277,38277,5471,27379,43197,3335,18313,26834
70803,0,0,0,0,0,0,0,0,0
70802,9459,27723,47358,3538,38856,57305,5921,22433,40795
70801,218,97255,117686,18,0,0,200,96814,103221
70791,9382,78231,91543,7148,90375,99908,2234,50376,57914
70789,327,19606,40146,261,25694,47278,66,0,11941
70788,1510,44632,65947,1126,50577,73578,384,26563,39091
70787,229,21378,36320,49,0,0,180,0,0
70785,7662,71395,85785,5720,84676,94576,1942,44632,56618
70783,1165,73631,99866,797,113633,114715,368,49792,66793
70782,39,0,36459,22,25000,37909,17,0,0
70780,424,73710,89753,371,76750,91537,53,29886,32187
70778,935,97979,95275,740,110441,105448,195,0,56558
70777,1491,64859,79018,1037,69606,89929,454,31818,53099
70776,1513,56529,84685,1071,72264,100294,442,33750,46863
70775,3839,63698,85575,2370,81042,105209,1469,39596,53403
70774,3267,81777,102034,2524,84750,115909,743,42943,45743
70773,101,0,51117,64,71190,73864,37,0,0
70772,466,39715,53066,352,42981,57968,114,21250,36739
70770,922,75469,85434,638,90833,105743,284,29293,39810
70769,16086,100458,112073,12920,117042,121205,3166,56316,71424
70767,5700,63343,73581,4208,75065,82852,1492,34963,44393
70764,5810,52315,65720,4273,57314,73800,1537,28838,40318
70763,1549,100846,107651,1198,112222,120205,351,40378,57925
70762,383,0,84850,270,83261,111460,113,0,18568
70761,219,36417,49884,111,37250,71159,108,0,28019
70760,2888,34399,53002,1456,38104,63263,1432,26131,40171
70759,659,33125,50143,372,54545,68577,287,0,25972
70757,1057,54219,66061,676,78190,87321,381,17008,28340
70756,146,0,74792,110,0,90133,36,0,0
70755,662,49375,63628,381,74688,81672,281,19179,39163
70754,4445,60129,70792,3263,63922,72567,1182,47145,62685
70753,367,24542,38186,280,24732,38359,87,0,31693
70752,310,0,57566,169,87386,91627,141,12231,13775
70750,585,27578,58381,429,30260,64302,156,17750,28710
70749,577,33304,52179,246,54643,66278,331,28491,41231
70748,1759,46484,70890,1070,50900,89193,689,39125,42012
70747,112,0,37018,56,0,62471,56,8879,11564
70744,2251,60982,81313,1734,82813,82730,517,32574,74082
70743,110,122569,112035,93,122743,118513,17,0,0
70740,698,46536,61502,534,46613,68132,164,0,33833
70739,4866,103316,113263,3961,121163,124671,905,49918,58942
70737,16185,74863,92137,11775,84515,103605,4410,46944,57550
70736,190,20104,23492,131,0,25350,59,0,0
70734,3190,106699,127351,2661,109025,129994,529,0,114056
70733,492,44695,67887,245,87788,87111,247,42969,44972
70732,449,52527,58425,313,54315,58215,136,0,58907
70730,1148,53974,79281,889,54814,86645,259,41875,50450
70729,331,0,108682,216,0,124927,115,0,78169
70726,20130,69205,81284,15055,75558,89356,5075,39931,49789
70725,685,0,43897,361,62641,61622,324,18778,24147
70723,503,46189,56161,374,46814,62009,129,25066,38903
70722,2444,63061,76845,1538,98587,101977,906,22475,34147
70721,137,73063,88654,75,0,90791,62,106125,86071
70719,1587,67712,87504,1223,82545,101020,364,36667,40293
70715,510,42813,49010,362,51389,54419,148,15750,23901
70714,6498,65170,79900,4241,69479,94405,2257,42057,48844
70712,95,71635,92015,62,72115,72789,33,0,124273
70711,1759,79013,99225,1417,97627,105030,342,50272,72418
70710,2019,79590,89265,1573,96616,98733,446,24031,47659
70706,7755,77305,86563,6026,92645,93677,1729,46105,54121
70669,4453,50667,57761,3448,55756,64277,1005,20723,34656
70668,2779,40842,59784,2280,41777,63865,499,23352,30247
70665,4367,72337,92333,3092,99000,114083,1275,25175,34888
70663,10638,54967,67034,6672,62656,73908,3966,40925,50046
70662,63,57434,63911,63,57434,63911,0,0,0
70661,609,31607,50310,334,55192,77014,275,14787,17876
70660,648,60382,80049,410,94167,107265,238,35679,33164
70659,436,54135,65154,268,64706,76529,168,42031,45089
70658,271,73750,68494,212,76603,79479,59,21845,29024
70657,1535,54629,70615,1003,65080,80155,532,22679,49926
70656,1225,50023,66735,954,66300,77764,271,15054,20222
70655,946,46944,57601,673,52443,63353,273,24315,34151
70654,50,0,76020,49,0,77441,1,0,0
70653,1252,42455,58788,737,66467,75743,515,14860,27853
70652,554,47778,55277,406,60208,71298,148,8750,8237
70651,53,0,0,25,0,0,28,0,0
70650,41,0,40751,13,0,0,28,0,0
70648,2904,53021,64717,2020,74005,78523,884,23413,27458
70647,3546,59770,72088,2763,71920,78942,783,35986,45030
70646,229,0,41090,192,25000,30386,37,0,0
70645,582,47969,66971,496,66339,71108,86,17197,28779
70644,228,0,35689,137,0,48177,91,0,0
70643,192,28711,34798,78,0,0,114,0,34832
70640,172,12372,19988,124,0,20548,48,15735,18342
70639,127,0,58087,98,60833,70498,29,13906,15634
70638,319,40901,88245,262,0,102805,57,14750,18512
70637,351,104003,102156,310,104696,106483,41,0,0
70634,10565,52208,70899,7416,70143,80869,3149,24642,44148
70633,2683,70985,78799,2284,77769,84515,399,26490,37412
70632,231,105625,95166,174,65978,91586,57,0,0
70631,200,0,88657,172,0,84373,28,61000,52129
70630,820,60722,87762,760,61042,92867,60,0,23098
70615,4583,35173,55090,3015,47747,63863,1568,26475,36313
70611,7120,82469,98417,5459,90616,110120,1661,51107,57375
70607,11329,39342,57530,7184,47407,64839,4145,32765,41758
70605,14887,70836,97737,9607,94173,119312,5280,42330,56386
70601,13817,37006,66115,7499,52358,84930,6318,24142,42770
70592,8320,82301,96626,6922,87641,102957,1398,42823,53133
70591,1579,56097,71840,1246,66855,83988,333,17641,20307
70589,978,35819,48732,634,43214,61868,344,13718,21799
70586,7229,31118,48814,4818,39701,59410,2411,17912,24163
70585,152,24350,35041,114,24600,38501,38,16667,21947
70584,2519,38695,59025,1752,53750,68014,767,30531,36090
70583,4140,52045,70541,2699,66772,77566,1441,37214,51581
70582,7116,50059,64153,4792,61856,76369,2324,28924,36839
70581,265,0,50715,210,0,41602,55,0,85509
70580,88,50972,51303,58,0,0,30,0,0
70578,6036,54756,63687,4486,65278,71371,1550,24784,34196
70577,1227,43933,51946,893,58558,61010,334,19286,26535
70576,494,36919,48753,418,37145,51412,76,25833,25449
70575,0,0,0,0,0,0,0,0,0
70570,14377,40906,56171,9407,45269,63358,4970,21875,40660
70563,7185,67166,79882,5457,79175,86073,1728,41418,56025
70560,14839,47314,61596,10082,49671,59918,4757,33285,60922
70559,986,61842,65680,850,81923,70106,136,28846,34233
70558,13,0,0,0,0,0,13,0,0
70556,155,37708,43359,110,48618,54353,45,12875,15420
70555,2987,59982,83551,2296,69591,89353,691,40417,64089
70554,2309,26578,39536,1325,33986,48769,984,20536,26384
70552,511,31875,49475,326,30577,57354,185,38616,30986
70550,0,0,0,0,0,0,0,0,0
70549,1133,34536,57325,837,51289,65655,296,16859,23522
70548,3697,41063,59329,2383,56771,69894,1314,14794,37351
70546,6578,38462,69067,4079,61191,91320,2499,21935,30716
70544,4178,46040,57403,2985,50935,65633,1193,28021,31648
70543,1748,83506,90107,1400,87478,104687,348,20735,28902
70542,1234,74902,78660,949,78395,88660,285,18523,31649
70541,154,24844,37886,99,24883,35846,55,0,30744
70538,5302,41236,57232,2914,55075,69302,2388,29431,41095
70537,146,50086,58905,101,50302,65550,45,0,43993
70535,6304,42781,59430,4328,47500,64112,1976,22353,41925
70534,208,36250,54480,137,52788,57340,71,25625,47794
70533,2602,50307,65799,1976,58816,74783,626,26141,33405
70532,996,49146,63247,764,95268,74420,232,18974,24117
70531,755,76155,71780,658,76462,78949,97,0,23152
70529,4517,52058,69998,3065,73030,82472,1452,25026,38083
70528,853,40529,58462,585,71563,70217,268,23472,32412
70526,7089,34784,59536,4491,37296,73078,2598,25234,33173
70525,5184,42090,57165,3607,58444,66439,1577,23843,31428
70524,113,35179,40275,41,49931,63739,72,19375,26914
70523,383,0,46007,211,71495,71983,172,25000,14141
70520,8704,50044,76629,5732,63995,93884,2972,26981,40313
70519,96,0,50345,41,0,0,55,0,0
70518,5098,74722,93442,3638,76925,102342,1460,44091,67269
70517,9769,46650,64443,6820,52980,71519,2949,31069,44931
70516,264,0,54500,232,0,50468,32,0,0
70515,1178,27149,47084,744,28750,46430,434,19244,44464
70514,899,29761,45836,430,50357,59906,469,27464,30780
70513,95,81031,81612,80,0,80534,15,0,0
70512,4044,53056,64419,2903,63834,73361,1141,31881,36242
70510,9977,47619,63476,6766,63777,75821,3211,28705,35436
70508,16007,73111,99491,9877,101900,126817,6130,34705,51597
70507,6826,61832,72370,4676,73891,81617,2150,34853,49485
70506,17132,49893,62223,9409,62102,75012,7723,35082,44712
70503,11815,81468,127883,7789,101672,131809,4026,47902,118324
70501,10915,30858,45773,6145,40744,56021,4770,18172,27697
70471,8238,84873,120166,5564,105822,152716,2674,35179,49999
70466,3187,60106,73327,2362,72804,85856,825,23730,35619
70465,168,0,30783,128,0,29024,40,17000,26115
70464,128,39375,41613,116,38958,35967,12,0,0
70463,33,27250,29512,23,33036,33704,10,0,19880
70462,2143,42758,69065,1261,54590,90281,882,24890,38349
70461,11902,75843,97961,9013,80880,108938,2889,45043,52598
70460,7477,51289,63879,5138,55500,70418,2339,24928,42086
70458,14866,56701,74985,9316,72339,87805,5550,32004,48322
70456,895,48661,68534,681,54410,79181,214,16500,31453
70455,430,125422,97906,295,126438,130666,135,0,26319
70454,10697,57428,72636,7104,70250,84255,3593,31004,45860
70453,244,66360,109387,216,66974,118607,28,22188,27518
70452,4901,55645,78145,3804,62370,88996,1097,30133,37457
70451,0,0,0,0,0,0,0,0,0
70450,973,48906,66619,638,54783,81973,335,26042,30269
70449,1467,60365,77305,988,78850,91951,479,26853,47096
70448,9086,82840,108033,6734,98957,119532,2352,50253,72090
70447,5316,107830,122180,4439,113851,132480,877,58250,65125
70446,2246,66479,80038,1764,75250,90177,482,35150,42930
70445,3958,60514,83465,2779,74355,102712,1179,30125,37490
70444,4709,41028,60947,2939,62412,73516,1770,24244,38186
70443,3506,27483,43084,2250,45000,51411,1256,23562,26025
70442,108,95511,90189,87,96108,92997,21,0,0
70441,1758,46250,58425,1230,62049,70724,528,20583,27970
70438,7580,44035,58215,5427,53513,66470,2153,20223,34919
70437,3555,56091,77984,2214,85000,94363,1341,44477,49642
70436,245,0,48014,213,23911,49403,32,0,0
70435,6356,72262,85995,4731,86112,97653,1625,37446,49130
70433,14291,72728,98427,9935,86908,113536,4356,42483,61702
70431,1936,45729,65382,1210,66429,84466,726,26343,32444
70427,7604,36331,49868,4835,41841,55156,2769,23905,36395
70426,1848,38900,49216,1194,45673,58953,654,14098,28572
70422,4878,39384,71526,3049,53428,99475,1829,13322,22087
70420,3221,71609,86782,2367,74464,99274,854,36447,47465
70403,11035,50136,69358,7582,63136,79327,3453,26514,39091
70402,0,0,0,0,0,0,0,0,0
70401,8266,35502,60067,4928,52733,74635,3338,26538,37218
70397,375,0,83816,299,108365,100023,76,18125,19593
70395,1573,59707,70026,1071,69375,85786,502,20441,30830
70394,5723,43358,68962,3730,69104,80849,1993,21464,44922
70393,280,0,102358,225,120859,123617,55,0,15389
70392,2870,45164,59847,1624,57976,78465,1246,28405,35445
70391,135,79639,86478,135,79639,86478,0,0,0
70390,2914,51450,57727,2142,62923,65419,772,19588,31205
70380,9065,39649,52023,5102,50410,65907,3963,28760,33079
70377,1452,47149,77577,1011,53272,93185,441,38556,35717
70375,33,57031,59673,33,57031,59673,0,0,0
70374,2761,52827,61447,1942,57574,69002,819,33114,39979
70373,2301,57019,71315,1658,70679,84193,643,25694,36974
70372,1142,29841,52175,808,29702,55233,334,0,43590
70364,10724,65327,73714,7601,70328,83286,3123,39397,44985
70363,8570,37922,63792,6140,40170,52794,2430,29851,84580
70360,11007,72613,88609,7068,83081,105788,3939,27051,55078
70359,3840,44245,60702,2575,46539,67903,1265,23347,35730
70358,289,0,65318,164,93214,87931,125,14125,31400
70357,1162,44803,53970,688,54375,67316,474,14621,31441
70356,687,39542,50324,425,54271,62138,262,26216,30558
70355,365,46958,79350,286,0,85477,79,41691,43673
70354,1891,58533,67644,1219,62375,80160,672,25476,44221
70353,313,32122,34874,208,32267,35514,105,0,26164
70352,81,104107,90649,81,104107,80343,0,0,0
70346,3890,35820,51270,2363,55048,61915,1527,19027,34291
70345,3543,56399,67894,2531,65275,76453,1012,23699,39823
70344,1910,49750,59167,1349,58675,68474,561,0,34623
70343,1874,76682,88862,1349,96746,98240,525,75121,61288
70342,1524,39770,63992,970,58571,79319,554,24167,31469
70341,1766,37601,60944,1158,42237,79976,608,0,23389
70340,59,0,0,59,0,0,0,0,0
70339,2076,46029,71649,1243,74152,98211,833,18713,32012
70301,16930,52430,75859,11503,69314,92905,5427,27903,37071
70163,0,0,0,0,0,0,0,0,0
70139,0,0,0,0,0,0,0,0,0
70131,11269,56465,96174,6409,74556,100408,4860,39693,89664
70130,7175,65132,103197,2348,81547,156507,4827,50576,71963
70129,2683,39715,54746,1878,49911,62849,805,19788,29358
70128,7186,36081,55851,4025,54978,70814,3161,23890,36416
70127,8901,30224,43979,4547,39479,57335,4354,19615,27255
70126,10441,26686,40868,5533,36460,54004,4908,16010,23634
70125,6237,52481,75703,3165,69011,95180,3072,30890,53804
70124,7593,95366,134587,4395,134229,179166,3198,51858,70254
70123,12165,72011,94201,7262,83603,111932,4903,50543,65384
70122,15659,34921,57633,7015,62256,82232,8644,25797,36276
70121,5557,48769,65855,2398,74800,86613,3159,34760,49321
70119,16549,40769,59510,6568,48646,76178,9981,34495,46386
70118,13727,50597,91867,6577,80954,134831,7150,29430,50515
70117,11998,29663,52476,4406,43348,75364,7592,22792,38313
70116,5823,36842,80903,1797,58616,122890,4026,33606,61592
70115,14847,77961,119724,6847,121969,167224,8000,59819,76254
70114,9140,33490,51590,4426,47467,67363,4714,20792,35077
70113,3647,25142,47800,1214,32736,54162,2433,19071,43480
70112,1951,29625,48260,417,31998,67141,1534,0,42479
70094,11485,41237,52925,7470,47372,59705,4015,26970,35851
70092,2690,44753,62162,2066,60793,71004,624,17672,30396
70091,86,52955,50850,55,66016,59255,31,0,26590
70090,2886,47955,63689,2059,62044,77327,827,18398,25864
70087,2630,47675,61741,1605,54472,79602,1025,19139,32986
70086,757,41065,56703,524,37500,62238,233,20865,40798
70085,1650,37816,50779,1028,39515,57070,622,28750,39097
70084,2085,43570,53701,1567,43839,57565,518,24286,36419
70083,962,48981,74376,806,55603,81595,156,17692,33944
70082,158,11222,9749,113,11605,11239,45,0,0
70080,791,52212,62196,323,98005,81473,468,51461,48891
70079,1145,68048,90332,785,70875,79095,360,48750,110924
70076,172,44025,44683,22,0,0,150,0,0
70075,1615,60448,77225,1185,71799,89216,430,25769,37640
70072,19825,53070,68566,13571,66765,76856,6254,37070,47468
70071,1377,47813,62453,1018,55818,74490,359,18272,26150
70070,5012,74478,94378,3950,96316,105671,1062,43246,50468
70068,12037,61725,77508,9022,66875,85714,3015,42559,46604
70067,999,54219,254808,663,57563,87467,336,0,579726
70065,19229,57206,79639,12271,73484,93393,6958,36602,51932
70062,5681,43788,58138,3706,53662,67976,1975,22437,35208
70058,13844,49551,72216,8956,64148,88275,4888,34309,39871
70057,1620,50919,74153,1037,80625,93968,583,21089,32780
70056,14638,56167,77138,9986,66838,88995,4652,38401,47159
70053,7564,39347,51890,3341,54321,68327,4223,24296,37241
70052,1187,60938,78778,928,76646,88226,259,33750,43977
70051,718,72308,79223,379,115804,94729,339,0,61887
70050,89,50104,40462,31,0,37600,58,52803,41991
70049,504,39125,65353,315,0,89183,189,0,24562
70047,4779,99252,106390,3850,111548,115894,929,41673,61821
70043,7668,47337,64038,5173,52068,66940,2495,27174,52116
70041,1148,33490,51867,739,33494,59539,409,0,35964
70040,412,27407,53771,234,35833,67635,178,9340,35543
70039,988,67855,70792,827,68203,71742,161,54931,51065
70038,80,0,41763,42,70588,51724,38,11458,30753
70037,5665,71956,97678,4414,90859,110034,1251,40188,45219
70036,389,61250,73919,299,71161,86026,90,19375,31962
70032,1542,48621,59653,909,59784,70936,633,33828,41101
70031,438,45000,57568,239,60750,76187,199,0,35208
70030,1309,69855,112665,1073,89345,96169,236,0,182502
70006,6223,67321,82738,4159,85758,96558,2064,41681,52697
70005,11705,64235,101259,6496,90182,131397,5209,44113,61482
70003,15213,65501,84117,9860,83873,102819,5353,36265,46957
70002,8954,56361,81822,4729,80085,108443,4225,37266,50631
70001,16638,56724,74980,9063,72434,93552,7575,37465,50670
69367,131,73472,69482,89,75662,76300,42,50000,49795
69366,85,79271,85040,69,78875,82916,16,0,84513
69365,0,0,0,0,0,0,0,0,0
69361,7129,49574,65115,4254,62714,78533,2875,30972,41589
69360,599,40877,51009,357,51339,61951,242,30833,33712
69358,910,56759,64141,597,71595,75000,313,32232,42255
69357,1500,55245,69273,956,63500,82847,544,24018,43728
69356,743,46406,54189,513,55179,66388,230,17500,24935
69355,80,53750,54315,47,73750,59685,33,53021,45545
69354,47,31632,35036,0,0,0,47,31632,35036
69353,15,58250,56907,10,0,55590,5,0,0
69352,287,46411,52205,173,46875,59192,114,37000,37745
69351,118,54038,81330,81,58594,84990,37,0,73316
69350,193,29250,55485,101,58021,85330,92,22292,22412
69348,566,54955,72401,407,60792,83842,159,25625,42511
69347,579,65750,72698,372,69375,83095,207,38906,52516
69346,244,45577,56427,170,45000,66784,74,23125,29391
69345,133,57969,84774,112,59688,93956,21,35972,35800
69343,1084,44070,65801,703,53109,83221,381,25234,30564
69341,4127,62363,78772,2934,75112,93328,1193,27089,38923
69340,26,0,350019,21,0,426219,5,0,0
69339,607,47396,56837,390,62273,67197,217,35250,37454
69337,2796,49161,60335,1595,65975,76444,1201,31187,37216
69336,929,44258,59266,502,57500,80024,427,24549,34003
69335,15,56563,48333,10,0,0,5,0,0
69334,955,51442,63479,612,67292,79219,343,26150,35012
69333,107,50250,99766,68,66875,135743,39,0,36305
69331,29,44766,51548,29,44766,51548,0,0,0
69301,4103,63995,68399,2607,83963,82960,1496,32464,40478
69221,55,50673,66518,37,0,75511,18,0,35317
69220,9,44583,115178,9,44583,115178,0,0,0
69219,51,89688,86676,38,116364,101645,13,37321,42923
69218,164,81750,121782,145,0,133090,19,14327,30579
69217,167,24464,45360,106,0,55414,61,17250,27333
69216,74,67917,63609,45,69063,85564,29,9063,19545
69214,107,59135,68311,89,58750,71883,18,68000,50650
69212,100,37750,45127,76,39500,48159,24,33654,35500
69211,174,42833,60822,116,55000,71525,58,33125,34197
69210,1059,42679,64314,561,64185,90515,498,31092,34723
69201,1693,53859,59994,1022,58936,68887,671,30794,42751
69171,4,0,0,4,0,0,0,0,0
69170,115,46042,58487,62,53750,71421,53,33438,43355
69169,267,44028,68048,138,77222,86287,129,33574,48537
69168,90,67500,95022,62,75000,119408,28,0,41025
69167,134,52500,65182,98,73750,75432,36,19000,37281
69166,295,60150,70687,193,61950,76149,102,47647,60351
69165,744,80263,91862,571,89107,103184,173,34766,51616
69163,354,49375,68953,249,63750,81324,105,34219,38468
69162,3385,51583,62658,1683,74931,84861,1702,33491,38850
69161,32,53250,61184,12,0,45117,20,0,70825
69157,42,50833,64805,27,0,81011,15,0,35640
69156,256,52955,76020,193,54375,86566,63,29219,41697
69155,428,73500,81929,322,81875,93673,106,37222,41643
69154,590,39792,53804,346,50000,65145,244,34712,37722
69153,2843,51361,62864,1534,66009,84548,1309,26648,35607
69152,360,42241,60140,189,64226,80709,171,35977,37406
69151,364,67778,84926,308,71250,92442,56,30625,43513
69150,150,52857,64437,112,73214,78201,38,26250,23871
69149,342,54167,63491,202,78906,82326,140,28056,31881
69148,62,0,228655,40,0,264555,22,0,163382
69147,245,59792,80738,135,83750,95511,110,33816,62607
69146,160,43558,41178,66,48452,47503,94,43173,36737
69145,1315,45987,58589,790,63684,72875,525,24835,35542
69144,71,0,46963,32,0,83444,39,16125,17031
69143,638,77222,84443,468,82434,97913,170,38750,44514
69142,44,41250,54550,26,81250,74219,18,28750,26139
69141,166,54773,77282,117,71250,88171,49,30417,48945
69140,775,65368,83164,559,80750,99216,216,24500,39324
69138,1487,67540,85395,1065,85089,101047,422,35806,43989
69135,9,0,0,9,0,0,0,0,0
69134,173,52313,75885,136,65192,84421,37,26354,44505
69133,203,54821,65174,143,72321,77245,60,35417,34257
69132,41,40250,54893,41,40250,54893,0,0,0
69131,303,64219,70668,222,66667,74382,81,43438,59864
69130,2129,50055,77234,1439,58125,95749,690,30375,36244
69129,526,48068,65230,347,61250,80887,179,24926,32259
69128,133,57531,52808,93,58125,54246,40,34318,49460
69127,331,54519,71495,238,66071,83444,93,37750,37853
69125,128,41000,53275,59,58472,73908,69,40139,35580
69123,360,59091,95360,271,71042,111223,89,31477,43413
69122,298,50769,55899,217,55313,62809,81,29375,37389
69121,172,48000,59906,101,70208,82972,71,21563,25711
69120,495,59875,76405,347,60625,85348,148,46500,43200
69101,12179,57627,71051,7568,71458,84125,4611,29942,46171
69046,54,48438,52339,26,66818,80531,28,0,26161
69045,434,48833,53998,278,56932,64405,156,36944,35429
69044,304,44519,78923,183,61875,103538,121,28906,39347
69043,210,39375,51351,130,44286,64116,80,23750,30609
69042,6,63125,48933,4,0,0,2,0,0
69041,41,50486,49600,13,0,0,28,51389,57032
69040,291,44125,60201,164,76250,79664,127,27031,35016
69039,44,111250,110950,39,117917,120364,5,0,0
69038,223,50625,83977,170,49688,93605,53,44375,51011
69037,74,40625,53005,29,0,80614,45,40469,35213
69036,99,97708,69758,25,0,46424,74,98287,77641
69034,364,48889,64774,272,68077,75176,92,35227,33879
69033,1107,60063,76829,788,66463,85235,319,38281,54268
69032,222,52292,59931,155,71161,73176,67,0,27797
69030,111,56719,72144,75,57708,88343,36,27917,27522
69029,159,60893,71970,115,72656,83095,44,36250,42050
69028,356,68750,72309,206,79700,85759,150,39500,51285
69027,13,0,0,0,0,0,13,0,0
69026,45,43563,53967,35,43882,61380,10,30000,28030
69025,441,48813,58563,269,70156,73285,172,22857,33230
69024,532,52794,66742,330,67692,79166,202,40000,44949
69023,108,71429,111155,100,75125,119194,8,0,0
69022,800,63500,75504,561,70625,88525,239,31023,40696
69021,595,48162,59443,349,66685,75362,246,30694,35989
69020,225,50750,70159,183,58750,78637,42,24375,27538
69001,3768,48000,62734,2036,67598,77878,1732,33049,44681
68982,287,64306,81243,186,75714,103147,101,38750,38143
68981,100,59643,58966,69,64688,60175,31,50625,47277
68980,158,72500,92821,135,88125,100785,23,33125,39965
68979,715,67083,99792,511,80625,122082,204,27500,42925
68978,1112,47845,78240,643,62716,103541,469,22891,41752
68977,98,61071,68038,68,108125,85609,30,22045,28210
68976,183,72250,85970,138,76667,95555,45,41583,52218
68975,44,71250,80207,35,70938,82897,9,85625,69744
68974,119,85230,81872,75,66927,86205,44,85882,74486
68973,166,57500,75377,110,70417,87736,56,36429,51100
68972,89,52321,63354,56,54706,75236,33,21023,35294
68971,187,37917,61178,106,68235,66290,81,33750,54360
68970,673,45250,63939,428,55714,74412,245,28750,40367
68969,4,87500,75175,3,88750,94233,1,0,0
68967,460,58333,64715,326,67244,74685,134,33333,36092
68966,278,51667,58130,125,73125,69747,153,34792,47895
68964,19,0,79711,10,0,0,9,33958,34400
68961,289,54076,72493,200,66176,81071,89,27250,53217
68960,96,54375,54858,64,54063,54864,32,56250,54847
68959,1555,56827,84704,1030,78696,101723,525,30703,47167
68958,262,58750,73382,196,64833,83452,66,36719,40386
68957,212,57500,69303,153,75547,74721,59,33456,54524
68956,541,71250,75782,396,71591,80077,145,40625,55456
68955,820,82000,90433,628,90395,99385,192,40263,57440
68954,8,0,0,0,0,0,8,0,0
68952,30,45833,374960,22,0,497636,8,28750,37613
68950,142,44063,67739,83,80938,83452,59,30972,34498
68949,2873,56356,69644,1668,78125,91314,1205,27058,37811
68948,135,54375,62070,103,54792,65245,32,43500,45303
68947,285,52583,72422,184,64375,85820,101,47050,47402
68946,12,26250,28433,3,0,0,9,22083,26389
68945,104,56250,56187,55,44250,59107,49,72550,52908
68944,523,63365,70726,399,69345,75927,124,41250,49528
68943,113,60417,79865,100,78750,84146,13,50313,43208
68942,139,56146,64071,94,68000,65811,45,38375,53347
68941,330,64286,81894,238,71750,86469,92,0,69716
68940,202,72400,108874,161,90625,121955,41,58750,57507
68939,471,43705,58137,321,52375,70340,150,29000,30231
68938,268,75192,89597,163,80787,113958,105,31705,51604
68937,840,63050,73229,533,64714,84664,307,47708,50479
68936,119,50815,53011,100,51818,57113,19,27250,31337
68935,292,45962,57558,162,91250,82366,130,20000,26498
68934,69,21620,34812,28,66000,52961,41,21157,22417
68933,437,65188,69547,297,78958,85793,140,25625,35082
68932,174,55455,64130,120,72000,80998,54,18000,26646
68930,596,56346,76723,388,76875,97133,208,33182,36620
68929,96,31250,36917,56,0,35434,40,35417,36300
68928,147,51484,65481,107,59375,74366,40,42083,41370
68927,569,61146,73846,404,71250,82701,165,44115,50632
68926,254,38250,49252,140,42500,57274,114,35000,37574
68925,211,76146,80682,163,83125,96039,48,0,28538
68924,528,66435,76541,412,69063,79063,116,45938,52541
68923,34,96000,95747,22,106500,134155,12,23333,25333
68922,523,60170,66466,355,78750,84438,168,22500,27181
68920,762,47500,79719,455,89196,113162,307,26417,29879
68901,10614,54109,72341,6537,72884,88991,4077,30641,43325
68883,1044,58148,71461,740,64000,78020,304,44808,44661
68882,217,40813,55810,144,42083,64394,73,36750,37732
68881,0,0,0,0,0,0,0,0,0
68879,215,46705,54424,139,60625,66896,76,30517,29058
68878,179,68750,76219,147,78352,85824,32,33250,29509
68876,647,57634,75450,507,64875,78993,140,33750,52543
68875,298,47841,55799,201,52788,63523,97,32344,36993
68874,353,40069,50426,221,48631,55572,132,20556,35994
68873,1474,58929,65506,1024,77933,80458,450,22286,31482
68872,374,71429,74577,319,71750,75764,55,0,67696
68871,127,43438,66028,81,54250,81867,46,40000,35189
68870,177,70583,82642,142,76250,89382,35,38750,51286
68869,868,56552,69538,530,67333,77706,338,35208,50812
68866,413,56806,71692,282,77000,82732,131,36964,47621
68865,413,88125,96818,346,95227,103396,67,0,57955
68864,405,59375,68914,296,66724,80673,109,22361,30961
68863,536,68750,71257,413,83920,79083,123,40436,40978
68862,1289,57264,76060,855,78924,97963,434,25909,30658
68861,33,0,73755,14,111071,134607,19,0,28911
68860,147,55104,56872,84,55000,58154,63,44688,44854
68859,259,42417,53432,175,59583,60171,84,28750,28769
68858,123,59904,66155,82,67500,77856,41,0,34661
68856,307,61250,89836,232,75000,106007,75,43073,39064
68855,183,56964,89873,130,66429,100864,53,37083,62549
68854,327,62841,67490,267,64432,68643,60,43958,61822
68853,700,43864,53090,409,60855,65443,291,27361,34543
68852,254,68750,70859,181,73125,79933,73,26250,40918
68850,4272,58488,69440,3236,61033,75315,1036,30041,41645
68849,0,0,0,0,0,0,0,0,0
68847,6774,59356,69954,3882,79573,89308,2892,30144,41068
68846,130,77500,69179,87,100034,85683,43,31719,35437
68845,8411,68372,84927,5237,93022,110127,3174,31963,39295
68844,106,53846,64326,47,74519,98662,59,0,36975
68843,293,71083,81304,219,80625,92029,74,39375,48451
68842,277,47202,63522,156,79167,87751,121,21563,30541
68841,226,69583,88074,168,82083,88691,58,61667,84376
68840,1108,64145,76523,871,69250,83790,237,38036,41230
68838,103,54375,73458,93,60208,76882,10,28333,41610
68837,34,69167,68724,26,76250,77027,8,44167,41738
68836,656,68246,77177,461,69519,79525,195,44219,68426
68835,253,46875,52721,160,57500,58298,93,36875,42339
68834,93,50893,56241,52,52500,70396,41,36458,38288
68833,141,70174,67042,74,63000,75799,67,70590,57369
68832,844,79167,91007,677,88977,102753,167,38819,38851
68831,302,54500,61490,161,76250,73488,141,0,46628
68828,109,54107,65773,62,67045,74092,47,41583,54800
68827,263,52813,65161,195,54750,70717,68,43750,41056
68826,1539,56875,69833,1032,78295,83779,507,31699,37733
68825,407,47614,75305,265,64028,98458,142,37500,32028
68824,613,59583,75489,425,74671,90989,188,32750,37391
68823,1029,55117,67059,752,64167,76191,277,34375,40418
68822,2147,53386,72738,1343,57228,87528,804,29914,43155
68821,51,45893,46294,40,0,45463,11,46964,49318
68820,169,56750,70660,97,72813,89976,72,44500,44057
68818,2119,66839,81762,1515,92340,98875,604,30885,38273
68817,168,60000,59486,94,60000,63119,74,0,53997
68816,112,44762,57828,65,61250,67552,47,0,0
68815,307,45114,67424,222,61250,75342,85,26063,45622
68814,420,49792,57366,275,60846,65161,145,37232,41461
68813,210,61711,87819,142,75500,104594,68,40000,49482
68812,206,67000,81062,144,80938,94910,62,51250,47715
68810,405,50091,56205,237,63750,70097,168,25714,34317
68803,10192,61634,79266,6946,75696,94594,3246,27132,40066
68801,10902,55676,71852,7125,61944,84127,3777,35347,42343
68792,193,67011,72388,141,68438,72828,52,61591,63044
68791,832,60250,73309,530,76284,87019,302,38333,47311
68790,492,57079,75011,301,75625,87710,191,55509,49285
68789,47,51250,68619,35,52917,76391,12,32500,44992
68788,1941,57628,69819,1229,72904,89135,712,32414,34808
68787,2463,56038,66364,1283,73835,91447,1180,23059,34436
68786,396,64464,82457,269,81042,100286,127,30801,43823
68785,94,0,77463,66,92250,104312,28,11607,14175
68784,675,57468,64587,498,69583,73703,177,24896,33032
68783,360,55500,68603,256,70167,82622,104,20909,34064
68781,595,50703,61550,375,57566,71517,220,38000,41047
68780,414,61765,69377,232,81250,88056,182,34531,42159
68779,1022,65119,72827,675,78558,86616,347,29871,43308
68778,245,57604,76544,157,59896,89747,88,30500,49940
68777,271,44250,59029,178,65000,66710,93,20417,44327
68776,5485,56903,68810,3686,71765,78861,1799,32258,45627
68774,91,49375,69968,79,56375,75318,12,21563,22492
68773,83,38828,48307,50,48636,58190,33,30764,33333
68771,597,59393,69244,436,71111,79958,161,30341,36725
68770,665,50391,99583,364,80833,97140,301,25461,99233
68769,756,50682,57360,497,59943,64184,259,34750,41999
68768,266,58000,67023,181,69115,75992,85,45329,46202
68767,1429,58125,77872,1005,78980,94312,424,33438,37559
68766,171,85208,103752,149,88906,113677,22,28125,36273
68765,475,57768,72820,277,71750,78322,198,47917,64353
68764,369,48487,63791,240,58125,66428,129,33173,56690
68763,2036,64286,79348,1186,71920,96538,850,42875,54538
68761,159,49464,58664,98,56667,58252,61,28125,54561
68760,542,45500,54650,344,55833,63541,198,30268,35335
68759,91,35417,56396,58,36429,67505,33,26964,36873
68758,547,52250,61668,364,61250,71873,183,32083,35652
68757,323,70125,77315,249,85625,89184,74,35500,36934
68756,768,52813,63666,482,61625,76194,286,34355,39709
68755,157,73813,92692,122,81429,111242,35,25938,27760
68753,65,59688,68017,43,55417,75628,22,61071,53141
68752,300,51000,63214,217,60078,72472,83,26307,36402
68751,25,58125,66552,17,66250,79688,8,37500,38625
68749,32,46250,51531,18,46250,59533,14,0,41243
68748,939,53060,60795,689,58618,68089,250,32167,39802
68747,64,81029,85728,44,88750,107361,20,41250,38140
68746,204,36944,48660,82,57500,76227,122,27500,30132
68745,657,57868,71182,420,78750,89697,237,33250,38262
68743,196,69306,90492,154,69063,96737,42,0,53255
68742,95,63125,67868,73,85260,74316,22,41000,41068
68741,275,73750,88663,211,87292,98541,64,38125,39202
68740,358,79583,80999,281,82583,82482,77,56250,75587
68739,1122,72955,80756,729,88958,100581,393,29209,43720
68736,295,61250,63752,230,75000,75925,65,10417,20677
68735,348,53026,60366,241,58984,68540,107,30781,40824
68734,43,0,48800,39,0,51651,4,0,21025
68733,458,64444,71077,350,67125,77035,108,34375,41203
68732,98,61667,64470,52,72500,71015,46,60167,51500
68731,939,83047,88883,731,90699,98192,208,37500,48060
68730,793,71908,83032,538,80789,86353,255,30521,74255
68729,786,52857,64973,490,70469,75351,296,32381,46441
68728,105,56875,57977,72,61250,66640,33,22250,27764
68727,286,53958,80613,155,70250,94214,131,31875,62893
68726,239,53438,54023,144,61000,65591,95,37083,35444
68725,252,39118,55598,157,57250,69326,95,27159,32911
68724,60,43077,43642,51,42981,42802,9,36250,36922
68723,273,87535,78678,205,71875,81862,68,0,63004
68722,209,57750,66026,141,77917,81174,68,23833,33956
68720,128,62778,84779,91,92083,107348,37,16250,26103
68719,83,0,79549,64,117672,93841,19,33472,30032
68718,803,50709,61027,479,65489,70204,324,31786,47260
68717,131,62344,84779,74,108125,110980,57,53346,47949
68716,430,57308,72484,290,68882,76404,140,32500,64362
68715,557,72917,77053,404,84265,85223,153,46875,52994
68714,546,53021,78341,377,67750,91963,169,29934,46821
68713,982,55385,70491,644,73939,89173,338,24271,33685
68711,64,0,70756,44,0,77702,20,0,55480
68710,334,48611,64511,238,58833,75271,96,33333,36409
68701,12790,52272,71348,7448,72906,91568,5342,29661,41317
68669,217,67321,151564,137,82188,204226,80,40000,60976
68667,30,45000,55510,21,60179,52200,9,0,63244
68666,615,62292,73657,417,74750,90422,198,33824,35456
68665,329,44013,58340,223,56875,65528,106,33929,38665
68664,137,58125,73171,96,62500,84685,41,34531,42454
68663,429,55170,59597,246,56899,71473,183,40290,40725
68662,465,68550,77278,355,82422,87277,110,45000,43190
68661,2290,65473,73821,1624,65179,74975,666,49590,67610
68660,480,59444,72959,307,59063,83641,173,34821,48428
68659,93,52981,62799,67,52212,64610,26,0,58135
68658,320,75375,80830,223,84712,93191,97,38750,46567
68655,39,60208,80541,17,0,119112,22,58333,50736
68654,249,58315,72927,161,72875,87991,88,32500,43202
68653,237,67344,80917,190,77292,89560,47,0,43932
68652,314,49000,62569,189,59250,78483,125,38319,38302
68651,490,65000,73518,340,72024,83094,150,44583,49331
68649,828,75565,83821,636,80000,91017,192,34107,48744
68648,126,72381,75278,69,105662,92399,57,70536,54553
68647,282,86150,81413,227,87075,88304,55,51635,50935
68644,288,57656,67691,216,68125,76477,72,30625,38081
68643,476,72857,77241,272,86667,98733,204,51429,48583
68642,780,75417,78635,566,89167,91419,214,32059,44360
68641,522,57609,60716,322,75000,75689,200,25750,34262
68640,511,59583,73258,353,78125,88171,158,33438,39939
68638,788,53207,73106,532,57813,87167,256,32500,42855
68637,145,38750,46865,73,43750,56614,72,36875,36981
68636,633,61382,68198,382,77188,84212,251,26997,42899
68635,216,82700,85777,132,95000,104643,84,51250,55563
68634,202,36250,55672,123,51563,65648,79,23125,37561
68633,502,71250,84347,296,76176,101191,206,57778,60144
68632,1551,54596,73512,953,79489,94723,598,30673,39360
68631,163,55375,69458,108,66250,85182,55,0,38582
68629,515,66806,74752,292,88500,90472,223,40156,54168
68628,355,55375,65794,224,75000,74068,131,41313,50305
68627,323,54306,71134,235,66850,80949,88,36875,42477
68626,280,71136,73558,150,88750,93695,130,43750,44768
68624,357,65417,71737,251,70938,84782,106,17422,26745
68623,180,42031,60141,96,59375,84503,84,0,32299
68622,126,68571,87025,73,82375,107563,53,35938,58738
68621,168,51250,54692,112,65625,60895,56,45500,42289
68620,1125,74276,85457,745,85114,97470,380,35588,57563
68601,11419,59386,75368,7235,75630,92279,4184,34360,42671
68532,196,130556,145341,175,130972,152946,21,0,81962
68531,280,107500,93829,200,120893,107407,80,46250,59885
68528,2266,67744,78254,1326,85466,95283,940,41600,47841
68527,293,169583,178837,293,169583,178837,0,0,0
68526,2507,117986,157337,2054,131290,173373,453,52014,75733
68524,2257,62344,73124,1554,66545,79601,703,38802,50160
68523,489,114583,164544,427,127188,178884,62,68571,65789
68522,4434,67265,82366,3045,74390,93673,1389,43668,54144
68521,14127,59626,77032,8919,73610,90266,5208,37836,51445
68520,1075,108319,153706,865,109347,167155,210,74722,94096
68517,176,150938,194594,148,165667,223114,28,0,0
68516,18036,88060,109193,12998,101250,125855,5038,49758,62544
68514,57,108917,118096,57,108917,118096,0,0,0
68512,5620,84253,112105,3603,98598,136196,2017,53728,65734
68510,9115,59013,71698,4951,78712,93001,4164,39500,44497
68508,5729,28251,36948,999,42813,62141,4730,24734,30934
68507,6543,59237,74799,3934,76154,88350,2609,36418,48816
68506,12758,60611,80134,7337,78750,101143,5421,40138,50561
68505,7082,63344,70386,4140,72695,82147,2942,38276,47975
68504,7836,42588,49194,3190,49235,59036,4646,34225,39548
68503,6343,37388,53396,2975,48884,55594,3368,31550,47594
68502,11602,54684,70640,6527,77401,87034,5075,35932,47103
68467,3788,59969,83354,2351,83547,100873,1437,30066,54318
68466,662,46909,61534,403,72708,75136,259,35114,38963
68465,994,67407,77903,739,76446,90306,255,27974,35927
68464,279,58958,60296,147,76146,76639,132,32083,41929
68463,574,59375,73381,397,73365,87025,177,31375,34005
68462,1582,81534,93737,1208,93393,104564,374,46310,57733
68461,386,0,278717,256,221520,410135,130,23618,19926
68460,271,66696,84072,186,81136,100938,85,40625,46901
68458,64,66250,80048,46,73750,92767,18,38750,47544
68457,215,59250,61519,148,72188,70118,67,29196,40028
68456,532,67969,83541,389,72163,96822,143,37083,45290
68455,215,49063,72118,169,48036,69477,46,0,54830
68454,290,78103,87564,249,79526,95748,41,36458,36737
68453,163,55313,57904,94,59643,70851,69,50417,40265
68452,45,41875,53818,31,58750,67513,14,16500,23486
68450,1026,40250,61540,683,51917,72596,343,26821,34181
68448,152,43125,63699,96,59375,70743,56,27500,51082
68447,266,48750,68549,149,79875,88375,117,40150,41234
68446,1232,69324,82423,797,97917,104412,435,37740,42134
68445,77,52440,64452,65,61750,72626,12,0,20167
68444,21,79688,80119,18,79375,74744,3,0,0
68443,391,59931,74827,307,74135,84974,84,38125,37739
68442,121,31771,52176,73,49519,72864,48,16563,20642
68441,61,40375,46797,45,40875,51304,16,31250,34119
68440,64,0,117719,41,208170,166056,23,34375,31552
68439,331,71360,85148,264,78125,89196,67,68616,69196
68438,42,52500,58967,20,77500,77060,22,44167,42518
68437,140,73750,94349,86,84063,128226,54,22250,37919
68436,237,50865,75296,142,77500,84005,95,31875,60754
68434,3269,72118,80839,2175,93799,100059,1094,34137,40784
68433,126,55000,67294,83,112321,94872,43,11645,14063
68431,119,0,77172,57,109531,96212,62,0,59668
68430,646,90595,98850,476,91576,108405,170,0,72096
68428,455,98935,99864,375,103313,102783,80,97870,78554
68424,316,51667,58367,186,65357,70115,130,0,39650
68423,499,79271,79524,327,85990,91031,172,52500,57230
68422,204,67500,90430,161,85417,99956,43,36042,52477
68421,307,44583,63824,149,61528,88358,158,35952,39563
68420,592,45769,53459,390,62500,63220,202,20000,32791
68419,93,85625,105308,73,83750,101445,20,54500,68545
68418,417,76250,98679,342,90278,109147,75,39375,45921
68417,142,34286,49527,99,56458,54598,43,19018,31760
68416,98,56500,52212,59,57250,58542,39,0,42633
68415,255,57813,92647,203,68750,108305,52,31667,31519
68414,124,53077,70890,83,83438,87329,41,0,37610
68413,218,79741,84669,138,92917,96659,80,71538,63053
68410,3540,59105,74292,2382,68891,84969,1158,32155,48604
68409,291,68438,84728,215,96750,93407,76,49167,57338
68407,322,84750,94518,234,114231,112285,88,36250,47274
68406,231,53906,69076,128,79500,93824,103,33897,38321
68405,1301,67684,82430,909,89938,101884,392,28472,37159
68404,386,70556,68996,294,69722,66022,92,68611,76143
68403,93,56750,66317,66,62500,75077,27,36806,43400
68402,398,81667,87570,321,97344,98531,77,36719,41395
68401,380,98889,87665,314,105182,91216,66,44500,70636
68382,18,120938,109983,7,145313,129900,11,120781,97309
68381,53,51964,71923,37,84375,86892,16,31250,34650
68380,23,44583,65587,16,62500,80306,7,29688,31957
68379,28,58750,67979,16,54375,74006,12,71250,59942
68378,267,58295,76612,179,76875,94286,88,47857,40209
68377,196,59375,92285,145,79821,106830,51,41328,43394
68376,639,54188,66911,415,72292,82047,224,30000,37683
68375,67,20774,21537,48,20714,19454,19,23125,25474
68372,1265,103869,115861,1099,106991,119988,166,47222,68174
68371,592,61250,66398,400,68000,74733,192,0,48978
68370,903,52669,67339,497,72083,84491,406,41204,45667
68368,195,84107,92519,189,84464,93279,6,51250,67017
68367,141,39063,89461,85,48438,111721,56,29750,51911
68366,334,70375,87345,257,72063,98566,77,0,48262
68365,113,64063,69522,83,85365,75333,30,38125,40463
68364,61,74107,76210,48,74643,77277,13,0,72269
68362,20,55833,66575,8,51250,55425,12,81250,74008
68361,923,74750,106966,593,92664,140623,330,28362,43740
68360,200,70000,91020,152,77833,98812,48,38000,43421
68359,649,67898,82336,439,91750,100027,210,40500,40974
68358,494,114079,117581,440,116364,126062,54,47500,48474
68357,122,91000,112025,108,90500,116155,14,47500,48000
68355,2241,39568,59265,1384,45772,72394,857,24583,34641
68354,450,55714,66990,274,67955,81308,176,29712,40388
68352,2137,43733,53883,1191,55365,68072,946,26250,32886
68351,416,62885,83188,231,84875,107629,185,30560,51892
68350,110,61250,81295,78,64063,97654,32,35000,39281
68349,435,80875,97138,325,84625,111495,110,0,45787
68348,115,73750,67238,83,88250,84789,32,21250,20713
68347,979,81979,119805,727,105208,145466,252,32708,41710
68346,238,67935,77270,167,89583,93588,71,31985,38887
68345,134,36429,46673,63,51806,63249,71,32212,31965
68344,183,69250,67337,109,72768,75124,74,61250,55868
68343,373,67361,70234,252,66111,70530,121,68125,65898
68342,272,53636,68907,164,85357,80248,108,25833,48534
68341,445,70156,72101,259,71719,78374,186,66500,63366
68340,389,51518,74712,259,55461,68185,130,46184,87342
68339,414,105000,116214,319,116971,133423,95,62917,56968
68338,143,66875,95778,92,105000,125288,51,28875,42545
68337,164,44821,54401,100,53750,72960,64,18438,25403
68336,297,122292,142376,268,141250,153254,29,50104,41845
68335,225,52708,60807,145,59583,71091,80,35000,42166
68333,2943,48825,66825,2129,61094,79874,814,23833,29190
68332,53,54750,56791,28,80625,72418,25,22159,39288
68331,349,58295,78962,281,68125,85604,68,28750,50174
68329,222,56667,74387,135,67250,90266,87,39219,43269
68328,171,59375,76052,132,72500,85355,39,32344,41508
68327,176,0,46731,102,59167,61958,74,19474,25466
68326,95,66313,77238,84,63889,76646,11,35417,26836
68325,72,75000,85839,34,78750,107071,38,69063,66842
68324,35,0,147254,26,210938,187785,9,33750,30167
68323,114,43750,49147,61,56750,69507,53,0,25643
68322,186,70000,76162,112,86250,98441,74,31667,41514
68321,163,46850,70157,118,0,80913,45,36193,40984
68320,191,50375,96936,87,108510,134136,104,26000,65720
68319,257,62208,79812,213,66250,86504,44,43750,37286
68318,182,52045,56549,125,64792,62206,57,31250,40702
68317,700,88333,103743,561,110469,119858,139,37740,37917
68316,212,62955,68103,156,68611,79534,56,33542,35963
68315,35,59688,59034,32,70417,60728,3,0,0
68314,148,72500,106660,106,111250,127221,42,66875,54600
68313,296,73561,86929,239,74583,94526,57,44844,50209
68310,6190,45759,59378,3390,66541,76739,2800,27575,36307
68309,43,68125,62823,22,68750,65214,21,54750,59952
68307,193,60250,67992,142,63750,73372,51,31103,36912
68305,1827,48144,64971,1192,63750,75810,635,32460,40307
68304,102,64583,63536,74,70556,68370,28,55000,50761
68303,142,70625,99015,116,81250,113157,26,0,35588
68301,546,85833,103055,436,98088,117668,110,38750,43260
68178,20,0,0,0,0,0,20,0,0
68164,11795,73984,90287,7491,88352,106803,4304,49071,57800
68157,2827,68558,77258,1852,81084,86736,975,36267,52697
68154,9909,74904,112040,5837,103401,148674,4072,46850,55745
68152,2498,72606,98508,1732,88908,113155,766,45471,60187
68147,4076,64088,74117,2939,76654,83804,1137,41678,42852
68144,10273,72475,91560,6483,97145,108051,3790,41016,54286
68142,1756,89914,132938,1320,124148,153680,436,56053,66583
68138,4565,80389,99224,3169,92917,114856,1396,46628,60209
68137,10148,74716,84757,6301,86129,98047,3847,47954,57745
68136,5994,107923,122598,5155,114737,129121,839,67361,75015
68135,10043,116800,134415,8252,126926,147169,1791,60423,71453
68134,12973,56184,68269,7580,72624,78527,5393,37138,49926
68133,3942,109878,123500,3098,120708,134505,844,72738,81041
68132,5817,69229,109369,3426,92746,140866,2391,44957,61190
68131,5863,42516,58402,2416,66725,78890,3447,32118,42924
68130,7873,112947,153336,6127,133695,174537,1746,48853,77429
68128,7756,71579,88043,4799,90497,105397,2957,46792,58732
68127,9856,58481,69798,5308,73090,84555,4548,39444,50333
68124,6508,83878,118597,3881,119422,153120,2627,43525,66023
68123,11685,81231,94405,8359,90861,106732,3326,47874,57908
68122,3906,87181,88602,2912,93178,98893,994,43913,50484
68118,3447,126753,152698,2825,139450,166426,622,46853,89125
68117,3017,56193,66311,2057,62650,73846,960,33504,47473
68116,11668,98300,116816,8508,113571,129459,3160,58723,75314
68114,8166,62870,99652,4231,88288,144741,3935,41770,50308
68113,243,51875,65467,182,60300,68371,61,30865,56803
68112,4242,52563,69107,2780,60977,69964,1462,30109,55635
68111,8434,30046,38582,5213,32947,40957,3221,20242,29889
68110,3196,31503,37323,1646,41231,46044,1550,22656,26433
68108,5171,43690,62751,2988,51098,64149,2183,31896,56292
68107,9012,48971,57786,6375,57114,65796,2637,24362,32448
68106,9640,61473,73505,4643,74603,90123,4997,47876,53107
68105,9605,43306,59793,4284,60656,77836,5321,29644,41952
68104,15387,48720,62953,8625,63448,77476,6762,32219,41488
68102,4798,63723,80224,831,105313,151942,3967,53589,64794
68073,905,77917,93798,658,82500,106973,247,47614,57686
68072,20,38750,103780,14,0,37036,6,0,0
68071,582,51442,55257,463,50815,55430,119,23281,36355
68070,357,63482,77788,300,97541,85949,57,22083,27725
68069,1231,95046,165066,935,96716,198056,296,49063,54281
68068,58,73750,82622,29,63750,83817,29,106875,80666
68067,339,52798,58990,250,58333,65299,89,25417,32718
68066,2112,65405,85489,1398,85595,105503,714,35147,43189
68065,630,71250,87935,435,91654,93165,195,43750,75489
68064,1592,62347,97476,984,79659,114992,608,32917,66738
68063,108,50000,53901,75,48750,53293,33,51250,53403
68062,117,74250,90972,98,84167,99830,19,0,37421
68061,951,55625,71615,598,65417,86241,353,28068,39133
68059,1361,86042,108304,998,99500,127252,363,35417,55190
68058,114,91250,105333,87,96106,118002,27,55179,60467
68057,628,67708,83498,390,74750,84379,238,40000,77626
68055,100,61250,78026,58,97500,98967,42,30000,48860
68050,256,46863,60945,159,73036,77136,97,39750,33155
68048,5077,70734,82657,3397,83172,94030,1680,39542,54740
68047,729,75107,89691,516,84167,99051,213,40417,57613
68046,10398,95524,115774,7758,113949,130530,2640,40333,65120
68045,806,57500,83314,558,73942,100792,248,29300,36371
68044,269,62813,74120,177,0,86824,92,43750,45891
68042,20,41250,67340,19,48125,70595,1,0,0
68041,444,63269,75984,281,96875,93689,163,46082,44494
68040,156,81250,69196,111,85764,80941,45,19531,40222
68039,293,32386,43047,241,38393,45090,52,12917,16862
68038,614,42125,62857,364,66667,85791,250,25365,28757
68037,982,90417,106815,742,107857,126953,240,35625,43153
68036,160,33750,38211,112,24608,38051,48,34271,34679
68034,286,114375,113175,179,115859,129420,107,83750,83516
68033,135,53750,69827,99,75446,81601,36,40357,35003
68031,709,65074,83403,496,78750,88032,213,55956,69441
68030,289,73125,72703,201,77875,82082,88,43750,46784
68029,411,56875,58400,216,75313,73026,195,0,38072
68028,5396,116066,126339,4373,124917,137956,1023,49183,68044
68025,12623,57213,70652,7999,73444,83428,4624,32020,45596
68023,964,81824,99237,644,95938,109824,320,51786,76385
68022,9512,112500,146103,7143,137396,170586,2369,57643,68326
68020,294,51250,64844,162,65000,74926,132,26000,47850
68019,202,50000,62269,156,71389,72592,46,0,27059
68018,189,89375,92737,146,120461,107284,43,45313,41149
68017,731,74375,79915,479,87969,91994,252,52639,52298
68016,172,98194,123887,133,99514,138680,39,38750,52503
68015,486,69000,82851,396,72500,84262,90,45625,71484
68014,137,48679,68058,96,0,86870,41,20694,24012
68010,18,0,193828,8,61250,63813,10,"250,000+",292680
68008,4996,69006,88063,3373,92017,106070,1623,41646,48415
68007,4443,121217,166660,3656,130093,183091,787,75404,82997
68005,9241,56499,72640,5895,73031,85776,3346,33282,43061
68004,423,52917,72393,272,79500,88943,151,35928,41260
68003,1895,73945,90467,1263,86016,101870,632,33714,41439
68002,1002,69722,81779,681,86654,97569,321,37557,45349
68001,20,60833,65340,18,61250,67267,2,0,0
67954,265,50966,67952,201,58250,77587,64,23333,33698
67953,42,0,34724,18,0,73861,24,0,0
67952,183,58487,127630,145,59236,143279,38,42500,43682
67951,1581,59417,64840,1161,62150,71157,420,32500,44890
67950,747,41698,55993,395,54688,71465,352,32917,34761
67901,6904,48695,60796,4746,53842,68718,2158,32323,38397
67882,155,0,48408,30,0,96613,125,26205,36838
67880,2613,62452,86030,1655,80965,87315,958,33656,83444
67879,491,53750,63425,336,60909,68815,155,36458,51743
67878,747,49886,57692,457,54417,66546,290,31324,38383
67877,820,48981,71220,581,67634,85141,239,40343,36024
67876,580,62614,71911,429,73750,82643,151,37734,40442
67871,2084,55568,71337,1433,71477,85933,651,28351,37104
67870,461,56094,73825,338,57398,86590,123,38068,35263
67869,608,61250,71266,475,65875,72507,133,37083,45147
67868,50,46953,56538,50,46953,56538,0,0,0
67867,590,54896,76298,410,72308,91307,180,35227,41076
67865,413,54583,72595,247,64306,78321,166,41833,56902
67864,763,57026,83823,461,68897,102488,302,29000,54192
67863,157,43359,67466,67,74938,103313,90,36061,40779
67862,126,46667,49125,80,55909,55869,46,34375,37396
67861,805,59201,71761,528,78000,84318,277,34821,43422
67860,894,44619,61302,528,51250,70228,366,36839,47434
67859,221,62375,73604,188,65096,77113,33,55729,48715
67857,39,0,65608,27,80903,75326,12,0,0
67855,731,58247,75193,421,70707,71524,310,57949,79959
67854,553,60524,66510,339,81250,79725,214,32500,45272
67853,247,72656,88987,204,88438,100889,43,30139,28681
67851,919,75125,83254,787,80694,86686,132,51667,56385
67850,170,56667,61029,118,66250,69235,52,31250,40142
67849,152,56875,75188,130,65000,75469,22,45000,71014
67846,11450,59242,70721,7950,72120,79662,3500,38935,44091
67844,346,47262,64949,192,61250,77259,154,34038,48931
67843,115,33418,32037,5,0,0,110,33516,32535
67842,150,64375,77801,114,72188,91635,36,0,32300
67841,158,42917,67377,89,47321,88700,69,37891,37322
67840,45,46250,47396,35,48125,46454,10,0,50680
67839,568,40441,57685,298,79250,90356,270,16667,21045
67838,306,56071,61553,238,65089,67706,68,0,38994
67837,357,66042,135241,260,79167,166577,97,41250,51249
67836,55,31250,42102,20,41250,52405,35,30250,36214
67835,1075,80040,84689,845,94190,90834,230,51500,61559
67834,358,56406,71149,255,65972,81845,103,32188,43557
67831,468,55238,63710,282,66250,77449,186,38750,41040
67801,9832,53728,72111,7003,65413,81559,2829,32470,43249
67764,152,65000,90376,114,83333,100220,38,38750,57529
67762,71,36250,49965,48,58750,58471,23,21875,27665
67761,91,80469,91270,74,82500,92493,17,43250,85947
67758,510,49265,58962,345,65536,70851,165,19306,27593
67757,168,41667,61433,96,68750,78834,72,29167,38214
67756,931,42639,57809,458,63913,81571,473,25446,34253
67753,203,70764,93428,136,90000,114319,67,45625,49972
67752,653,53646,71795,422,66923,78322,231,35515,59675
67751,113,52396,63949,70,52292,61561,43,0,67260
67749,1053,37271,54063,557,58958,71984,496,25000,31757
67748,1048,47083,61680,685,69625,76908,363,25568,32279
67747,54,53438,93106,39,74063,124026,15,25000,12713
67745,181,57188,60862,135,67330,73355,46,14500,21020
67744,50,44286,60046,44,0,68068,6,0,0
67743,61,0,81026,45,95729,93218,16,0,0
67741,186,0,78180,120,0,97033,66,26310,42285
67740,741,68281,93470,446,81667,115663,295,31458,58571
67739,124,40417,60919,63,57917,78897,61,22212,41926
67738,219,56635,71284,146,64643,83405,73,41875,45279
67737,248,51731,71232,123,70417,92402,125,29750,48740
67736,97,66750,82928,69,73750,97375,28,0,46200
67735,2262,57053,87579,1476,67143,91431,786,31262,77567
67734,95,76607,73498,85,77708,77089,10,46250,42130
67733,79,102171,91992,75,102303,95107,4,0,0
67732,234,57778,69916,203,58850,75727,31,0,25313
67731,326,42250,57513,187,58438,70991,139,29792,36443
67730,770,61923,69542,490,75526,82006,280,26667,41460
67701,2699,66573,88084,1683,74882,85508,1016,48276,91235
67675,88,44674,69336,63,0,78737,25,0,45648
67674,21,47292,63210,11,0,80955,10,0,0
67673,42,31500,35279,23,0,44009,19,0,24711
67672,1158,57609,78004,754,79677,94076,404,35893,42595
67671,656,67071,73516,412,80865,89602,244,40000,43753
67669,826,45781,54887,512,54125,64532,314,30781,38544
67667,61,86250,82457,47,95625,94666,14,0,41471
67665,2168,50250,59528,1266,60227,75445,902,27016,32483
67664,124,82500,85462,85,101563,103946,39,0,45177
67663,1039,59375,70428,698,75000,83421,341,28125,41628
67661,1400,51481,66433,749,66321,89217,651,32923,38990
67660,32,0,54722,11,0,86009,21,28375,38333
67659,46,46250,40457,29,50536,47393,17,0,0
67658,34,57500,60115,23,86250,66957,11,0,45800
67657,116,46429,50921,68,50875,58813,48,32500,39740
67656,83,59850,78993,30,128864,117143,53,58350,57398
67654,1267,52014,82760,790,71277,110807,477,35156,34388
67653,166,58810,59778,97,70469,72562,69,51125,41777
67651,218,63611,64060,169,64464,71367,49,19438,27163
67650,118,51875,59817,61,71625,81203,57,43009,36928
67649,108,55167,59732,72,56833,71574,36,32857,36047
67648,285,43750,80285,196,59286,102796,89,30547,29170
67647,83,46250,56617,46,64375,71235,37,32125,37273
67646,423,50688,54663,280,47813,55303,143,45066,41578
67645,296,40593,52574,212,41398,58979,84,24625,36183
67644,125,55875,65343,76,55500,63855,49,63036,67651
67643,113,58750,62445,55,70208,73913,58,57500,51571
67642,944,37149,51932,545,53750,69550,399,21969,26982
67640,282,60625,69884,215,66583,76828,67,32917,46046
67639,80,68000,64665,51,72656,76359,29,31583,43572
67638,133,32656,52113,78,73000,62499,55,0,37384
67637,1077,70474,85663,756,81288,93096,321,26855,54191
67635,62,52500,68231,43,57083,87537,19,23750,24537
67634,80,55000,65799,56,69444,84168,24,19000,22942
67632,127,34779,49877,67,53125,54028,60,33393,45242
67631,52,43750,57269,43,60139,63591,9,0,27078
67629,69,61563,59106,46,82750,72528,23,0,28704
67628,43,56518,69314,38,56250,69571,5,0,0
67626,86,52059,52692,24,68750,61300,62,51471,46774
67625,86,39167,40347,31,40938,48368,55,37188,35825
67623,72,47813,79300,41,49219,93046,31,0,59768
67622,260,52500,75282,143,62813,104483,117,35156,38307
67621,155,40875,52519,85,56875,63645,70,31250,38946
67601,9831,55176,72122,5653,80770,85958,4178,31633,50675
67584,108,32500,38794,32,62857,72625,76,15000,24549
67583,409,49205,61639,233,81250,82430,176,31250,33696
67581,142,65500,80480,103,77159,96575,39,30313,36777
67579,1176,51071,59379,794,62344,69109,382,27500,35557
67578,545,41932,51247,322,59688,67394,223,18173,27560
67576,807,62083,83085,561,74542,96709,246,37500,47906
67575,210,70000,67165,138,77903,79515,72,38750,42899
67574,55,48958,69736,32,63750,73900,23,0,63943
67573,81,60250,64814,56,60000,72700,25,29750,40348
67572,209,47969,61117,115,58583,84850,94,26111,32082
67570,514,61176,72837,372,67917,74660,142,47500,61865
67568,100,34167,42950,56,42000,49543,44,22500,34559
67567,274,45682,54653,134,63333,63111,140,40242,44420
67566,214,56667,74318,140,71071,91293,74,24128,34672
67565,168,52917,50243,93,62625,62418,75,30938,33945
67564,75,50625,67228,49,66250,81124,26,19773,41042
67563,142,54405,70427,102,56000,81986,40,32188,37043
67561,503,52697,55699,372,54722,60821,131,20250,30969
67560,692,60227,77865,482,68214,90053,210,45000,47126
67559,14,58250,55964,14,58250,55964,0,0,0
67557,250,51364,65219,178,61250,76935,72,0,34400
67556,94,46250,54827,49,63281,73737,45,0,34236
67554,1717,51150,68444,1141,59875,84830,576,26136,34416
67553,66,43750,62070,29,70938,85097,37,32054,39627
67552,323,41806,62343,193,77614,81466,130,28333,32653
67550,2108,45854,61454,1140,63190,71982,968,28017,47861
67548,743,43068,53044,307,66083,72555,436,27969,36620
67547,774,50125,57802,475,60417,69822,299,32788,34961
67546,908,64583,78171,715,69725,87915,193,31528,39524
67545,78,51250,71786,46,72500,95759,32,38125,37328
67544,1216,48750,67205,803,62250,81752,413,25568,32207
67543,818,60000,69679,578,66618,80447,240,34773,38449
67530,7603,48750,63005,4892,64703,78125,2711,24736,33802
67529,71,50938,60934,45,61250,75884,26,31071,34308
67526,1056,48750,70647,700,69239,88921,356,31413,34716
67525,386,51250,62764,218,71250,82450,168,35000,37220
67524,248,46528,51970,151,49659,59067,97,44125,39319
67523,180,45714,62991,135,51250,64371,45,38281,58847
67522,780,59286,71419,605,71058,81708,175,29327,35848
67521,78,91136,75650,64,91705,80486,14,46111,50307
67520,144,55833,61008,100,56146,63439,44,45833,55484
67519,61,50938,56372,45,44063,55422,16,55500,48875
67518,14,0,56379,12,48333,62800,2,0,0
67516,164,50000,66244,116,59000,76397,48,27000,41494
67515,26,80313,103212,21,81094,124424,5,0,0
67514,351,46875,55921,241,53661,59893,110,33750,38153
67513,49,20313,32602,13,63250,61385,36,13571,22206
67512,87,71250,82289,69,76042,90222,18,21667,42422
67511,90,44000,58657,66,47500,65730,24,0,35979
67510,101,43125,65842,74,0,73476,27,55208,44915
67505,1297,43050,49897,658,55947,65550,639,22338,32890
67502,10137,66295,85114,6587,79344,100435,3550,37386,54315
67501,9498,40833,50903,5446,48932,60644,4052,26389,33354
67492,58,57500,53303,28,61500,63136,30,50500,44123
67491,172,50000,63166,118,51875,71444,54,37500,43880
67490,372,53500,60166,242,59848,69183,130,0,38965
67487,574,45921,61743,402,55859,70956,172,34500,38398
67485,188,38125,46797,78,60455,64918,110,31198,33948
67484,405,48558,78981,268,70000,101628,137,25893,33378
67483,193,62928,71741,142,63487,73065,51,54063,67398
67482,53,0,56891,30,0,57623,23,0,0
67481,286,38854,56190,192,53250,69395,94,28750,29219
67480,597,66534,73398,412,75938,83730,185,35679,44515
67478,37,53203,53654,31,53125,50135,6,0,68350
67475,57,41607,65446,34,51875,91018,23,0,27639
67474,103,52788,50719,63,60625,70595,40,13750,16335
67473,866,51500,62125,513,57455,72757,353,31006,43242
67470,195,65694,56128,106,66389,59291,89,53958,50263
67468,114,56786,65119,89,60188,70424,25,40417,46064
67467,1081,53229,64651,715,72639,75913,366,36190,40103
67466,298,53194,61183,198,64500,68348,100,32500,45332
67464,437,50809,60099,272,55000,66244,165,46116,47104
67460,7025,60406,75479,4553,72648,90262,2472,35172,46143
67459,136,91500,84927,103,125293,97996,33,31750,44136
67458,142,50459,59696,112,50816,62915,30,30000,47673
67457,304,49048,61912,187,75250,79115,117,26750,33309
67456,1606,57209,67668,982,75273,82200,624,35606,41635
67455,804,48015,60267,451,81458,79730,353,30288,34982
67454,321,46193,55343,211,50972,65019,110,31071,35459
67452,98,78269,74548,56,78269,76668,42,0,71721
67451,436,42955,54419,270,44342,58196,166,32115,47929
67450,281,75938,79652,194,79861,95714,87,30313,41848
67449,1364,53864,77563,826,62882,61135,538,30476,102621
67448,464,64244,69913,339,73162,79674,125,28487,36298
67447,164,0,64558,109,70417,88940,55,9137,14171
67446,308,51429,63969,192,80455,77595,116,40000,41416
67445,247,39375,54602,174,39333,59380,73,39583,41973
67444,258,51250,67247,182,70769,80343,76,30000,35258
67443,681,82257,96200,554,99000,108461,127,36250,38995
67442,40,36250,36653,40,35000,31125,0,0,0
67441,405,41723,51887,295,48352,54149,110,31250,37663
67439,1120,54200,65466,721,78984,82667,399,27120,33764
67438,98,41250,47393,67,41741,51399,31,0,38735
67437,468,51500,76213,209,76250,96024,259,31801,58711
67436,268,56944,69413,188,67500,81635,80,31000,36821
67432,2620,47300,63523,1593,69668,84373,1027,23750,28774
67431,862,58362,68686,544,73088,84134,318,28333,39014
67430,267,41544,45958,172,44375,50883,95,27031,35718
67428,567,62426,88099,424,68864,101953,143,23438,43449
67427,198,38152,49397,128,44833,61895,70,22273,25243
67425,248,58438,70796,157,74107,82520,91,0,44987
67423,80,46250,63166,48,77083,83773,32,0,30953
67422,614,74286,113448,482,79808,132902,132,28500,40683
67420,1780,47704,62177,1091,54053,75867,689,34196,38124
67418,84,50625,47719,62,53158,51760,22,38571,36327
67417,85,71086,80594,64,71316,90348,21,52813,50862
67416,393,69205,113800,288,80333,136090,105,35950,37857
67410,4402,54359,74469,2765,80228,98823,1637,25089,29771
67401,20828,51221,68767,12362,69660,88804,8466,30168,36921
67364,129,70433,66694,96,71731,75582,33,37232,40836
67363,78,87917,87856,61,121458,99192,17,54688,47182
67361,678,35000,44851,431,40781,50755,247,28578,32490
67360,179,41250,69604,116,42639,91245,63,0,24160
67357,5028,46452,57258,3064,58882,72050,1964,26677,33064
67356,1105,45859,68503,737,53144,80004,368,30588,43220
67355,92,61250,67329,73,61220,70568,19,0,52800
67354,246,63056,60403,181,69732,74846,65,14250,19542
67353,234,39444,50731,164,51250,55771,70,27500,35827
67352,259,43125,54964,176,58167,63297,83,23750,37295
67351,160,81500,76983,85,76375,81325,75,90096,69648
67349,405,53011,68450,250,64706,89970,155,23523,33421
67347,167,72083,81196,148,73750,86612,19,0,38784
67346,140,61458,65696,108,73333,72559,32,0,26313
67345,68,0,44509,40,75192,61095,28,12273,20818
67344,287,41964,57835,204,56500,70895,83,19821,23854
67342,339,56328,62991,220,76389,79123,119,21016,32739
67341,152,90357,103899,138,107750,108931,14,0,0
67340,212,52500,60715,151,56555,75668,61,18750,23700
67337,4959,40249,56652,2791,51081,71555,2168,27202,34233
67336,701,32009,43271,414,42262,52684,287,17319,29510
67335,1402,46938,56513,1049,49399,63094,353,22813,28102
67334,25,31719,71364,17,0,94882,8,0,18388
67333,1115,51334,59644,730,67115,71200,385,24612,34425
67332,56,0,44305,50,0,46138,6,0,29033
67330,519,58194,66210,391,62396,77690,128,19808,30854
67301,5475,46563,61088,3266,56905,76574,2209,26645,34445
67260,0,0,0,0,0,0,0,0,0
67235,4663,102399,117412,4043,104850,119832,620,69444,94055
67232,147,61067,53284,136,61402,58407,11,0,0
67230,3911,125817,167406,3258,134255,175625,653,65104,123528
67228,687,151989,211624,650,155385,213019,37,0,173178
67227,80,68947,83645,64,85000,94956,16,0,0
67226,8085,69520,91608,5169,83411,107551,2916,45958,60140
67223,186,113462,119117,174,104583,117437,12,0,0
67220,5033,66466,74984,2921,90166,100277,2112,31042,36768
67219,4527,57025,69496,3269,60429,75431,1258,35845,49664
67218,9914,41563,56098,5183,54226,69495,4731,30576,38810
67217,11871,49366,57677,7866,59554,65125,4005,32279,38854
67216,9223,40336,55998,5085,51053,61060,4138,27183,47647
67215,2106,93365,110932,1595,101915,123502,511,55313,60866
67214,6089,29900,37569,3209,40479,45790,2880,16259,25511
67213,8424,38277,47154,4571,44104,51181,3853,27611,38447
67212,18043,58867,72145,10922,75963,86749,7121,35067,47389
67211,8160,37166,44134,4211,45047,53061,3949,26227,31925
67210,3401,46661,54680,2350,59855,64395,1051,25768,31571
67209,5100,73186,83176,3400,80078,87869,1700,50096,70384
67208,7502,54598,71288,4048,72946,88474,3454,37891,49109
67207,11413,54660,79172,6208,72781,84189,5205,34878,69603
67206,7398,85000,133177,4338,122293,187070,3060,42981,56401
67205,6938,101884,119129,5720,113973,127164,1218,47124,69888
67204,8510,56745,68936,5726,63724,80087,2784,30056,39363
67203,12588,43520,54603,6439,57906,67511,6149,30314,37456
67202,1230,54375,69787,238,150844,154292,992,41901,49512
67159,48,56250,55956,30,83333,68630,18,0,34833
67156,5494,49404,69143,3514,59000,72842,1980,24455,56988
67155,65,78750,94372,62,79286,96408,3,53750,52300
67154,622,49950,66203,468,56875,69000,154,38900,55523
67152,3606,49219,62073,2306,62929,72696,1300,23553,33849
67151,164,54167,65828,138,58750,69251,26,38750,43362
67150,12,27000,30575,9,0,0,3,0,0
67149,405,90398,93115,260,86429,83694,145,155083,110008
67147,3699,73155,84542,2935,77372,94538,764,31000,37845
67146,798,66000,91361,586,74839,107182,212,48047,44798
67144,995,64432,82873,780,67132,90575,215,37750,54928
67143,15,46250,57073,12,55000,62700,3,0,34567
67142,175,61438,114676,140,62813,134611,35,22292,25914
67140,424,38750,55288,297,52589,64731,127,28393,32794
67138,175,46616,83807,139,47263,98753,36,14773,26028
67137,185,43393,55014,106,65962,72651,79,17917,31348
67135,1153,72028,88944,946,82566,98772,207,35074,41011
67134,165,55625,80002,132,78000,92239,33,34250,31052
67133,2286,80533,91667,1835,85984,96319,451,40521,68209
67132,146,56833,85303,124,58250,71306,22,0,164200
67131,108,64091,75330,96,59464,74168,12,0,0
67127,248,58750,61366,177,69327,73329,71,29107,31542
67124,3092,54781,72143,1846,69293,92808,1246,33000,39599
67123,332,51500,67754,239,60250,72577,93,46875,54728
67122,70,41700,67720,49,41950,78022,21,0,43686
67120,311,104083,99791,201,111161,112214,110,73750,77091
67119,536,49250,61218,356,78750,78920,180,18438,23006
67118,281,52344,84080,173,66635,71876,108,38125,103038
67117,790,71058,81962,460,95192,112238,330,23542,38612
67114,8516,56776,68608,5890,66964,81524,2626,29408,36876
67112,91,80893,81169,76,82500,89720,15,0,37847
67111,102,55556,64567,68,80500,80787,34,28000,32126
67110,3171,67542,79880,2477,81533,87833,694,29944,42059
67109,166,56806,63175,96,68636,74572,70,47500,47537
67108,552,75500,85687,423,82292,95625,129,43125,46737
67107,1344,51016,62631,813,62039,76667,531,32476,40895
67106,179,0,73628,163,0,77839,16,29500,30731
67105,79,65313,62616,61,65938,63580,18,0,59350
67104,919,48110,64639,511,67625,71666,408,33214,55825
67103,76,85804,79429,58,86607,95305,18,30938,28267
67101,2089,59824,86349,1452,85330,102271,637,27610,50057
67074,499,68295,79023,346,81818,75994,153,32829,76731
67073,123,51806,61195,91,61719,66514,32,44444,44869
67072,167,0,34083,135,0,38767,32,16250,14316
67071,63,0,58827,63,0,58827,0,0,0
67070,447,55417,68467,312,66000,72077,135,21250,57408
67068,1893,52160,73178,1113,64583,83089,780,40543,54164
67067,705,97542,102862,540,104773,114803,165,59926,60157
67066,153,49570,55932,118,49091,55178,35,50568,50903
67065,113,62125,71899,78,85658,84524,35,50368,43354
67063,1455,52697,64080,922,68472,79384,533,23727,33317
67062,1615,53872,80768,1061,79583,103537,554,43193,37162
67061,46,0,48854,21,59063,79448,25,13977,23160
67060,5531,57565,67399,3600,75422,82565,1931,33996,36898
67059,304,60000,68546,197,69250,75864,107,39688,55073
67058,884,53750,71670,537,80893,93239,347,37664,36034
67057,105,40781,55519,66,57500,71956,39,0,27331
67056,1167,61984,68908,890,73750,77095,277,31719,36141
67055,35,0,75349,20,0,0,15,0,0
67054,522,47000,60197,296,63646,75733,226,23971,39848
67053,260,53750,100622,169,75417,74950,91,40781,145308
67052,2545,98646,115105,1987,108732,131161,558,40833,53205
67051,171,43750,54329,111,56250,66042,60,28750,29918
67050,696,95536,120470,572,108864,135072,124,38750,49877
67049,40,36667,44373,37,37589,44965,3,0,0
67047,315,43618,56927,209,60107,66656,106,27857,37744
67045,1420,39688,56656,889,56185,72929,531,23583,27473
67042,6815,46151,58190,4083,73365,76641,2732,19852,28869
67041,87,61250,78876,77,68250,84818,10,0,33120
67039,1119,71681,88391,842,90417,104361,277,20078,32170
67038,301,48958,57920,235,54375,65347,66,0,28321
67037,10744,74833,87731,7961,88920,99602,2783,40696,50650
67036,69,48625,75219,47,34676,65779,22,51111,95386
67035,392,58929,106898,281,71442,129742,111,35795,44505
67031,969,62279,76197,674,79500,92548,295,36675,34313
67030,816,84306,103574,700,92955,103729,116,49167,83553
67029,505,44904,57058,219,79250,83106,286,30238,35679
67028,151,59602,70324,101,63935,80044,50,57625,50690
67026,1719,97656,95780,1361,101406,102719,358,32143,59047
67025,1311,78021,94535,982,88906,107780,329,36250,54437
67024,412,37273,51700,268,51618,61156,144,23500,32023
67023,92,37000,61075,60,58750,77428,32,0,30413
67022,759,40850,54964,365,63295,77058,394,19722,32115
67021,18,0,65528,9,95625,98922,9,0,0
67020,559,59323,64107,400,72500,76118,159,28092,32011
67019,357,75208,74686,262,81250,84692,95,32375,43781
67018,43,0,55330,35,0,46671,8,0,93213
67017,804,79500,90067,610,94167,100639,194,30217,52512
67016,162,48750,68060,126,56250,71040,36,31250,45236
67013,1346,60395,71660,902,83065,86524,444,32083,40806
67012,21,0,0,0,0,0,21,0,0
67010,5715,64320,81846,4263,84308,93494,1452,32861,45652
67009,357,37228,53404,255,43194,54766,102,35139,46049
67008,299,41563,69810,190,49091,77067,109,24958,56943
67005,6378,50044,59509,3717,59440,70802,2661,31236,38681
67004,319,61328,64053,230,67500,73750,89,24896,38993
67003,969,47292,58288,578,56250,70323,391,33125,37297
67002,4977,95422,112506,3874,109316,125209,1103,32194,65994
67001,532,81667,97384,447,93438,105354,85,53274,54838
66970,40,37188,77780,37,48125,82616,3,0,0
66968,613,47050,56628,356,55156,67261,257,30924,41115
66967,876,41620,64409,603,60972,77764,273,22981,34005
66966,331,51611,67029,182,68125,90955,149,34792,36330
66964,68,49375,47384,48,60543,55646,20,19167,24330
66963,95,41875,48113,65,48036,51849,30,35000,35017
66962,112,60682,65858,82,61818,77355,30,25500,26300
66960,57,47813,55054,37,65536,55903,20,44375,41180
66959,88,53750,59390,57,67250,62042,31,38125,54513
66958,116,70530,69204,61,75139,81374,55,70417,54040
66956,526,35455,65068,311,63424,88910,215,20893,30089
66955,53,0,62030,25,72188,98572,28,28864,28539
66953,275,55417,65069,142,59375,81138,133,44219,47912
66952,236,41012,56443,133,49821,70232,103,40030,38637
66951,302,50167,59531,230,57500,68804,72,25714,29835
66949,300,48409,56410,169,51985,65473,131,24659,44282
66948,185,63661,107045,114,79286,142506,71,39044,49090
66946,102,0,88591,50,0,87260,52,0,89037
66945,358,55000,65401,230,71250,81737,128,25417,33816
66944,128,62333,104676,120,62333,105140,8,23750,23738
66943,245,47981,47508,151,53977,59312,94,20833,28546
66942,104,30417,36292,68,30833,37221,36,24500,34539
66941,56,21250,23782,18,46250,38317,38,0,16897
66940,184,33750,46384,103,57813,61369,81,22216,27328
66939,189,66250,82257,142,69559,98523,47,25625,33113
66938,443,51094,62540,307,66016,68390,136,36250,44465
66937,360,46111,65095,213,65156,65886,147,28125,61222
66936,137,30114,41847,92,31875,49924,45,17292,21478
66935,1065,47358,56553,610,66591,72029,455,27841,35267
66933,147,40980,46983,70,42083,59494,77,34792,35382
66932,33,51563,47100,27,51563,48867,6,0,39150
66930,109,44625,66237,91,36406,50496,18,115714,104772
66901,2512,47437,58700,1527,59146,68376,985,30503,37135
66873,121,42917,54728,87,51250,62684,34,26250,33453
66872,403,42109,58345,276,51957,72582,127,22250,26103
66871,608,59904,73045,419,87054,89000,189,33520,37388
66870,63,41875,57448,44,60833,70607,19,31250,26974
66869,293,45819,52918,168,68750,70718,125,16940,28996
66868,347,78036,86222,242,91774,102122,105,0,49117
66866,664,48923,58946,445,57277,70962,219,30729,33139
66865,473,83250,78256,329,92426,92299,144,35313,44903
66864,153,51161,58818,87,68594,67763,66,33667,36292
66863,22,0,77532,10,0,0,12,0,0
66862,49,0,41951,15,0,65647,34,17308,31497
66861,1265,51090,59503,751,66860,71259,514,40798,42013
66860,537,48365,75004,357,77708,98438,180,25543,26239
66859,87,44688,49820,67,61750,59176,20,16250,18475
66858,145,44375,57408,86,56667,69424,59,39013,39892
66857,552,50000,67315,341,61382,73122,211,28750,57115
66856,760,68750,78168,502,73889,92355,258,32500,41458
66854,274,51786,63659,178,81875,80541,96,22500,31038
66853,209,41979,85988,142,49583,108624,67,25750,29130
66852,275,66339,74421,189,80536,86079,86,35000,43729
66851,237,31250,56812,138,63056,77661,99,21875,27749
66850,102,59063,185825,82,0,222151,20,43750,36890
66849,182,68500,107397,133,108750,135475,49,37574,30669
66846,1342,57500,71445,907,70072,85501,435,26012,36713
66845,475,55168,62080,344,57500,73531,131,23646,30790
66843,74,45750,50019,30,41458,41507,44,73077,55823
66842,174,83125,98235,123,95250,121619,51,38807,39341
66840,182,63929,67069,159,67841,71312,23,32750,34213
66839,1494,57609,77336,1043,73750,90225,451,29063,39233
66838,75,0,54992,70,0,56734,5,0,0
66835,479,60250,71904,326,74881,91587,153,16477,24688
66834,383,52026,61329,241,66806,71759,142,40000,41732
66833,234,47083,56064,181,51250,61891,53,32917,35098
66830,91,46394,56909,76,47100,61839,15,31250,31927
66801,11600,48583,64413,6276,67279,83776,5324,27849,39546
66783,989,45040,64002,570,70870,80366,419,32933,35973
66782,48,33750,40594,29,47708,47266,19,19125,30247
66781,420,42734,53839,201,53281,65178,219,35078,43036
66780,211,61458,67783,159,66875,75321,52,46300,43238
66779,243,48882,64191,162,53750,76932,81,17750,38060
66778,0,0,0,0,0,0,0,0,0
66777,238,31429,46034,153,43631,50746,85,12188,33351
66776,569,47470,64092,468,60769,66956,101,20313,45425
66775,75,0,56687,35,85903,68766,40,0,45558
66773,256,49318,63071,165,60156,74078,91,21719,42802
66772,64,47500,53342,30,61250,70183,34,0,34194
66771,366,80268,79790,256,85357,89407,110,30278,57268
66770,354,44500,61423,235,60114,70284,119,32875,39028
66769,191,64063,59879,159,66563,66592,32,17500,17366
66767,212,43750,54319,134,51875,72112,78,16852,23750
66763,1360,51563,64742,1001,64330,74976,359,32216,32857
66762,9958,39390,55098,5650,55561,71211,4308,22780,32974
66761,95,49688,70573,71,55250,75610,24,41591,38538
66760,0,0,0,0,0,0,0,0,0
66758,104,41667,50442,70,46389,60379,34,20500,29988
66757,1373,55179,66465,992,63822,68330,381,26625,60258
66756,446,42819,56830,305,60156,68618,141,14750,20616
66755,370,56000,57308,224,75472,75618,146,24000,28491
66754,136,54688,48814,106,63068,54300,30,13929,17430
66753,445,60043,68839,317,65841,83343,128,23125,30993
66751,249,34635,43361,169,44028,49599,80,25625,27639
66749,3005,46712,54515,1880,57045,66153,1125,27091,32923
66748,1260,50455,61583,829,61473,73357,431,27440,38481
66746,66,38750,46562,46,36667,48474,20,29375,38410
66743,1693,44397,59765,1177,50912,67424,516,27778,35469
66741,72,105192,95813,61,106250,110741,11,0,0
66740,83,78594,87735,78,79375,89253,5,0,0
66739,2187,38784,53804,1349,56103,66798,838,23190,31741
66738,117,71250,75545,82,83611,88348,35,45521,43151
66736,1578,49894,67254,1007,68520,86175,571,21964,31287
66735,204,33333,38344,174,46944,42599,30,0,0
66734,77,41250,50983,56,46389,63918,21,0,0
66733,926,49133,56987,560,60658,72974,366,17391,30838
66732,80,53125,71748,59,54886,87232,21,18750,25205
66728,25,26094,22456,8,0,0,17,0,0
66725,2362,43333,54409,1507,57850,67386,855,17144,30735
66724,386,50200,60248,233,57446,65492,153,23482,51865
66720,4509,48531,59405,2960,62168,69585,1549,25114,36111
66717,236,60417,57321,181,65337,64660,55,22031,25495
66716,147,60250,66828,90,62500,70209,57,0,58132
66714,80,39750,50168,57,39625,49047,23,0,52943
66713,2071,41481,53958,1271,60250,68928,800,23974,28808
66712,762,40952,61708,464,69750,76879,298,23000,36773
66711,260,35625,45066,172,46419,56065,88,15909,20064
66710,221,33162,57303,140,56875,65419,81,21827,42109
66701,5006,44369,56977,3172,54483,65784,1834,23056,39643
66622,0,0,0,0,0,0,0,0,0
66621,0,0,0,0,0,0,0,0,0
66619,872,59193,61061,715,58867,58606,157,42109,46855
66618,3738,93786,97717,2987,99681,110289,751,29341,40924
66617,3340,80391,86895,2646,85194,91484,694,41645,65787
66616,2514,40663,50450,1445,48780,55819,1069,33833,41157
66615,1376,72176,119181,740,125083,176987,636,44259,51808
66614,14368,61189,74463,8599,80925,92589,5769,37132,44945
66612,1193,25525,31663,356,44444,51463,837,17677,21689
66611,4442,47839,64349,2156,76373,84032,2286,36360,43346
66610,4283,104471,139748,3256,124110,162180,1027,45085,58187
66609,2875,55876,70838,1635,74083,86158,1240,40929,47658
66608,2072,46845,49180,1197,53839,57076,875,27299,35818
66607,3439,31484,37785,2038,39631,46254,1401,20243,24293
66606,4851,50214,67299,2391,64991,87144,2460,34138,46657
66605,7557,55239,67158,5398,66093,75980,2159,35086,40785
66604,9961,53810,69913,5421,63517,80352,4540,41172,53326
66603,710,25455,31827,184,38021,40727,526,18172,27466
66554,254,70000,96641,189,87750,110941,65,52656,50629
66552,183,65446,65091,127,74583,77628,56,30833,33261
66550,185,76750,89492,145,79205,99648,40,39286,51535
66549,719,65571,76741,465,67981,89592,254,54063,49592
66548,339,59514,75600,238,68971,92626,101,28533,33931
66547,3268,65132,80818,2234,88431,97732,1034,31174,40587
66546,412,79917,112240,322,84931,129462,90,43889,50622
66544,149,50156,53926,116,67976,61470,33,16607,27409
66543,436,76944,85146,282,92222,101796,154,49375,54656
66542,1131,87984,103782,971,89484,110545,160,60735,62739
66541,85,49625,48555,56,52083,55843,29,0,31814
66540,239,50739,57937,126,63421,78741,113,0,34680
66539,1037,69875,89118,723,87042,104726,314,46638,52096
66538,1261,59844,76414,890,75357,91519,371,32993,37754
66537,459,62337,81131,300,69808,101939,159,37292,40117
66536,1142,71047,80926,906,82368,89430,236,33917,43223
66535,1163,71370,87989,857,82036,108450,306,21806,29020
66534,1643,58393,80250,997,85907,111765,646,25968,30823
66533,562,67500,82858,405,98250,101332,157,27188,33650
66532,289,64063,86925,214,67500,95962,75,0,57816
66531,665,66181,86908,523,83304,100514,142,28500,36254
66528,318,50625,53516,219,59338,61550,99,0,31398
66527,92,40500,56377,62,40833,61466,30,30000,41853
66526,291,68224,81343,225,71509,97622,66,25897,25848
66524,866,63707,71179,618,73015,81308,248,35625,44185
66523,1599,51648,60123,1051,59598,68857,548,28673,34125
66522,79,21273,28328,22,0,47700,57,21273,20663
66521,669,60272,70575,451,76484,86872,218,26667,35638
66520,293,62457,76495,213,84375,90420,80,40938,38991
66518,101,63568,59445,36,69375,69819,65,63411,53698
66517,636,41190,47128,418,48864,54412,218,25227,30491
66516,115,55938,55194,82,63125,64335,33,26250,31000
66515,122,60909,71694,92,64500,83211,30,34583,36077
66514,585,73938,82442,371,97596,106685,214,43214,40334
66512,1093,62458,87943,782,95298,109390,311,30982,31914
66510,305,53438,61562,206,81944,73614,99,23750,34154
66509,1014,60338,65937,793,62408,68587,221,27011,51914
66508,1866,44601,67427,1096,68333,88340,770,31364,36084
66507,428,76857,81758,339,80417,86619,89,37083,59425
66506,0,0,0,0,0,0,0,0,0
66503,7033,82157,113344,4787,111850,141858,2246,42176,47488
66502,17364,45942,59861,7597,70913,82230,9767,33579,41382
66501,121,54479,72098,90,61667,79066,31,31563,48042
66451,649,58450,72610,451,71488,83453,198,28333,33657
66449,452,65735,94702,292,72500,111004,160,30917,64941
66442,3524,43494,49092,3168,45085,50587,356,30577,35417
66441,10551,51950,59940,7134,59783,65814,3417,38914,44250
66440,799,56698,71605,528,66293,83297,271,47083,48483
66439,1055,43967,54733,714,53500,58867,341,26146,41596
66438,62,52250,70000,45,78194,83411,17,31750,34494
66436,2596,59795,73860,1682,81040,92045,914,25208,34978
66434,1834,52404,65062,1182,69032,77698,652,35366,40307
66432,156,89583,77863,86,54750,72283,70,103011,84719
66431,218,69231,76011,156,80625,91713,62,27857,35105
66429,188,67500,69918,135,72208,84839,53,35625,31911
66428,92,73958,80690,80,86250,86141,12,0,44342
66427,445,64125,79439,308,83438,95604,137,40125,41455
66425,220,51364,53580,137,64023,63810,83,35170,32892
66424,187,49940,71148,133,61250,87413,54,26250,31089
66423,362,55893,66738,271,64583,77582,91,26250,32884
66422,274,61094,68272,239,61396,73901,35,0,23811
66419,160,62500,65125,68,84559,93507,92,38750,43224
66418,195,72188,81852,154,85000,87576,41,23625,59737
66417,149,76484,81994,107,67188,85812,42,0,59683
66416,210,54250,65569,164,68750,77327,46,20938,23650
66415,335,72898,77873,254,81250,89712,81,29688,40369
66414,1220,65000,79088,828,78235,89104,392,35694,53097
66413,835,56691,66073,513,71328,77968,322,27826,43992
66412,79,58304,63643,48,68864,77996,31,52847,41419
66411,509,48542,62160,317,71063,77841,192,29063,32869
66409,1447,85257,103160,1176,90000,105288,271,57344,89700
66408,114,102813,138676,95,114375,150037,19,82708,70605
66407,140,46894,61621,39,77188,97523,101,46098,47481
66406,237,38021,39631,93,54375,57418,144,0,25988
66404,162,54000,74556,126,64286,86221,36,30625,27511
66403,327,64464,77327,243,76130,78779,84,37500,72402
66402,1126,73000,116102,843,87527,135939,283,31875,54923
66401,750,69167,84035,514,91875,100987,236,33871,46828
66227,2520,108611,139689,2002,140417,160124,518,56406,60709
66226,4663,136094,148829,4151,143281,157597,512,66500,74901
66224,4643,159818,224360,3491,192772,255245,1152,80045,129553
66223,10114,99689,130199,6782,118306,150512,3332,67869,85780
66221,5976,162056,190401,4879,186530,213448,1097,70123,77164
66220,2674,152804,196281,2288,171786,212386,386,84167,99198
66219,6234,82717,99777,3579,119088,128587,2655,48252,60770
66218,2482,131527,148860,2205,135964,157175,277,68930,80442
66217,2613,68231,116811,1627,113625,152877,986,48258,57247
66216,9079,98979,125522,6751,108018,140799,2328,63596,78241
66215,11089,76121,90788,6780,93735,106527,4309,49753,62508
66214,5328,62292,83782,2909,85580,98822,2419,42446,63436
66213,11879,103418,122479,7985,133093,148359,3894,55089,66602
66212,14989,65537,80743,8534,83000,99338,6455,44489,53782
66211,2373,115722,228304,1584,170125,301244,789,61733,81869
66210,8890,79576,101198,5151,104826,121128,3739,54180,71365
66209,8569,124564,183869,6022,177000,227216,2547,55325,80771
66208,9162,96691,157169,5570,133773,204838,3592,64856,81557
66207,6304,96472,134650,4022,127000,165076,2282,65833,80178
66206,4540,145077,194876,3316,160722,226182,1224,89300,109644
66205,6210,83013,123091,3536,106224,159505,2674,55000,69813
66204,8634,61268,75154,4014,84605,93938,4620,47528,56064
66203,7742,62724,75763,4647,76002,85834,3095,44809,57511
66202,8193,62760,79496,3730,87701,102708,4463,49179,59187
66118,0,0,0,0,0,0,0,0,0
66115,0,0,0,0,0,0,0,0,0
66112,4759,52831,61532,2961,64434,69696,1798,30800,39979
66111,3830,56339,65609,2705,63074,71326,1125,36050,42407
66109,8862,80546,93213,6232,98478,106871,2630,46855,54390
66106,7824,50328,61759,5446,55751,68132,2378,34184,40379
66105,923,27445,35927,512,33676,41441,411,17414,25962
66104,9530,42944,51417,6278,50266,59789,3252,21726,30528
66103,6141,43581,53195,2617,55754,66952,3524,31301,40311
66102,10372,35837,49262,7067,41825,54166,3305,22947,34531
66101,5078,30032,39967,2826,37222,45383,2252,19129,27008
66097,546,59297,68742,337,82768,83134,209,43750,40596
66095,357,56811,58659,220,56250,57538,137,56676,59742
66094,127,37083,49272,77,54250,57206,50,23333,34486
66093,231,81250,82432,217,81369,84196,14,0,53650
66092,1490,72100,87036,1068,95200,104843,422,37292,41005
66091,194,59107,68742,101,0,101378,93,0,33300
66090,1134,53143,62138,665,63277,76383,469,30650,36776
66088,1073,67578,81057,760,82875,98604,313,33375,36690
66087,884,45000,67664,599,73512,80401,285,22232,40325
66086,3746,81160,94876,2648,97900,109406,1098,46521,54879
66085,3442,144514,169261,2951,162132,185111,491,57813,67054
66083,3596,96274,130289,2978,109511,139811,618,39737,72412
66080,325,63958,73399,243,76250,83619,82,32115,40193
66079,334,58958,57941,214,67206,76920,120,25000,19517
66078,378,62045,75833,286,73452,89532,92,33125,32215
66076,847,61469,71776,664,69231,78819,183,37981,42356
66075,1034,47500,61111,671,64468,79762,363,14013,23893
66073,1075,66438,76301,811,72524,83610,264,46944,50660
66072,568,54167,103913,417,76875,113345,151,21875,75319
66071,5353,69400,86170,3714,86350,105568,1639,35579,41802
66070,904,93696,93437,729,105750,107900,175,27768,31411
66067,6413,49688,62530,4124,63600,74501,2289,30188,37981
66066,1121,65991,92650,761,67134,108928,360,37000,52303
66064,2354,57386,64590,1594,62900,72720,760,31071,40395
66062,29174,104821,123055,22062,114808,134461,7112,58251,80965
66061,22360,92096,110745,17189,102150,124077,5171,46940,59345
66060,492,67458,88802,379,74531,92661,113,38750,59573
66058,118,61250,72914,76,68500,92058,42,30625,38155
66056,624,46042,57054,412,68889,68588,212,28393,31037
66054,1020,52324,73922,734,79773,87804,286,24137,35611
66053,2656,87984,99739,2051,97552,111142,605,50780,57378
66052,785,66927,88191,644,65000,92729,141,28068,43150
66050,841,88125,101732,645,97225,111047,196,42000,61092
66049,13689,77304,102162,8214,114230,134986,5475,40088,51645
66048,13609,61842,81285,8845,82851,97953,4764,33737,45316
66047,8742,58536,81586,4512,90376,112938,4230,35413,46139
66046,8298,50066,63775,4359,71737,80818,3939,34773,41046
66045,0,0,0,0,0,0,0,0,0
66044,11241,43821,63495,4616,70243,91786,6625,30896,40935
66043,3099,86292,108981,2472,95233,117639,627,53317,73182
66042,254,44412,57142,150,61250,70581,104,30000,35989
66041,362,44583,50901,177,64625,63942,185,28274,36797
66040,1569,57841,66710,1146,68400,71367,423,31250,41311
66039,237,43843,50394,169,48125,53463,68,33382,42663
66035,244,67083,76148,171,79063,90354,73,30625,42870
66033,299,50739,79283,243,51989,81266,56,23750,66484
66032,2003,54092,65177,1396,66923,78413,607,22894,32849
66031,0,0,0,0,0,0,0,0,0
66030,8198,79563,89071,6240,88211,97922,1958,42438,53108
66027,1497,96408,97944,1379,96432,95445,118,0,125844
66026,240,65357,75096,176,68000,70694,64,58750,81294
66025,2650,86293,89376,2060,88446,93699,590,46458,65199
66024,292,37857,46346,201,51023,47706,91,19526,30684
66023,396,45435,53988,225,59531,70778,171,27880,31481
66021,1013,75750,94446,744,85000,104867,269,43641,51061
66020,485,76106,81290,387,80216,94091,98,0,27728
66019,110,0,29132,55,50691,44024,55,0,0
66018,2271,70705,92393,1679,94097,106391,592,31552,50518
66017,174,67500,64131,104,88077,88291,70,28750,27301
66016,173,77344,90100,152,96429,94063,21,58036,61419
66015,285,39750,47082,178,54286,58985,107,21094,26067
66014,210,0,60228,183,0,68597,27,0,0
66013,658,129688,153108,607,133125,162427,51,45089,42196
66012,4468,75824,86498,3395,81737,96664,1073,43234,51267
66010,374,44909,66868,253,58194,85374,121,0,27331
66008,100,81250,75102,56,115938,107111,44,0,34364
66007,2578,86754,98744,1900,94152,112111,678,37885,59439
66006,2622,77418,89428,1999,87889,100210,623,37031,46040
66002,4778,49880,63047,3173,62086,74206,1605,28988,38933
65810,9358,72038,96048,6664,92429,114742,2694,38917,48366
65809,4519,84766,127365,3201,109770,154640,1318,28538,56572
65807,26557,42053,55587,13089,57150,69435,13468,29689,39913
65806,7132,21325,29769,1923,31155,43640,5209,16494,23782
65804,18828,50805,72440,9903,73498,96151,8925,29120,44544
65803,18070,39113,52670,10270,53061,64962,7800,25618,33553
65802,19446,40509,53997,11274,56643,68608,8172,23643,31014
65793,2325,34261,47253,1534,44592,54352,791,16721,33480
65791,1905,38082,47390,1374,47461,54495,531,23463,27495
65790,279,0,38516,133,37697,40930,146,0,36317
65789,688,32500,50321,590,38417,54921,98,14886,18232
65788,146,44167,67617,86,55208,100116,60,20729,21035
65787,602,67875,65417,453,72102,74270,149,33542,38503
65786,746,42448,66417,522,57300,82233,224,0,27538
65785,2232,39141,55415,1351,55461,72062,881,21576,29147
65784,10,0,0,10,0,0,0,0,0
65783,56,38281,38009,6,0,0,50,38047,0
65781,3098,71438,74727,2411,79868,83514,687,30179,37312
65779,787,31932,36377,374,48571,47238,413,24406,25974
65778,216,22000,37783,145,44028,50763,71,0,9435
65777,98,25000,24993,98,25000,24993,0,0,0
65775,9963,41062,52752,6523,46576,61765,3440,28031,32335
65774,521,27210,45791,289,43250,66143,232,18409,20441
65773,255,40938,53391,180,60370,63781,75,25721,28455
65772,844,45625,54486,517,52467,65139,327,28155,34297
65771,547,75018,71475,488,75441,74965,59,28355,31022
65770,1122,56136,77075,829,72125,92633,293,25536,32276
65769,1076,49662,53605,788,53147,55871,288,38782,43208
65768,179,19353,43551,97,0,64813,82,12300,18400
65767,828,46750,60255,587,64356,70625,241,20817,31802
65766,40,61786,71693,35,61339,68806,5,0,0
65764,431,29464,62084,261,36058,85562,170,20000,24624
65762,150,37500,43908,109,43438,48575,41,21250,29798
65761,619,22917,36392,354,31548,42014,265,16705,28348
65760,359,39816,43549,236,51196,53482,123,0,24491
65759,471,44583,50637,315,51813,61815,156,20536,23514
65757,2818,64386,74485,2094,71267,81896,724,38644,48874
65756,283,93043,83561,157,67171,83729,126,93409,80209
65755,263,64816,70214,258,57700,64169,5,0,0
65754,226,78167,156120,191,107721,182929,35,0,0
65753,1845,57366,66009,1510,58000,66790,335,40063,57193
65752,152,41016,59703,108,0,72268,44,25417,28864
65747,1695,38848,54544,1012,50385,61742,683,31321,43508
65746,2672,49255,55694,2028,56786,61190,644,26944,35956
65745,974,36196,43550,659,35917,46659,315,22804,30405
65744,35,53125,51714,22,62500,60636,13,45893,36615
65742,4968,63795,83765,3860,73315,90723,1108,32500,42921
65740,1453,38528,45776,942,42143,51278,511,28490,32468
65739,382,53611,73449,267,62813,88464,115,0,36496
65738,7791,56321,65007,5591,63049,70962,2200,35090,43219
65737,3126,51250,72969,2094,60143,89335,1032,31406,37760
65735,46,0,43396,36,0,51686,10,0,0
65734,1202,46855,62472,871,48194,65510,331,39327,36911
65733,254,28684,44524,146,44500,54219,108,0,31418
65732,437,35511,52995,256,87500,78871,181,0,16354
65731,117,48942,55874,97,48438,57076,20,0,0
65730,8,0,0,0,0,0,8,0,0
65729,102,0,108437,52,0,167773,50,0,0
65728,0,0,0,0,0,0,0,0,0
65727,87,49375,49185,60,62000,68957,27,0,0
65725,1202,61833,83041,932,74058,91764,270,50533,51874
65724,674,29636,35107,329,32396,42463,345,27992,28092
65723,1138,42763,56619,831,42875,60142,307,38239,41883
65722,547,54271,65261,449,61531,73039,98,0,25606
65721,12092,63349,81223,8597,74312,91960,3495,41151,47627
65720,391,31964,52015,325,32782,57314,66,24000,25920
65717,824,44556,67242,655,49063,74442,169,24417,34155
65715,8,0,0,8,0,0,0,0,0
65714,12544,67258,84139,9230,80141,97234,3314,32903,42214
65713,900,47717,61221,670,55375,67865,230,31071,36134
65712,3610,44984,60185,2330,58611,76149,1280,26667,30257
65711,3648,35927,48038,2637,41745,55213,1011,24016,26881
65710,479,60613,59561,306,61957,66883,173,0,46240
65708,4646,46023,72623,3344,61039,85973,1302,24302,32856
65707,748,49071,64793,553,61625,73411,195,31750,38273
65706,6330,57429,71200,4471,64523,78394,1859,44129,49053
65705,1546,49167,65451,1091,47461,74201,455,33523,39318
65704,1486,39552,47616,1003,46506,54742,483,23250,28236
65702,135,50959,49293,63,60804,60675,72,50192,39333
65692,496,38429,52108,388,40929,53541,108,0,46598
65690,90,24028,34427,33,0,58464,57,22708,20511
65689,2254,37882,59765,1571,53714,73873,683,25625,26152
65686,2370,57030,79726,1556,63986,82655,814,30089,69698
65685,255,33173,46127,208,40417,51366,47,25313,22943
65682,744,50455,64196,529,56940,74784,215,30417,36376
65681,924,50903,66953,614,53929,77434,310,0,43152
65680,453,36475,45582,292,43269,55000,161,28068,27288
65679,1298,42583,56640,882,66000,72051,416,12481,21652
65676,207,36298,34514,124,37115,42457,83,12083,14559
65674,1065,43738,96221,753,49750,116574,312,23900,28695
65672,3620,51429,60484,2750,56008,69607,870,26550,30032
65669,814,66689,75969,669,80096,84928,145,34276,33437
65668,830,31757,43848,476,44022,52953,354,24917,29142
65667,1275,37872,44089,825,43239,55951,450,16154,22248
65664,45,17125,29011,33,18750,33861,12,16000,15675
65663,925,45694,67105,719,49926,75250,206,32500,35886
65662,433,34969,56397,350,63250,66248,83,11607,14857
65661,994,29773,50946,675,37371,51110,319,20353,48891
65660,109,0,52417,108,0,51235,1,0,0
65658,717,62813,73232,481,88240,91933,236,25350,34334
65657,93,0,56520,89,0,58592,4,0,0
65656,1809,43723,58526,1370,50904,63369,439,40013,39158
65655,1249,26096,32067,732,29364,39161,517,23446,21895
65654,138,45000,51527,81,65417,62465,57,26094,35340
65653,2614,37757,52920,1605,50364,66149,1009,18860,28565
65652,1300,48802,67743,890,58106,61065,410,27300,81352
65650,505,39718,53136,424,44537,56860,81,35787,32096
65649,777,39369,67248,613,44402,77088,164,22083,29470
65648,1961,62589,81733,1650,75081,87528,311,35784,43527
65647,1089,51133,61101,875,55380,70381,214,14391,23079
65646,756,46875,68860,531,63576,82051,225,29712,37084
65644,789,58450,59775,543,58841,66122,246,41250,45765
65641,494,56204,69504,380,64565,76247,114,40385,47029
65640,311,54531,53902,278,61250,56139,33,0,35055
65638,254,54063,55987,186,71635,68924,68,11944,20600
65637,473,22402,53733,250,52800,62282,223,20747,44149
65635,189,70156,79945,157,71719,80283,32,65714,78284
65634,191,32670,34632,125,41375,36898,66,22292,29812
65633,1348,41859,55704,996,46290,59002,352,26250,41026
65632,900,49167,68710,647,63750,66097,253,29528,71616
65631,2228,66777,76677,1784,71019,83661,444,36042,42539
65630,152,90469,104500,134,91833,109436,18,64000,67756
65629,266,43571,49948,193,49821,58109,73,26442,25232
65627,336,49750,51363,210,49000,51891,126,0,48853
65626,810,39360,47479,577,39436,48769,233,0,34805
65625,3201,39233,66521,2254,52434,78812,947,22420,30941
65624,510,58000,65009,408,58810,67819,102,46964,52788
65623,6,0,0,4,0,0,2,0,0
65622,3464,34191,51646,2509,45229,61823,955,18255,24630
65620,78,65726,84065,78,65726,84065,0,0,0
65619,3249,68825,79260,2355,78179,90653,894,27280,47758
65618,40,59674,71383,33,0,0,7,0,0
65617,508,34674,59869,367,48953,71638,141,19464,29234
65616,11109,50259,65838,7297,54997,75585,3812,31278,44159
65614,187,50938,52304,139,57721,61996,48,12250,24235
65613,6733,43735,62122,4434,54851,74090,2299,25021,34823
65612,758,62606,65620,467,98787,91691,291,23678,23780
65611,1089,43618,49038,751,50069,57657,338,24569,29034
65610,1950,56061,74996,1448,70658,86311,502,25875,38202
65609,368,32227,42818,204,35326,38068,164,31442,48729
65608,3612,44892,56109,2521,53388,67515,1091,20913,28668
65606,1252,35308,41928,815,38520,48100,437,17891,28902
65605,5088,42826,58276,3482,52712,66995,1606,19739,34302
65604,1418,53333,68097,814,70104,81506,604,28214,49785
65603,70,53750,49023,70,53750,49023,0,0,0
65601,217,43203,53130,133,56563,57302,84,0,46005
65591,476,39821,50188,356,39821,53114,120,37500,36591
65590,442,40100,52255,232,73929,58642,210,39444,45198
65589,39,15481,16887,30,0,0,9,0,0
65588,885,32519,41237,587,41615,48356,298,21585,26370
65586,38,0,0,38,0,0,0,0,0
65584,4424,56136,67182,3198,67861,73704,1226,49271,48336
65583,4418,66100,72930,3024,88750,85642,1394,40769,43393
65582,982,46797,66334,656,61786,76799,326,21042,39794
65580,262,56553,66526,149,73594,84164,113,55360,43270
65571,739,23705,36817,533,27743,44386,206,12409,17234
65570,293,26027,41252,202,27062,53727,91,9246,13559
65567,710,29231,43744,362,62171,68815,348,12069,17636
65566,317,47181,53036,241,47370,56964,76,23750,37449
65565,2000,41119,52026,1346,45231,60987,654,27857,32507
65564,34,0,0,34,0,0,0,0,0
65560,6003,41730,53068,3902,51233,63886,2101,19154,30237
65559,3424,52648,65933,2495,60775,77580,929,19954,29521
65557,33,0,0,33,0,0,0,0,0
65556,2165,40615,66126,1194,52378,67833,971,33961,62533
65555,464,45455,49617,347,46831,55233,117,24191,28316
65552,845,66546,86684,691,72083,75451,154,0,127545
65550,1161,36750,53879,723,55638,68128,438,22083,27234
65548,2247,39539,47671,1662,48598,52892,585,17617,27491
65543,152,41157,56549,54,0,98452,98,40231,33459
65542,2135,34637,52811,1322,52500,63071,813,20356,31500
65541,117,0,103924,83,118869,135470,34,27125,26915
65536,11883,45364,56359,8345,55633,65274,3538,24677,32633
65535,524,45400,46975,374,46675,56050,150,14038,23109
65534,234,55071,50056,185,39137,45061,49,0,0
65529,122,88056,83076,122,88056,83076,0,0,0
65501,64,39091,55763,64,39091,55763,0,0,0
65486,1355,49535,74802,959,68393,92746,396,24457,28776
65484,31,0,0,31,0,0,0,0,0
65483,1893,34411,46489,1151,43936,57135,742,26698,28763
65479,84,40192,28542,43,43828,44567,41,25000,0
65473,1784,58598,70830,1234,68424,82783,550,36056,43001
65470,469,60428,67508,382,60486,67994,87,0,61331
65468,0,0,0,0,0,0,0,0,0
65466,733,36602,47517,499,52946,51837,234,23281,36632
65464,291,0,37192,176,58629,51788,115,15234,14854
65463,582,57248,58377,343,55746,60151,239,65585,52303
65462,641,42159,56578,348,70500,78422,293,21885,26688
65461,62,54643,51805,43,49205,50144,19,0,0
65459,2426,53333,68834,1725,63011,78611,701,28278,41727
65457,99,61438,81987,90,0,87810,9,0,0
65456,165,40469,49471,118,0,49459,47,57841,49500
65453,3685,44284,52994,2393,53958,61574,1292,19495,34446
65452,946,50952,63136,626,59524,76090,320,26250,35783
65449,145,0,48597,86,86190,66977,59,0,21803
65446,187,0,58257,141,68616,73548,46,10395,11389
65444,429,29875,45209,326,31442,46292,103,0,29366
65443,36,76250,88300,27,105375,93537,9,0,0
65441,2318,53200,90803,1534,57083,74172,784,46406,122238
65440,156,81250,67380,146,88333,70173,10,0,0
65439,55,0,51969,30,0,0,25,0,0
65438,984,31351,42413,681,37279,49945,303,16932,24990
65436,13,0,0,6,0,0,7,0,0
65401,13571,44134,61722,8074,61786,79254,5497,23765,33339
65360,1725,45300,60051,1200,48964,68938,525,24890,35347
65355,4749,38976,56666,3085,51131,69682,1664,24779,31070
65354,252,51316,78248,221,54125,86829,31,9313,13600
65351,832,51371,59683,592,65147,70116,240,28864,32839
65350,705,63162,70514,543,65954,75179,162,51700,49507
65349,1130,37784,48900,594,55903,68264,536,20208,26727
65348,570,43393,53805,324,59464,66978,246,31295,35684
65347,372,82000,71148,308,85346,72783,64,41875,58003
65345,152,52339,63657,128,52500,68570,24,0,37454
65344,76,75313,74557,52,78000,84431,24,0,40542
65340,5331,46463,61591,3216,63878,76412,2115,28132,36087
65339,155,56339,63008,114,65833,73201,41,17292,24993
65338,1188,44583,83267,775,57731,111203,413,20559,30437
65337,665,50515,59918,519,54226,65468,146,25217,35221
65336,2600,57172,71799,1561,78826,83724,1039,48278,49982
65335,65,22981,43098,46,0,39583,19,23375,51611
65334,442,55872,66892,366,56059,70358,76,46167,48166
65333,278,39167,63097,145,51458,73868,133,31294,41455
65332,612,55000,67885,513,62548,73152,99,32679,38854
65330,184,54375,60164,117,67917,72961,67,32688,37630
65329,119,0,68095,76,91250,95695,43,0,19314
65327,67,55250,62337,49,57250,68294,18,44167,46122
65326,845,40438,44649,477,51484,62349,368,16071,19558
65325,1151,49476,67762,817,67396,81164,334,15741,33555
65324,555,52604,69705,332,81081,92413,223,25469,34113
65323,335,49750,52301,214,56750,58199,121,27446,38960
65322,213,58250,61588,178,60625,63550,35,20313,29480
65321,166,58500,128756,116,92500,172576,50,22500,27094
65320,24,66250,67588,14,0,100693,10,22500,21240
65305,930,54500,61683,795,53292,62922,135,0,48927
65301,13171,47724,65327,8542,59574,73194,4629,31068,47312
65287,142,78158,79454,89,97083,95076,53,0,53221
65286,33,64583,71606,19,64327,77784,14,85833,63214
65285,201,80938,94094,156,83690,116097,45,25000,17813
65284,910,73571,86901,662,86458,97189,248,29375,50775
65283,294,42143,79860,249,42474,89088,45,28375,28802
65282,91,10670,22925,25,55938,58668,66,9583,9386
65281,1017,49410,57660,739,58613,67453,278,20625,29584
65280,127,43988,61903,111,44702,66376,16,0,25863
65279,725,68980,108662,521,90208,133401,204,32167,45187
65278,45,36750,43542,28,45000,55696,17,0,23524
65276,648,53125,60647,415,70938,76025,233,23264,29462
65275,1020,50000,63965,669,68563,74587,351,29688,37450
65274,629,66250,67390,488,71630,75212,141,21208,37886
65270,5966,46367,57329,3877,60458,66701,2089,24122,35497
65265,5919,43812,61921,3796,51092,70254,2123,31706,44333
65264,361,31563,62285,282,0,64026,79,27708,51872
65263,639,42684,51635,408,48281,60465,231,37554,35756
65262,271,56845,104407,193,0,123091,78,0,54886
65261,388,47024,55761,259,57917,66192,129,25875,34605
65260,138,51000,59520,96,65795,67720,42,33750,40774
65259,986,63250,66479,683,73601,75766,303,30430,43576
65258,238,48611,66575,167,74063,86465,71,16607,19792
65257,623,52240,59904,469,58750,65982,154,34167,38582
65256,548,75000,89877,458,82833,98101,90,33750,45534
65255,1547,53281,65749,1054,61364,72217,493,30625,38292
65254,754,58125,61626,504,66250,70877,250,41250,41584
65251,7284,56561,70799,4886,69032,79880,2398,31160,49158
65250,187,52031,67085,112,51250,61753,75,0,73525
65248,1478,53500,74228,1043,69375,88420,435,19779,33276
65247,256,60821,59124,173,61518,69182,83,22159,35578
65246,20,0,112765,15,135625,145040,5,0,0
65244,165,58625,54843,94,65682,62606,71,31141,36548
65243,739,51875,68594,548,63250,76657,191,50250,43556
65240,3408,60541,72435,2642,64960,81818,766,31100,35845
65239,726,61620,73584,490,75000,85279,236,60329,49031
65237,415,58287,64964,277,71250,75539,138,33889,38521
65236,548,37404,56867,303,69750,75395,245,22656,32415
65233,4075,51985,65594,2807,65221,77570,1268,29474,35910
65232,113,34375,44507,49,31964,42137,64,0,45919
65231,1334,53423,65656,1024,64135,73874,310,26394,32490
65230,215,43785,73415,115,52083,62372,100,43077,85484
65215,0,0,0,0,0,0,0,0,0
65203,24944,66310,95592,14973,96216,123245,9971,37425,52196
65202,18933,57756,70879,11955,69964,81047,6978,36574,47591
65201,17837,39364,60853,6623,71650,96592,11214,28638,38967
65109,16668,62024,80732,9866,80076,99595,6802,39082,50454
65101,10634,58504,73966,6796,81949,90105,3838,33571,42528
65085,514,64597,90592,364,82222,110266,150,36429,39609
65084,2391,38590,61614,1715,54201,74677,676,20917,27391
65083,64,53714,56845,49,54250,66076,15,0,0
65082,346,64474,96942,294,69750,106215,52,35714,39102
65081,1102,44167,49364,732,53125,59249,370,14231,26828
65080,495,63266,68341,295,58897,76020,200,63387,57015
65079,2098,45693,70384,1196,56667,89198,902,26843,44335
65078,1436,40815,46797,867,58125,57252,569,21629,28638
65077,178,52315,64563,130,58750,76181,48,0,33098
65076,289,63125,74186,189,83750,97837,100,15565,24978
65075,363,66477,104250,302,84063,115787,61,27813,44307
65074,1136,61855,65496,765,72102,74106,371,30685,42632
65072,689,48393,66344,481,83242,81536,208,25893,31213
65069,232,37500,53034,118,48750,72734,114,0,32360
65068,302,51000,70660,224,56786,69960,78,28750,69805
65067,198,58250,66850,132,85795,82067,66,33750,31262
65066,2565,53265,64702,1801,63250,77065,764,26706,32903
65065,2532,54692,72589,1682,75027,86293,850,34229,44553
65064,251,47841,65057,204,48409,66515,47,42188,58728
65063,1235,71023,76551,931,80806,84734,304,45375,46318
65062,8,0,0,8,0,0,0,0,0
65061,233,43542,53852,155,52865,58398,78,26667,43921
65059,431,56555,61132,294,56951,71343,137,0,36251
65058,402,42188,65308,162,81250,108327,240,27959,35970
65054,418,73182,255418,313,113092,328265,105,30804,38268
65053,637,86250,87032,492,91722,92798,145,65069,62401
65052,1405,66806,96031,1104,69939,104056,301,47112,56583
65051,1773,55148,65701,1222,71500,81012,551,23028,28269
65050,195,49554,74586,165,62596,82916,30,19500,27753
65049,3154,66271,86386,2063,68835,94859,1091,54017,67564
65048,59,73264,74295,59,73264,74295,0,0,0
65047,555,64539,86272,508,69219,90483,47,27986,38821
65046,607,70662,74254,440,78636,80145,167,29044,57690
65043,3978,67814,72166,2758,72893,79785,1220,38376,47310
65041,2389,61309,82342,1511,71458,93373,878,34397,61733
65040,438,41944,56937,285,62875,76028,153,10256,17729
65039,1077,105764,124615,809,124018,146679,268,0,55945
65037,2106,49375,86307,1130,76731,115658,976,32880,51545
65035,685,77950,81818,531,90625,94637,154,31500,37343
65034,388,40556,53717,344,42870,56810,44,30833,29534
65032,618,83360,102696,421,84738,94842,197,23688,118565
65026,4929,40222,50781,3032,56565,62799,1897,25244,27410
65025,259,42750,49924,168,50556,58619,91,28438,32825
65024,447,54306,65847,324,60667,66874,123,40139,59208
65023,723,62731,78737,500,90114,93509,223,39044,44862
65020,5637,52750,71649,4072,69701,83814,1565,25893,37086
65018,2920,64901,71478,2076,77647,80633,844,32098,42982
65017,416,30192,37469,215,49375,52233,201,16645,21677
65016,538,73500,81531,480,80735,86414,58,40833,41124
65014,1067,52128,63527,798,78042,75652,269,19650,25491
65013,1172,37946,50289,795,44135,57248,377,24338,32829
65011,716,39583,47597,568,45000,53961,148,11576,23176
65010,2531,81135,91350,1876,89114,105043,655,36791,48758
65001,123,59583,59754,75,85365,83289,48,0,21308
64874,217,38456,40645,160,51346,45578,57,15250,14837
64873,299,85799,89477,247,86865,98182,52,41250,46400
64870,5658,54442,62992,3992,61523,72318,1666,30833,32824
64867,478,49226,63759,358,67817,73487,120,35969,34153
64866,379,48538,50818,320,48602,51245,59,26641,34302
64865,1994,44154,54515,1479,55602,63387,515,24292,28166
64863,566,46500,57207,475,50032,61161,91,0,28563
64862,1434,46364,64403,933,66758,77904,501,21528,36766
64861,334,0,75858,294,103636,82144,40,27857,23878
64859,504,43125,55911,404,48245,62943,100,16974,26888
64858,195,0,0,195,0,0,0,0,0
64857,152,52727,53899,95,67614,65257,57,0,34437
64856,1474,40904,49191,1110,52843,56809,364,21395,24409
64855,913,60114,79323,622,69615,94009,291,42422,44375
64854,1447,33315,45669,1021,43309,47205,426,17015,23599
64850,8647,49299,64539,5626,59937,76739,3021,31720,38585
64849,75,73542,61792,63,74792,64514,12,33500,45375
64848,194,46053,58375,117,62639,73888,77,0,29157
64847,171,29107,40067,103,37917,49262,68,18750,26140
64844,1821,44199,59064,1363,59021,70064,458,21042,24943
64843,1268,48074,65866,1010,47866,69262,258,28750,37966
64842,334,52273,87655,266,59015,102713,68,21800,27284
64841,156,67500,60534,90,71458,65810,66,37500,41168
64840,1152,60500,70671,851,64679,77102,301,39653,49724
64836,8921,46900,62511,6118,56458,71743,2803,32197,37604
64835,766,38214,50475,538,56042,58117,228,27656,28459
64834,3417,62246,82426,2565,74063,91858,852,38077,43230
64833,19,36250,39711,10,44375,52450,9,23906,25556
64832,395,88393,81776,299,91005,90725,96,48281,52907
64831,2508,53320,65702,1912,50882,59281,596,42073,80354
64830,304,47000,51015,215,56901,62822,89,14250,18521
64804,14463,51921,81609,9372,65617,102484,5091,30233,39473
64801,15535,44357,57946,8933,58221,71292,6602,26705,37766
64790,390,35263,48718,251,43250,61979,139,21344,24604
64788,674,58529,82864,435,78079,86258,239,40781,73921
64784,510,43846,56897,335,62708,67035,175,24112,33343
64783,324,36582,50491,180,49375,52461,144,31250,48029
64781,45,41250,78953,33,70938,97221,12,31429,28717
64780,172,47500,53467,134,49333,58506,38,21667,34779
64779,960,41667,54737,708,52500,62818,252,21375,30992
64778,187,57109,62092,142,70750,67588,45,27083,31580
64776,1645,39417,53242,1061,54583,61584,584,28333,35133
64772,5682,43964,60399,3395,63096,76682,2287,29497,35478
64771,194,54464,62344,134,72778,72341,60,39286,38150
64770,546,54348,67304,387,69583,74450,159,20972,44457
64769,299,27386,49238,157,66250,69780,142,11648,25061
64767,273,40438,53313,171,53603,69411,102,18250,20105
64765,8,17500,22275,2,0,0,6,12500,14900
64763,629,40288,52763,307,57841,73872,322,30268,32114
64762,667,47019,55863,464,61731,67140,203,18173,27756
64761,529,53750,64630,364,66944,77646,165,28393,33541
64759,3066,42780,61740,2072,51161,70209,994,23636,39307
64756,261,45523,56344,202,46136,63418,59,21125,29363
64755,995,65681,72737,735,70096,82970,260,28125,41117
64752,245,53516,66193,177,56875,73823,68,25833,42366
64750,163,30139,52242,129,37708,56675,34,24239,35421
64748,670,45441,55479,450,52500,67179,220,17027,28255
64747,1557,59566,77812,1163,71985,89169,394,35147,39959
64746,603,63358,78531,353,81406,83282,250,42813,64906
64745,23,45625,59561,22,45000,59395,1,0,0
64744,3089,36993,46250,1911,42335,57013,1178,23040,28503
64743,81,37292,48178,51,36458,51935,30,0,38357
64742,893,61637,77530,678,70370,88402,215,32569,36652
64741,78,28958,39313,46,41458,53233,32,17308,19303
64740,804,42667,53996,523,54083,66801,281,20078,28103
64739,343,68625,80090,249,96705,92637,94,44250,46582
64738,542,39324,52847,353,53393,66743,189,0,24020
64735,5587,46452,63558,3434,56528,75813,2153,26596,40802
64734,887,91042,102722,705,104375,109539,182,46250,67791
64733,479,62668,74609,362,62561,81024,117,52188,50731
64730,2827,40047,64702,1776,59071,86181,1051,20938,25417
64728,188,50500,56348,140,58750,64031,48,30217,28315
64726,153,57969,58682,100,66154,64915,53,24006,26568
64725,814,59500,73663,625,64958,79976,189,29219,43670
64724,785,40511,56708,496,53889,69952,289,24375,28000
64723,339,46563,70849,205,91250,89955,134,35938,34597
64722,159,64750,67908,120,73000,76863,39,34688,38803
64720,1591,51446,67560,1113,72292,80949,478,28670,29601
64701,5644,54854,70944,3615,71507,84432,2029,38631,42708
64689,204,55833,74411,162,62500,75311,42,31250,50743
64688,215,53843,70949,148,76184,89471,67,0,27593
64686,118,63889,72872,95,75104,62873,23,21458,114178
64683,3111,47793,65648,1782,65000,73851,1329,25379,53048
64682,174,60357,57970,123,61356,69219,51,0,29657
64681,49,49375,55008,34,59000,65238,15,21250,23393
64679,332,41719,61411,216,65833,76821,116,14556,28459
64676,79,63563,66530,54,71250,85313,25,29063,25960
64674,132,58500,62792,81,73542,75953,51,17708,41737
64673,853,50903,58539,496,73074,73059,357,27697,36473
64672,55,36406,38896,17,63229,49835,38,35568,30432
64671,751,60039,72894,533,68920,86371,218,38250,38294
64670,314,48750,55221,218,55833,63877,96,17500,27971
64668,646,54732,70123,495,56705,75264,151,34306,41277
64667,117,40250,51444,88,41500,56242,29,26875,29776
64664,134,66389,66099,92,68750,74443,42,36250,42293
64661,382,43100,54986,236,55250,71994,146,20640,26386
64660,169,59250,92105,126,73167,110156,43,31250,37109
64659,410,62000,76059,328,66250,80263,82,28750,54982
64658,1243,53417,73704,853,68880,89364,390,28409,34003
64657,169,75781,85875,141,81250,94776,28,0,34946
64656,127,47875,56272,89,49625,60682,38,0,45345
64655,85,0,181199,60,0,217967,25,0,92956
64654,21,58977,108781,19,58625,60258,2,0,0
64653,271,57386,63440,163,65781,77052,108,40948,41929
64652,149,45781,57691,91,67188,71275,58,34375,33655
64651,239,48173,56138,172,67941,67430,67,26875,26779
64650,343,24724,43502,175,40347,57138,168,19483,28296
64649,327,39659,48750,185,41375,56745,142,32000,36280
64648,652,58448,71435,500,68929,83521,152,20147,28768
64647,185,39821,48738,121,50560,57832,64,30577,31036
64646,78,47500,74222,59,48750,76586,19,46250,66884
64645,62,41071,54758,35,80781,79840,27,27946,22056
64644,1260,60909,69905,914,69722,79121,346,34643,40846
64643,479,49625,59407,340,55789,64733,139,36719,44390
64642,366,41250,53363,237,56563,64301,129,30677,30660
64641,271,51250,61963,165,66058,81415,106,25682,31685
64640,1288,51127,64630,876,65435,75917,412,24111,40324
64639,79,45893,61916,51,91250,81369,28,18571,26486
64638,207,51875,62253,121,54650,78650,86,33269,39181
64637,216,51250,56637,149,59688,61560,67,36250,40278
64636,107,34861,42236,63,42188,48022,44,32500,33014
64635,183,51563,67526,117,62188,80759,66,0,42314
64633,1920,38838,58897,1326,54917,69185,594,24012,31435
64632,178,49063,53561,138,47813,54198,40,47500,46330
64631,292,47500,52628,160,60000,68439,132,26094,33442
64630,240,42500,67971,181,48950,76106,59,19861,29253
64628,2469,48542,63176,1720,50500,70332,749,22531,35342
64625,309,43375,60192,198,60217,60121,111,27396,55123
64624,706,52692,61203,484,65682,69828,222,36071,37120
64623,134,61875,71171,96,61250,69344,38,46250,71321
64622,174,53571,85121,98,74722,116873,76,41923,42941
64620,186,81250,74511,130,87688,82672,56,59583,53841
64601,4775,50412,60727,2954,63603,75052,1821,27231,35640
64507,5279,56357,70181,3509,65445,84050,1770,28578,39684
64506,8921,54698,78882,4890,81563,104801,4031,29069,45859
64505,5051,59006,74332,3486,70987,82635,1565,31658,43972
64504,4186,53394,65063,2757,61250,74587,1429,32099,41375
64503,4839,47315,59813,2986,52674,66867,1853,33848,44693
64501,4557,29461,42372,2074,42750,51048,2483,21834,32296
64499,54,75357,65935,25,58472,49488,29,76369,78641
64498,108,76250,76420,64,70000,67791,44,105179,87718
64497,169,80590,85690,119,0,93577,50,80764,66916
64496,60,19527,32475,45,19020,26918,15,44063,48547
64494,454,51500,59313,226,67000,72023,228,50458,44266
64493,160,43281,53298,121,42604,55140,39,45625,45623
64492,694,61548,73852,532,68300,74480,162,46500,57914
64491,845,50586,57808,447,58906,72760,398,28646,38310
64490,684,65625,76562,533,75521,87367,151,31750,36691
64489,759,59698,80153,469,81406,111485,290,16944,25557
64487,282,52794,66920,147,61875,95050,135,35208,33199
64486,135,34063,53244,91,51250,65033,44,22000,28861
64485,3137,53080,64241,2058,72652,79585,1079,24752,33394
64484,346,53000,62611,226,66184,72291,120,23333,33796
64483,209,51563,66544,184,55000,70000,25,34750,37776
64482,1024,52750,73423,636,66000,87729,388,36250,48475
64481,351,44281,52937,220,64091,62825,131,36563,36005
64480,135,95078,104764,70,190735,150783,65,49844,55205
64479,350,53750,63234,253,61806,69672,97,35893,43307
64477,1531,63878,66768,915,85402,85529,616,26563,38799
64476,129,50341,72305,76,51563,81197,53,40179,52906
64475,119,39107,59891,82,52500,70129,37,35750,35778
64474,375,72917,66176,208,76563,76273,167,51979,52956
64473,622,44464,55089,387,55375,68822,235,26313,29388
64471,187,43563,49674,122,47353,62150,65,23281,24982
64470,712,51611,61883,428,61500,73534,284,28125,43475
64469,847,63798,69139,516,73851,78243,331,38487,52990
64468,5926,45036,55400,2911,68614,78277,3015,26951,32323
64467,82,51250,57423,47,81328,83240,35,0,22754
64466,190,47500,95018,105,60694,73375,85,33750,121005
64465,1626,62632,71464,1245,71523,77378,381,37625,41778
64463,618,48333,70036,429,63839,82750,189,35707,38054
64461,322,57083,70901,207,70781,79045,115,24393,49505
64459,212,66066,61043,153,51563,58461,59,22330,36090
64458,74,25682,34416,39,41125,47882,35,0,13980
64457,78,49167,51532,64,51250,55133,14,32500,33593
64456,570,43750,61336,390,60833,74691,180,23214,31052
64455,166,50000,63817,110,75625,78117,56,24167,32007
64454,1011,58036,65334,687,76750,83736,324,20000,26316
64453,93,65208,66513,63,66964,82489,30,0,27543
64451,244,37619,49143,134,53750,64204,110,28804,30558
64449,261,38977,55271,163,72569,70786,98,25238,28798
64448,449,59196,71024,317,59476,79101,132,54167,48652
64446,508,52344,61895,335,56713,69288,173,32639,39460
64445,116,50313,55236,76,66250,74533,40,15000,17938
64444,535,77250,79113,342,84091,96724,193,35250,42679
64443,616,81100,101322,466,92727,116215,150,36500,47403
64442,315,49417,60550,211,53047,69381,104,26250,37861
64441,36,60625,58856,16,63125,63863,20,45500,54845
64440,316,70278,77978,223,91964,96608,93,0,29190
64439,588,69500,85752,406,84828,98585,182,37419,51198
64438,68,0,71909,43,103516,97814,25,28125,27352
64437,221,46250,65314,163,48750,66055,58,28750,57359
64436,378,70000,87193,299,80750,96281,79,51750,50484
64434,200,80000,118893,156,80000,81410,44,0,246109
64433,18,58750,45861,10,61250,58820,8,23750,29663
64432,22,41250,49073,16,50000,57200,6,0,0
64431,176,66579,130120,121,68750,164660,55,46875,54131
64430,323,55417,59363,219,63854,61936,104,0,53944
64429,3601,59305,68538,2388,68106,81342,1213,32988,39572
64428,241,39875,52789,177,44861,59256,64,25000,31605
64427,233,54712,64037,152,67143,69275,81,32813,54209
64426,162,33194,49272,118,33676,51689,44,30000,37636
64424,1691,35019,48662,1021,55063,60764,670,19657,28682
64423,334,62083,74756,223,83859,96887,111,21027,29912
64422,190,75294,72259,171,76691,78868,19,10313,12779
64421,410,53500,58174,263,59107,69277,147,0,34962
64420,27,58750,61230,21,59028,58181,6,0,0
64402,979,44598,55450,612,54327,63117,367,28546,40128
64401,447,73438,84368,356,75313,88003,91,69375,67476
64192,0,0,0,0,0,0,0,0,0
64167,145,79632,117483,116,80833,134843,29,0,0
64166,135,46250,59742,135,46250,59742,0,0,0
64165,124,0,334627,110,0,362995,14,0,0
64164,54,160938,148381,41,0,193512,13,0,0
64163,331,40250,47579,190,45417,51926,141,32917,38389
64161,140,60000,58464,93,63472,63228,47,0,45196
64158,1988,91429,105181,1268,108575,129226,720,52049,61652
64157,6326,114339,142173,5524,120413,144885,802,67500,104367
64156,2707,115625,136779,1942,127849,156168,765,74134,85028
64155,8911,80533,90720,6067,92799,102706,2844,49909,59868
64154,5074,77222,101910,3198,98245,116683,1876,58861,73248
64153,2404,84747,92503,1548,86970,104595,856,52115,67122
64152,11345,95342,127650,8058,119456,152770,3287,45475,62217
64151,10685,77512,95280,6757,94443,110607,3928,51295,65394
64150,1617,36653,70639,812,59815,93959,805,31074,45863
64149,189,0,90894,109,136116,110068,80,0,64768
64147,129,8618,12630,113,7566,12784,16,0,0
64146,875,62868,78393,456,112905,109957,419,33869,41188
64145,1811,74214,110133,1276,80227,122115,535,38922,77639
64139,761,114917,127463,574,131750,138133,187,70271,81588
64138,10558,44867,61461,5651,66479,74424,4907,31780,42503
64137,4705,55180,65013,2700,65451,79077,2005,32393,43411
64136,758,0,68739,372,83333,100945,386,27143,33353
64134,8780,44969,55702,5254,47472,59995,3526,34845,44344
64133,15128,54421,65024,8588,70072,79234,6540,34954,44097
64132,5298,37936,44485,3226,41620,48747,2072,27525,32965
64131,10151,51241,67465,4998,66234,82196,5153,37207,48624
64130,8522,37679,54597,4157,45723,68796,4365,25028,35321
64129,3623,41530,57262,2023,51826,60485,1600,31471,50088
64128,5178,27045,40751,2532,37904,52587,2646,20020,26697
64127,6626,28021,38012,2880,39341,48568,3746,17584,28531
64126,2152,26575,34714,1303,35146,39064,849,13964,24308
64125,628,37258,52241,418,45069,60889,210,19125,29647
64124,4057,34402,42466,2505,40171,47221,1552,24167,31225
64123,3807,39513,48178,2126,52364,60042,1681,28052,31269
64120,145,39792,54764,81,67188,70252,64,33750,35163
64119,11578,70105,82969,7429,79048,93414,4149,47457,58955
64118,17207,58861,72722,10622,69619,83787,6585,41780,50879
64117,6094,52667,62311,3738,66522,71559,2356,40055,45453
64116,7838,47273,75402,3664,61939,92492,4174,37087,58082
64114,12864,66367,81454,5992,87500,105102,6872,49968,59579
64113,4702,146829,194853,3349,169589,228880,1353,66858,108546
64112,4875,79904,126910,1663,132933,214880,3212,60481,80207
64111,10279,53266,68517,2420,85484,102407,7859,46241,57418
64110,7411,46436,68770,3234,69357,91622,4177,32388,49091
64109,4980,33135,59264,1834,67695,97608,3146,22201,35482
64108,4594,57000,84174,1682,70417,95952,2912,51048,76942
64106,5180,37372,63057,1684,31605,55917,3496,49239,65806
64105,3530,59311,81044,623,133920,164394,2907,52287,63181
64102,0,0,0,0,0,0,0,0,0
64101,21,0,0,0,0,0,21,0,0
64098,1242,75139,82223,895,91458,96443,347,31420,38613
64097,450,59167,72766,312,67500,79866,138,38750,51611
64096,460,49500,65723,316,66094,73986,144,35000,47590
64093,10430,54054,66837,5650,72614,88155,4780,33852,39731
64092,18,0,0,18,0,0,0,0,0
64090,58,70278,61840,47,71806,65815,11,43281,40027
64089,4939,83014,94744,3953,90616,103807,986,38667,46307
64088,465,64485,78643,345,64191,86558,120,34643,44789
64086,9114,91429,107549,6584,107569,125575,2530,43766,56144
64085,3383,58279,67046,2213,73576,81468,1170,25216,35129
64084,580,42708,65665,400,58333,74400,180,21378,46254
64083,9046,84797,94532,6767,99027,105702,2279,40127,59966
64082,5866,123549,142784,4975,131634,153192,891,65184,73609
64081,9750,90625,113432,6601,110355,139398,3149,45119,53966
64080,4949,80242,93146,3670,93669,105940,1279,35951,49984
64079,5065,88261,99494,3624,107243,113922,1441,51989,59046
64078,3617,77027,87323,2794,85273,94285,823,41541,58295
64077,711,68750,70596,485,76250,75259,226,41250,58466
64076,3379,62184,78213,2543,79415,85740,836,34184,49516
64075,4449,74037,82552,3162,84358,95884,1287,27750,34801
64074,241,68750,98580,164,85272,108826,77,41080,73910
64072,209,47896,54441,145,48628,63004,64,19333,33033
64071,280,70192,78230,227,71979,77531,53,49236,63458
64070,1267,83984,95137,984,89779,105691,283,52750,54860
64068,13449,78884,93622,9564,89280,107912,3885,39554,51735
64067,2464,62465,77911,1407,79156,95423,1057,37017,49417
64066,7,85625,79886,6,86250,93133,1,0,0
64065,6,61250,59467,0,0,0,6,61250,59467
64064,7163,105923,132027,5395,127471,150179,1768,51757,72632
64063,8361,71119,84842,5837,83123,97393,2524,40441,52266
64062,2219,78263,107855,1817,79634,107742,402,45972,101286
64061,1230,62656,81455,922,71389,92202,308,42955,46328
64060,5903,89116,101239,4758,97091,112732,1145,43401,49633
64058,2478,66724,74319,1715,69865,79059,763,50550,57785
64057,5971,63625,76978,3402,81378,93532,2569,43320,51936
64056,5798,62126,71619,4467,65563,73921,1331,39693,57742
64055,14848,56942,75553,8968,70487,88120,5880,34402,48985
64054,1158,42167,51352,773,45375,52595,385,37796,39410
64053,2192,41500,57082,1227,50630,75107,965,25825,31463
64052,9136,45422,53914,5069,51171,58891,4067,38379,43098
64050,9339,39940,51249,4911,51461,63311,4428,25881,32838
64048,1492,83919,98249,1163,89602,105778,329,61450,69604
64040,2387,56250,66463,1744,66731,76542,643,32696,35300
64037,2286,60772,71451,1445,67868,79877,841,35809,54137
64036,113,19107,30747,91,0,30107,22,21875,32436
64035,393,51397,70551,304,63125,71241,89,30125,61699
64034,3287,102033,115328,2778,110861,123835,509,49688,62890
64030,10219,47454,63297,5682,57261,69579,4537,33182,51025
64029,6731,76649,83844,5028,85000,91651,1703,49047,53644
64024,5732,63659,71679,4034,75281,84587,1698,30241,37164
64022,47,58750,68902,38,76250,78729,9,31250,27411
64021,237,60938,84688,175,74583,99719,62,26667,39929
64020,1385,56141,77521,941,79844,95081,444,26483,30240
64019,819,60642,66166,677,60916,66810,142,53750,53949
64018,387,93417,108043,294,128333,130921,93,26750,35004
64017,126,63750,67851,92,90530,78118,34,34375,38224
64016,1849,77806,80264,1223,71416,78683,626,81023,79890
64015,11585,72025,89681,8177,87375,105830,3408,36178,48920
64014,9852,72294,91257,7522,81165,100393,2330,52618,54946
64012,10879,67071,81804,7716,75593,90320,3163,41067,51094
64011,1444,67128,85322,1163,69566,88405,281,49875,68858
64001,321,63036,70992,199,71806,78650,122,0,56645
63967,753,44321,49446,491,53188,56324,262,0,32021
63966,1093,50605,57961,711,64334,73624,382,24519,27544
63965,1057,37406,50811,647,55536,67535,410,15625,20464
63964,89,0,29540,67,0,24918,22,0,0
63962,48,0,0,48,0,0,0,0,0
63961,658,41442,54976,382,59844,70930,276,19886,31148
63960,1222,47898,54731,891,58403,63346,331,22629,29417
63957,2534,33726,46166,1513,41643,52924,1021,19415,33224
63956,418,44119,53850,319,44298,58730,99,0,38123
63955,58,30962,29134,29,38456,33355,29,27125,24910
63954,298,37794,56041,201,0,69514,97,19844,27510
63953,534,29423,42526,280,35625,50266,254,16500,31541
63952,135,31875,55387,105,32422,63055,30,13750,16550
63951,104,0,25338,46,38500,43146,58,11034,0
63945,334,45170,54564,305,45440,56269,29,0,26528
63944,766,37375,52345,507,46791,65983,259,0,24581
63943,177,38393,50116,140,38833,53906,37,0,23946
63942,229,32132,40453,180,34821,46379,49,15417,18684
63941,77,0,78548,45,0,120644,32,18594,19350
63940,615,47235,60444,360,63636,77384,255,25625,25452
63939,558,27262,44167,339,55089,57268,219,15884,22154
63937,1178,53438,67069,817,65607,79296,361,33033,31768
63936,261,41125,57206,186,43864,66329,75,30868,31311
63935,3645,39397,50582,2482,50926,61265,1163,16628,25242
63934,82,25000,0,40,0,0,42,0,0
63933,1296,36328,47326,810,45112,58834,486,20875,24443
63932,403,0,56803,267,60089,68545,136,25192,31434
63902,0,0,0,0,0,0,0,0,0
63901,13466,41697,55961,8507,50859,69212,4959,19643,30228
63882,147,37981,40293,68,0,44846,79,37981,34785
63880,60,19400,26752,37,0,30938,23,0,0
63879,293,41641,60543,211,59250,74374,82,22639,24104
63878,38,51500,53958,32,53333,60647,6,0,18283
63877,1433,34375,58255,1012,45403,66267,421,21858,31064
63876,864,36181,49383,645,37723,48741,219,20607,43179
63874,122,53500,58644,81,81042,75272,41,20625,24149
63873,1775,39414,57902,1257,43455,65977,518,20781,33398
63870,512,24886,44725,400,28333,48932,112,0,23536
63869,1576,40909,47081,880,55417,60092,696,21731,28520
63868,343,30391,36345,197,31250,37374,146,29615,29548
63867,404,37348,44776,274,36724,46338,130,32262,32403
63866,164,20938,30762,109,23393,38700,55,12188,15033
63863,2442,38029,63159,1553,50889,84406,889,22288,23659
63862,608,34931,47888,411,42404,55221,197,19583,23967
63860,88,37917,36626,56,48214,48546,32,0,15766
63857,5023,44587,60031,3230,55382,73122,1793,21321,32690
63855,397,39417,53121,262,54375,61172,135,21477,35497
63853,71,27031,53648,35,45417,88889,36,0,19386
63852,569,35688,53014,364,51111,66962,205,22829,27568
63851,1416,25238,42423,894,35833,52463,522,18264,23733
63849,70,0,65786,55,0,60176,15,0,86353
63848,406,38500,66952,294,45536,79367,112,15333,24287
63847,12,0,0,12,0,0,0,0,0
63846,531,47344,50900,392,53224,56119,139,24375,32905
63845,2469,33750,47887,1628,40305,55105,841,18640,32143
63841,5286,43894,55383,3394,57766,66399,1892,26255,33148
63839,169,44213,62034,111,44236,53445,58,31250,68779
63837,629,35054,45474,352,45116,56256,277,17946,29710
63834,1942,32969,47021,1341,39221,51574,601,17098,35126
63833,82,0,42989,40,73333,67195,42,18750,19936
63830,2764,36042,54517,1745,50014,71032,1019,14692,25251
63829,525,33098,57381,290,43816,61354,235,14598,51603
63828,67,37083,45964,38,51667,57645,29,26458,30659
63827,277,47563,60059,210,50455,67996,67,30521,34555
63826,21,0,114995,13,0,171631,8,0,0
63825,1558,41250,54156,1109,50839,58698,449,23633,39765
63824,35,54688,48574,16,54375,54750,19,0,43374
63823,493,51827,65430,407,59583,71286,86,40000,37715
63822,1001,38885,49468,662,49167,57382,339,26927,31080
63821,314,21500,36652,196,32188,44530,118,14125,21885
63820,87,28295,35455,62,46667,45197,25,9583,10736
63801,9446,45946,64998,5790,60103,80166,3656,28634,38524
63787,251,48693,57333,174,52500,61816,77,0,45805
63785,399,40250,55422,320,52188,62593,79,22917,23853
63784,78,66500,75174,44,49375,48993,34,88382,108288
63783,30,0,107557,13,81607,144931,17,0,0
63782,108,31667,45556,72,0,54803,36,0,25281
63781,385,64087,74522,305,79293,83242,80,36625,40755
63780,2386,50341,61730,1687,62905,68529,699,18047,40774
63775,6504,56790,67413,4365,72942,80902,2139,30094,38247
63774,38,52941,48697,32,53382,48653,6,0,0
63771,982,53580,61000,720,58810,65763,262,27378,40567
63770,48,46250,46794,45,38750,45540,3,63750,49467
63769,469,54375,61824,378,58500,65499,91,31467,45167
63767,281,33281,45816,182,36667,56174,99,14417,24299
63766,552,47188,57889,398,61538,69261,154,19848,28125
63764,1987,36023,52149,1188,59342,67943,799,20123,27570
63763,91,0,36242,73,0,41930,18,0,0
63760,218,70833,78005,185,82656,87048,33,19226,22094
63758,100,41818,46857,47,65865,73753,53,0,22172
63755,9479,65625,78644,6783,75162,90900,2696,35522,43071
63751,505,43169,45700,407,42762,47160,98,31613,35241
63750,9,0,0,5,0,0,4,0,0
63748,547,49237,59954,315,69479,73974,232,47824,39846
63747,194,80667,77868,186,81333,78796,8,0,0
63746,25,42083,49644,11,0,0,14,0,0
63745,4,0,0,0,0,0,4,0,0
63744,25,50938,53680,17,60938,62694,8,14167,14150
63743,22,100000,115905,22,100000,115905,0,0,0
63742,27,0,61881,27,0,61570,0,0,0
63740,2033,51278,70768,1527,61345,78991,506,24091,39030
63739,173,42125,45453,115,40875,48888,58,0,38641
63738,0,0,0,0,0,0,0,0,0
63736,1498,46944,55829,992,54667,64548,506,42833,36908
63735,336,23750,35154,223,33750,40751,113,12138,20199
63732,359,62083,67545,290,70375,72852,69,0,40296
63730,1524,48400,62029,914,61436,65779,610,30349,56050
63703,3702,28690,40710,1723,50498,57682,1979,19610,24946
63701,14614,53147,71851,8294,75274,91767,6320,32106,43728
63675,44,30833,27591,34,31875,30809,10,0,0
63674,0,0,0,0,0,0,0,0,0
63673,686,60909,89925,467,76397,87661,219,0,86677
63670,4578,60459,87777,3319,81040,100066,1259,34675,50346
63666,20,0,21705,9,0,0,11,0,0
63665,89,0,63298,64,0,81572,25,17679,16516
63664,3534,43780,60107,2273,59250,73191,1261,26636,35576
63663,333,35707,47336,224,56071,53785,109,28036,30244
63662,557,40282,55155,292,71757,63188,265,19362,26185
63660,1060,43939,52527,804,41923,53292,256,40778,45567
63656,107,49671,68072,96,48947,68054,11,0,0
63655,608,44338,53322,427,50827,60378,181,28594,36097
63654,302,27188,45933,183,58281,59399,119,21250,24376
63653,492,39625,47689,346,54464,56183,146,19286,24186
63650,1731,38132,48688,1184,45227,54680,547,24306,35341
63648,531,39904,53527,364,34615,56136,167,35938,39622
63645,4487,49032,64938,3095,64461,77924,1392,20541,34967
63640,10472,50663,65910,6989,68482,79075,3483,24976,35811
63638,1058,48066,54358,838,51944,60350,220,18512,23150
63637,517,48507,63273,321,48368,59515,196,0,64488
63636,228,37794,45354,145,54063,57026,83,23092,24510
63633,282,39318,53480,185,72813,65169,97,23459,25796
63631,400,65750,84985,318,68726,101437,82,19250,18509
63630,1366,38393,47270,1019,36717,49053,347,43536,40097
63629,482,48304,56779,331,56094,68140,151,19821,28132
63628,4937,44561,59617,3452,63877,70495,1485,21088,30357
63627,1420,74167,78816,972,85848,83938,448,41747,66418
63626,477,68125,71504,322,69886,77100,155,53295,45297
63625,158,54167,86148,125,60417,102286,33,18542,18942
63624,1511,37995,49538,968,48654,60527,543,22380,27896
63623,283,34890,50045,164,50000,64743,119,14313,29788
63622,599,41582,57681,343,65546,54587,256,24530,61085
63621,624,68403,72095,356,72955,81129,268,18750,48446
63620,469,37061,51075,358,38000,53136,111,28472,36378
63601,6469,42622,54030,4312,50111,57976,2157,26637,42027
63567,46,0,39650,45,0,40347,1,0,0
63566,42,60625,57983,31,59250,57413,11,0,24355
63565,1343,47670,61313,839,62348,74500,504,33125,37582
63563,170,0,118371,146,0,135608,24,13625,13513
63561,339,36250,49861,192,47250,55663,147,24922,41691
63560,63,0,33646,22,0,43127,41,0,28561
63559,605,51188,64208,407,74779,82129,198,15294,25514
63558,244,55000,59239,186,62744,67495,58,28333,32503
63557,103,60662,65771,68,65000,77138,35,40625,43689
63556,1264,49583,59978,786,54438,71060,478,30000,36724
63555,1186,46983,69077,784,58667,86241,402,20417,31439
63552,3061,43558,54372,1834,56475,67664,1227,26963,33468
63551,75,46250,60343,56,0,64984,19,31458,39205
63549,924,42841,53480,568,58000,64144,356,24737,33543
63548,359,42550,50958,232,54375,65236,127,20958,21941
63547,200,24911,37177,148,32500,44373,52,13036,16694
63546,580,51413,57731,399,54306,65668,181,28854,38388
63545,379,40268,52094,170,70909,72424,209,24375,34544
63544,321,43563,50860,251,52591,54086,70,31750,35569
63543,64,31719,38423,41,31625,42412,23,31875,31313
63541,176,50855,69162,113,52250,82110,63,50568,42630
63540,53,46875,69321,42,53000,80702,11,0,25864
63539,95,0,40971,44,61667,75766,51,25000,10951
63538,92,42000,59676,64,85417,78506,28,0,15089
63537,727,44141,53489,446,69565,69371,281,18698,28258
63536,367,52969,59201,258,54198,71233,109,20875,30271
63535,16,25000,0,7,0,0,9,0,0
63534,364,40682,50177,268,42045,54854,96,29583,36172
63533,282,55268,59975,210,57321,67454,72,27361,37878
63532,535,45234,57045,297,52375,67459,238,32083,43595
63531,129,61696,69456,92,75833,86662,37,0,26673
63530,367,57589,56396,283,63750,62758,84,24286,33519
63501,7536,41385,65753,3773,63380,96389,3763,20356,33881
63474,195,42279,89825,81,119821,167614,114,40147,34554
63473,86,66176,69234,65,70536,79762,21,44750,36648
63472,302,20000,40027,116,61346,65321,186,18304,22532
63471,293,63194,72345,231,69712,84367,62,0,27556
63469,470,55000,71797,330,79722,88073,140,28214,32481
63468,1020,42738,48907,627,58558,63930,393,15236,21050
63467,14,0,0,14,0,0,0,0,0
63465,137,42052,118655,102,0,146408,35,0,35960
63464,6,0,0,0,0,0,6,0,0
63463,250,67917,77434,208,67917,74777,42,0,83221
63462,700,35357,42434,463,45324,48699,237,31171,29105
63461,2188,57191,63743,1585,68317,69697,603,38867,39383
63460,119,45625,58386,71,80250,82163,48,20833,23215
63459,1566,56806,67997,1106,65156,77049,460,39250,43869
63458,48,29286,33117,22,0,40373,26,28571,26977
63457,104,58929,67857,78,66500,74286,26,55000,46758
63456,1930,52303,60673,1280,70814,74782,650,18162,29916
63454,330,57955,63783,281,72558,66919,49,29821,37000
63453,177,78859,93456,133,79063,105441,44,0,56634
63452,476,54167,60522,368,60370,68340,108,31667,32639
63451,88,75438,64227,40,53000,57733,48,76143,69640
63450,79,62042,77462,74,61833,77738,5,0,0
63448,605,50692,57998,357,57125,71612,248,31667,34392
63447,405,37760,53414,250,41250,62380,155,24886,31472
63446,179,38750,40592,114,47955,47184,65,0,27891
63445,1366,44069,61221,927,55712,74041,439,19609,30161
63443,146,32935,30334,51,33295,38700,95,32604,24914
63441,418,50714,61616,296,75000,72836,122,24375,31852
63440,480,35357,71112,301,55469,96012,179,21709,28868
63439,100,38417,36047,41,66146,58995,59,0,20100
63438,152,44700,52522,109,55865,57417,43,32788,29221
63437,649,32301,44792,406,37976,51574,243,23068,30769
63436,600,60833,81658,369,75871,82099,231,19219,79853
63435,1389,44427,64914,884,69189,85489,505,16875,24981
63434,241,51875,62963,189,63036,72133,52,21250,22638
63433,0,0,0,0,0,0,0,0,0
63432,233,50054,72289,146,61071,97379,87,30795,29646
63431,127,0,71613,115,0,71022,12,0,0
63430,213,32135,57264,157,0,64587,56,27000,36604
63401,8846,50896,63998,5676,63220,73600,3170,28404,42749
63390,3992,74764,91200,2939,86458,103889,1053,45083,52719
63389,2406,67773,75290,1591,77050,84126,815,47964,53203
63388,412,55750,68097,153,53875,66271,259,0,69176
63387,38,0,63503,21,56250,54290,17,0,48494
63386,193,47604,76383,135,70625,90819,58,38750,39383
63385,15609,93138,108526,12110,99756,118260,3499,54117,64625
63384,804,60741,77077,568,71250,92290,236,22500,35844
63383,6150,52743,69865,4529,61289,76922,1621,36162,43471
63382,1271,40733,53929,729,53385,64321,542,32500,37995
63381,177,45855,66371,137,45197,54389,40,0,106338
63379,9160,75106,82032,6858,80396,92345,2302,33976,43710
63377,1045,59750,75273,721,80919,93650,324,23182,34380
63376,28500,83420,98762,20097,99518,113381,8403,45775,58999
63373,219,76250,85880,173,102813,98002,46,39375,34896
63370,46,33603,32004,38,0,0,8,0,0
63369,673,79821,89634,423,113036,114018,250,40877,48236
63368,16396,106136,121317,12791,118366,134765,3605,53024,67034
63367,9461,107243,119686,7336,117459,132772,2125,49471,69721
63366,18783,81451,96959,13558,94613,111939,5225,41955,52822
63363,771,47904,55632,531,61367,61731,240,34167,36853
63362,2579,68644,77302,2051,73775,84479,528,31531,46619
63361,1916,47663,56845,1173,62688,68676,743,25506,36025
63359,520,64853,73551,387,81250,86664,133,28482,32662
63357,2234,80097,87540,1815,82192,92537,419,37083,45841
63353,1882,46084,55756,1236,61917,67098,646,22662,32537
63352,545,42986,52066,324,48750,63850,221,27875,31575
63351,814,70875,74872,639,74948,83948,175,40885,41424
63350,247,72125,74389,201,76050,82579,46,28571,38130
63349,658,56210,74009,514,61591,80551,144,46250,49757
63348,2984,106422,123672,2458,117130,135158,526,37364,60049
63347,1000,72196,80105,803,82721,86143,197,37868,54066
63345,275,54479,60175,162,59057,62827,113,35846,54691
63344,465,58565,70054,326,72143,85212,139,26696,32667
63343,1552,48600,55364,1053,54840,61723,499,32031,37774
63341,1194,110333,142447,960,126563,165203,234,37500,49090
63339,325,36823,54369,239,52063,62575,86,21912,23114
63336,413,49375,89592,293,63194,92020,120,36250,77971
63334,2962,42744,60015,1814,54202,71638,1148,33629,37349
63333,321,66250,93582,231,105707,119804,90,27500,25041
63332,568,116667,106990,470,120357,116119,98,32708,55205
63330,70,48958,47377,42,70455,52221,28,41250,37336
63304,15496,101663,128937,12318,113992,141458,3178,58423,74975
63303,20683,82336,110989,12875,100158,121407,7808,55997,92057
63301,20142,64922,82286,11991,85954,100143,8151,42537,53612
63155,0,0,0,0,0,0,0,0,0
63147,3598,32107,40709,1873,36764,51053,1725,26332,28820
63146,15135,72813,96308,8110,105820,124187,7025,48048,62477
63144,4419,81863,113692,1986,117763,148806,2433,68705,84444
63143,4888,49611,62805,2102,72560,85075,2786,38818,45452
63141,8536,107173,183050,5385,149162,237379,3151,54392,89195
63140,140,28214,31332,48,22500,26604,92,30625,33532
63139,10790,60569,81333,4828,92028,112910,5962,45859,55216
63138,7167,42101,56764,4368,53032,68743,2799,27019,35859
63137,8144,40845,51650,5238,48453,59716,2906,33432,35855
63136,19169,32512,42263,11106,39274,48563,8063,25523,31066
63135,8883,47272,57930,5652,52190,65669,3231,31939,40581
63134,5321,41113,47250,3512,39936,48770,1809,32121,37562
63133,3156,27074,39503,1591,37135,44830,1565,19692,32020
63132,5507,66214,100684,3136,91523,133310,2371,46221,56292
63131,6439,164531,252216,5302,191167,279026,1137,79030,124304
63130,12310,72793,124603,6730,102339,167029,5580,43618,71851
63129,21649,79834,100083,14290,103709,121940,7359,43366,55922
63128,13423,76415,95376,8467,98337,120226,4956,38275,49431
63127,2083,99426,142878,1416,133333,174148,667,43150,73325
63126,6061,84566,105679,4284,99905,118368,1777,52511,68704
63125,13798,53102,63848,8662,60328,73432,5136,33557,42148
63124,5126,164545,288371,3377,232768,356829,1749,60013,154640
63123,22473,61253,74936,13078,82018,90105,9395,39584,51598
63122,15855,107016,134357,10568,134627,163811,5287,57305,75108
63121,11261,40025,50720,5773,49395,60785,5488,31544,38846
63120,2890,28110,39337,1564,38224,50222,1326,17745,24417
63119,14327,85257,110800,8256,121031,144587,6071,55766,63462
63118,11964,42469,59804,6264,50241,66656,5700,35618,49835
63117,4368,82685,122230,2137,126782,171515,2231,54331,73367
63116,19893,48902,64250,9837,62280,77737,10056,37964,48149
63115,7070,27453,38751,3789,40684,49463,3281,16405,23827
63114,14874,46664,58520,8580,53391,63564,6294,36261,47753
63113,4907,32607,44900,2850,43514,54616,2057,18509,27532
63112,8399,36506,57986,3350,69314,85751,5049,23515,38316
63111,8465,30338,49328,4012,40986,61056,4453,24070,32403
63110,8397,57157,80585,3605,90268,109521,4792,41365,57588
63109,14225,62930,78660,6468,94070,110679,7757,42072,50856
63108,11434,48535,85170,3124,88853,153216,8310,38137,58689
63107,4167,30828,37492,2106,42330,46759,2061,16701,26432
63106,4338,21708,43584,2158,27773,45646,2180,16714,40078
63105,6621,105597,185593,3707,158281,254340,2914,64701,97026
63104,9560,62533,87893,4492,67955,98939,5068,57374,76323
63103,5177,41943,60837,1183,93561,114201,3994,32047,44865
63102,1203,56849,69050,187,96612,114133,1016,46419,60752
63101,2420,77976,93334,530,75106,93047,1890,79557,93343
63091,519,65972,76739,387,87950,91401,132,27344,32487
63090,8727,76025,91842,6217,89718,105416,2510,37331,53494
63089,2136,59435,72806,1429,76852,87198,707,27114,42055
63088,4209,55008,78566,1886,73631,93416,2323,44979,64669
63087,441,0,64093,289,0,62370,152,0,66166
63084,7509,59418,74159,5191,69696,87085,2318,35729,40850
63080,5860,47213,61924,3760,65980,72528,2100,24766,39870
63079,22,0,0,0,0,0,22,0,0
63077,4469,53549,60048,3046,59958,65851,1423,32995,44420
63074,6630,46953,56442,3975,58602,60579,2655,31382,47077
63073,148,"250,000+",373249,123,"250,000+",435426,25,0,0
63072,1196,68729,85117,1011,78828,89297,185,48953,48876
63071,439,29097,42949,299,36063,48382,140,20625,29740
63070,2861,64176,73797,2133,72931,83038,728,30071,41036
63069,6164,60520,86749,4028,85063,110325,2136,27877,37692
63068,2125,59703,75338,1655,73750,86079,470,29881,32196
63061,48,137778,112556,48,137778,112556,0,0,0
63060,903,50197,61772,676,53693,66311,227,39755,42589
63057,0,0,0,0,0,0,0,0,0
63056,815,67750,68949,441,95893,92641,374,35658,40795
63055,710,82026,102155,594,83500,105327,116,0,83795
63053,40,42500,51860,24,31500,46142,16,66250,60438
63052,10265,76315,86623,7594,84551,94609,2671,44776,61335
63051,4806,63081,77732,3598,69744,83438,1208,39583,49793
63050,5985,72589,87187,4588,78714,96725,1397,34631,45206
63049,6428,72697,84962,4343,86362,96808,2085,36725,49932
63048,1375,65568,73652,1046,78293,82471,329,28875,39524
63047,16,0,0,16,0,0,0,0,0
63045,0,0,0,0,0,0,0,0,0
63044,4039,61901,90233,2753,78385,104379,1286,33472,50758
63043,9126,76944,86801,5736,88125,97149,3390,55078,66356
63042,8687,46400,59933,4514,58381,71400,4173,32419,45349
63041,180,61944,92590,122,94375,112452,58,51333,50809
63040,3148,109917,131308,2359,132572,148884,789,53924,75911
63039,232,61336,67020,165,44132,51159,67,0,56863
63038,2561,148594,190560,2176,162332,209164,385,67443,82514
63037,1220,51444,69431,769,68438,90449,451,25428,32042
63036,572,55946,78704,395,62539,94099,177,0,43160
63034,6623,95525,102526,5018,101881,108951,1605,64358,75957
63033,16441,57506,68563,9736,76336,81183,6705,34243,47636
63031,18136,64401,76282,12185,76245,84698,5951,42602,54378
63030,105,0,59179,91,0,63346,14,0,0
63028,10426,65127,76468,7460,75744,89091,2966,31972,41353
63026,16988,81395,98630,12305,94158,113040,4683,43942,55706
63025,5350,117002,135049,4206,120357,149239,1144,51714,77895
63023,2063,60558,74596,1555,64282,67176,508,33750,88307
63021,22050,92201,118679,15724,109819,137703,6326,50362,66880
63020,8129,52647,64733,5855,61929,71868,2274,30947,41266
63019,1819,57441,67247,1189,69838,80043,630,35147,41967
63017,16425,115095,158239,11568,151691,193497,4857,51294,71568
63016,2788,65250,78014,1846,73202,77592,942,39201,72658
63015,771,49321,96453,375,62969,101698,396,0,91486
63014,350,33900,50637,197,49971,70269,153,30495,24223
63013,474,90064,90192,291,101827,114357,183,46230,51764
63012,3777,81702,91318,3219,80685,89514,558,53207,67625
63011,14427,105586,129207,10686,126536,149780,3741,48798,68508
63010,13916,65883,74948,9532,77279,86022,4384,36648,47704
63005,6937,161364,227759,5599,192404,259086,1338,69737,93089
62999,671,44934,44477,409,52031,53666,262,22667,25600
62998,105,49219,61961,76,61944,85604,29,0,0
62997,237,54875,58563,150,56731,62490,87,50956,45552
62996,115,57656,123874,87,0,152098,28,21731,23346
62995,1418,47500,58432,961,57925,66483,457,22734,39449
62994,271,51023,65094,183,52067,66967,88,33750,44670
62992,277,51750,61442,227,62695,70941,50,17500,18316
62990,358,55682,77612,285,64420,89419,73,36354,31164
62988,481,42760,47848,323,47462,57924,158,19737,26789
62987,515,60625,61385,366,73182,71407,149,21080,34226
62985,210,59643,69880,177,59821,73688,33,0,49458
62984,658,26900,63440,394,40735,89852,264,16759,22226
62983,614,38214,58786,385,55179,75088,229,18787,29554
62982,418,46389,57345,305,56319,68120,113,15208,24370
62979,533,45469,58104,340,63594,67073,193,31418,36459
62977,246,54444,71758,186,69375,79996,60,41167,46220
62976,144,35000,38566,85,40625,44399,59,25875,30163
62975,74,0,100077,16,0,0,58,0,95643
62974,775,53271,68372,503,78594,79124,272,48562,46728
62972,412,71667,87220,317,90774,95217,95,26688,34447
62970,266,52500,59823,119,92639,82866,147,33472,40059
62969,152,52500,53693,110,47321,56244,42,0,47014
62967,116,45500,57627,96,37500,56814,20,12000,20155
62966,6155,44483,67128,3888,57879,82373,2267,30218,37202
62965,23,0,68796,22,0,71477,1,0,0
62964,531,30827,35653,268,36087,46719,263,19943,24189
62963,248,41364,43569,156,60135,53229,92,12273,26200
62962,0,0,0,0,0,0,0,0,0
62961,12,0,59750,12,0,59750,0,0,0
62960,4322,52021,59651,2933,62422,69028,1389,24688,37328
62959,11449,53876,71347,6847,75256,90377,4602,30747,40913
62958,797,70469,82979,540,86250,100996,257,23393,41861
62957,304,39750,46097,162,48611,61614,142,24583,28065
62956,350,49167,55588,246,56848,69782,104,15714,21818
62954,327,52165,102205,249,54018,126584,78,0,24379
62953,89,29792,45882,56,36250,55618,33,17083,24458
62952,1220,41810,58871,788,67368,72787,432,21700,31402
62951,2064,41821,56708,1479,52744,66251,585,29728,30613
62950,63,98487,107487,36,97632,77636,27,0,0
62949,353,26625,40830,168,47115,58112,185,14702,24532
62948,5733,46420,64145,3211,61875,81969,2522,25726,38755
62947,185,60469,71269,124,70000,79447,61,43523,54643
62946,5239,43107,57082,3491,57452,68903,1748,22018,29075
62943,130,56875,66348,100,73611,82971,30,9583,10940
62942,241,52917,62042,156,65469,71058,85,43750,42795
62941,269,60341,61758,194,69028,75437,75,0,21392
62940,212,65125,53817,175,65641,61088,37,15781,15695
62939,1188,58281,79493,904,68250,89482,284,44524,46844
62938,1248,45729,56421,794,54224,66846,454,35000,37966
62935,795,51597,76746,590,61630,78203,205,27159,72553
62934,333,52663,93832,202,62500,99951,131,0,82134
62933,557,51331,60726,324,74000,78493,233,31394,35215
62932,501,41188,50610,328,41667,53162,173,36750,42435
62931,581,45054,53724,298,72813,75259,283,19509,30889
62930,2707,43169,59673,1556,51167,71084,1151,22909,41332
62928,83,15764,32951,38,63000,53366,45,14671,15709
62927,140,35000,41326,88,38750,44715,52,31000,31581
62926,827,53502,65345,488,62708,80797,339,40208,39909
62924,1157,51176,63774,823,56932,67718,334,35000,49165
62923,174,51333,73368,123,57031,89300,51,30208,32945
62922,1241,63917,81766,939,69938,90317,302,33942,47036
62921,136,0,30924,66,0,28106,70,0,32657
62920,1339,57764,67302,899,67171,78892,440,26620,38338
62919,313,60202,96610,233,52083,113467,80,0,37089
62918,4013,58294,74736,2733,73242,86870,1280,29474,45812
62917,907,43393,82423,652,49583,97559,255,19821,40060
62916,283,70750,80260,196,79130,99672,87,33365,34353
62915,124,52500,55519,102,56875,63236,22,0,19736
62914,924,28275,40218,431,31458,39590,493,25319,39368
62912,583,53661,82965,443,57132,89533,140,37857,60319
62910,954,39750,52075,563,52560,62711,391,30703,32749
62908,251,74489,78993,184,85938,86907,67,38036,50239
62907,691,55417,81932,468,61364,96667,223,31728,46974
62906,2815,50489,64653,1761,67821,83071,1054,26813,32737
62905,231,53375,64423,156,75000,78179,75,0,34279
62903,1294,31037,69600,647,89250,105787,647,17477,32783
62902,1834,51538,86189,1159,75815,112871,675,30021,38730
62901,11448,28756,51243,4267,63722,83890,7181,20494,31221
62899,593,44886,56896,350,54167,69953,243,26458,35065
62898,748,70455,84917,601,78413,92769,147,33264,40559
62897,169,62604,57380,67,98438,84737,102,24000,38612
62896,5024,40054,51634,3174,51010,62111,1850,21194,31461
62895,756,44167,53876,502,57963,62780,254,25536,28887
62894,408,60179,72361,337,71438,80395,71,20938,31785
62893,351,62917,69096,263,81250,80511,88,26250,32201
62892,131,61146,55998,81,68375,70988,50,0,31594
62891,292,35500,50053,179,57212,66317,113,20875,23778
62890,991,47560,53831,598,66667,66291,393,33149,33390
62889,408,60441,68142,304,72500,78338,104,14631,32599
62888,953,62802,67232,661,72545,78103,292,35789,40683
62887,111,54625,63997,103,54875,67033,8,15000,24925
62886,136,53214,61502,114,55000,62075,22,0,35932
62885,197,44583,58597,113,72344,71549,84,29250,40921
62884,1103,58281,64399,761,73450,72847,342,40357,43609
62883,254,62130,80323,199,80104,91034,55,40250,41569
62882,948,46129,55473,621,52989,63574,327,26776,34551
62881,4658,53239,66901,2923,66117,77863,1735,28725,43452
62880,282,59792,62478,198,64056,74340,84,22083,31355
62879,47,63375,53636,38,64500,61532,9,0,20289
62878,168,42308,49995,80,0,57865,88,40865,41591
62877,204,54375,64795,161,62813,71068,43,19250,40556
62876,69,41607,56470,40,67500,73658,29,28125,32759
62875,457,56576,67121,335,58958,74827,122,27500,37467
62874,199,35234,40268,95,50625,50377,104,27500,30696
62872,386,62125,74254,292,71042,87290,94,17500,31252
62871,222,66111,71697,158,66944,75840,64,42500,61469
62870,882,47500,62821,568,58409,66933,314,33929,52050
62869,1000,46818,64997,678,69479,80756,322,22308,29118
62868,703,55208,79826,506,71250,93617,197,35809,33653
62867,206,45833,50761,121,57250,61753,85,25859,34106
62865,813,64408,73674,570,91136,87734,243,33750,40505
62864,9742,47896,68148,6228,63539,80244,3514,30368,42986
62863,4107,46740,66940,2536,70942,83828,1571,25516,38568
62862,127,52813,66117,95,54417,74083,32,22500,34747
62861,56,38000,51671,45,33125,47591,11,0,48518
62860,214,58036,61190,115,76250,78942,99,50250,40569
62859,2303,56477,67579,1505,66683,82674,798,26757,38779
62858,1246,51268,61006,850,60500,70143,396,26522,31981
62856,143,47250,57726,89,63750,65736,54,0,40352
62854,759,50671,50503,379,61125,61575,380,29211,37632
62853,388,66500,70740,281,72813,83019,107,31875,37993
62852,38,55000,55105,26,58750,65396,12,23125,32808
62851,60,53333,53802,21,78125,74538,39,46250,42633
62850,204,41667,66494,165,41938,73499,39,0,35495
62849,826,58929,66396,568,67857,73950,258,37083,44038
62848,259,60114,62318,180,75000,77730,79,17891,24381
62846,326,44412,54137,216,58375,65272,110,15893,29505
62844,863,54602,61126,546,60750,71575,317,22107,34946
62843,107,0,30347,54,46250,46096,53,14055,13885
62842,314,43077,53495,220,55625,65350,94,21000,25314
62841,29,48250,50769,23,48750,50287,6,0,32967
62839,2688,54722,81658,1651,72824,100927,1037,25885,42505
62838,742,53864,64643,571,57448,70593,171,30781,38627
62837,4087,51487,59906,2560,65000,73206,1527,26619,34685
62836,298,65385,81990,229,75625,92857,69,42292,45846
62835,476,34375,54478,359,40446,63746,117,15938,25820
62833,143,62292,64580,97,65813,69807,46,49583,53557
62832,3816,48981,61112,2509,57996,72079,1307,26159,35717
62831,185,62250,67335,109,78472,87182,76,25000,37579
62830,611,44476,58131,343,70694,77442,268,24259,30597
62829,31,0,0,0,0,0,31,0,0
62828,597,55508,69556,484,66250,75749,113,34063,38911
62827,578,44773,54218,329,55208,66002,249,32125,36240
62825,77,45156,54932,49,51875,69841,28,18000,25914
62824,726,48111,60704,450,56591,69187,276,32742,42978
62823,692,55469,70464,463,73750,84754,229,30096,36243
62822,1292,33676,47052,672,38750,55533,620,21595,35994
62821,3232,48384,62335,1992,61964,77769,1240,21742,35148
62820,64,53750,58611,40,78571,80733,24,11406,21742
62819,148,37917,47743,86,43750,57395,62,28750,30918
62818,154,62500,69078,89,78750,89885,65,0,40306
62817,313,49479,70760,253,0,78631,60,35804,36898
62816,532,57083,60157,361,65536,71860,171,28750,30953
62815,97,67083,63115,44,88750,80636,53,28125,48570
62814,719,58523,68766,547,66250,76556,172,25625,42567
62812,4649,46898,65133,2802,59789,78434,1847,25443,43576
62811,116,36500,49328,86,36000,40420,30,0,74867
62810,396,52500,60645,308,49000,62358,88,53929,54577
62809,57,68750,73651,39,74125,84774,18,43333,42861
62808,678,56213,68666,431,66042,77102,247,34427,42273
62807,431,83173,88471,340,103721,102524,91,25114,35435
62806,1490,54364,67173,987,68346,79431,503,33483,40926
62803,460,67500,71163,314,90272,86286,146,42750,37005
62801,8508,43682,59979,4805,61079,72517,3703,31061,41294
62712,4352,88879,113070,2832,111694,140179,1520,63202,62204
62711,6871,99050,127486,4699,130036,155251,2172,58071,66934
62707,3338,75521,88364,2226,103750,104914,1112,47632,52850
62704,19102,54314,77135,9690,77771,100600,9412,42235,50439
62703,12519,39043,54256,6730,51661,66992,5789,30158,37098
62702,15254,42773,54877,7966,54075,66845,7288,31123,39337
62701,529,21193,56776,88,25870,65940,441,16458,54398
62695,111,42639,53972,70,39500,59070,41,43750,41971
62694,1223,59469,69168,866,70625,80773,357,34306,38843
62693,633,90250,109291,443,106875,121966,190,62500,78924
62692,874,51484,70203,557,60855,85820,317,36806,41942
62691,939,63295,70936,555,69375,77755,384,47500,58120
62690,1652,68105,67121,1014,78083,76889,638,36304,47188
62689,249,48594,72519,130,68542,95687,119,32917,42516
62688,331,67784,80444,259,81250,90842,72,47750,42047
62685,874,55658,70724,620,80833,87543,254,18750,27215
62684,2127,117566,127764,1577,140036,148319,550,61500,67033
62682,299,67917,82042,242,83750,90081,57,34688,45521
62681,2087,53073,66582,1172,72138,81944,915,40201,46232
62677,884,70370,94358,627,86719,106795,257,56827,63755
62675,2532,75667,97766,1816,90423,94676,716,43750,99851
62674,669,39042,56356,452,50625,62326,217,25781,43529
62673,179,59063,70152,115,83365,89708,64,30625,31203
62672,85,47292,51372,63,54250,59922,22,21250,26886
62671,216,78000,99792,141,86513,120457,75,45208,56981
62670,1061,70592,83493,765,84306,93811,296,30658,44511
62668,584,58056,62241,451,59609,66783,133,29531,42228
62667,254,51607,62718,188,55714,73781,66,24118,30315
62666,199,71641,76614,152,79375,85351,47,27396,39619
62665,617,47772,54522,409,55288,62493,208,30179,33147
62664,1379,58688,80934,890,77400,105418,489,29277,34367
62663,83,47031,68494,68,53750,75178,15,0,31560
62661,550,60550,70758,368,61915,77356,182,50000,54828
62656,7004,52703,75050,4274,68938,86484,2730,33783,55250
62655,249,40208,61196,160,51667,77458,89,30750,30821
62650,10256,51921,69127,5968,64984,82448,4288,32837,48448
62649,188,57955,75354,112,70417,86414,76,43333,50570
62644,2078,46278,58232,1256,55536,63291,822,34375,46945
62643,278,68355,78430,174,77500,91798,104,52500,50603
62642,579,63047,67412,381,65313,74077,198,30000,43947
62640,1315,59583,71030,1019,67371,73986,296,43103,51904
62639,132,48864,77402,75,83875,110201,57,26321,30475
62638,553,72132,110946,418,72125,123989,135,50729,57129
62635,243,49625,65137,157,59821,78555,86,26667,37220
62634,398,75682,93337,292,88750,108466,106,48125,49361
62633,250,43000,55173,200,43500,57127,50,36250,47356
62631,137,38380,47300,91,38221,44844,46,0,50291
62630,258,68333,93420,229,72813,99870,29,34141,42490
62629,5358,98982,118308,3969,112886,133640,1389,53097,66371
62628,334,60000,73975,212,74265,86473,122,41000,45989
62627,426,56250,72141,244,85833,90066,182,0,45258
62626,3011,59429,70530,1990,73611,81595,1021,32578,42862
62625,350,120156,116787,274,130250,132858,76,48194,58849
62624,172,39231,59716,94,0,83224,78,22857,24967
62622,0,0,0,0,0,0,0,0,0
62621,439,65417,76748,335,75938,86580,104,39375,42203
62618,2785,47093,57153,1840,56667,64854,945,29387,37242
62617,294,42321,50417,134,43971,62483,160,40208,39881
62615,2069,72256,85512,1402,100222,99654,667,42431,54372
62613,1596,90455,100550,1241,105225,108722,355,51220,65711
62612,725,61645,74887,487,68029,85882,238,52794,48195
62611,460,64924,82342,359,80673,92348,101,36359,45221
62610,60,40000,48882,34,52500,62941,26,30000,30362
62601,123,71750,72298,80,72000,80978,43,0,50681
62573,581,65417,75691,452,81731,85570,129,36875,39218
62572,236,60000,68746,147,80625,79632,89,43798,47356
62571,712,63333,69090,526,74375,77913,186,32813,40652
62570,239,90246,83790,128,71250,97387,111,90301,67758
62568,6463,50695,64126,3572,69357,83581,2891,26819,39338
62567,393,54554,61080,227,65313,69645,166,42778,48584
62565,3178,57342,65632,1867,71108,77674,1311,39496,47717
62563,2165,100170,116670,1704,104713,124806,461,50078,60987
62561,2347,39882,67721,1591,63689,77359,756,33497,42855
62560,446,60119,74490,343,68194,83617,103,27361,39221
62558,1344,76250,90851,994,77434,100256,350,56333,60935
62557,3174,49784,59032,1914,55410,68825,1260,32118,39717
62556,163,64688,67105,123,78750,77171,40,33000,34263
62555,175,82019,78643,142,84333,86017,33,42159,46606
62554,559,86250,101395,461,95275,109924,98,57857,59367
62553,154,59583,65856,128,59063,67919,26,48750,53258
62551,313,62969,71447,167,72625,84757,146,47143,54260
62550,1215,70947,76038,879,88355,85588,336,32143,48147
62549,2302,74463,93017,1771,90893,105924,531,36875,45593
62548,981,62418,81657,620,80500,99037,361,45083,50489
62547,382,64000,67831,273,69805,79841,109,31875,36895
62546,654,70000,84036,456,80921,97754,198,36364,43544
62545,520,76875,93999,351,111250,113495,169,52083,49082
62544,645,84083,89820,511,86046,98784,134,38333,46237
62543,195,54638,70575,104,81875,83560,91,53346,55263
62541,10,0,0,6,0,0,4,0,0
62540,666,56827,73738,383,85313,92168,283,28173,42702
62539,509,64531,65752,335,76635,79596,174,25500,37921
62538,197,47604,63402,157,49063,68190,40,0,44365
62537,54,47955,45959,23,0,50452,31,48750,42626
62536,217,130917,143132,144,116389,132315,73,209750,164470
62535,1282,95000,125170,954,126282,144435,328,48750,65674
62534,525,59205,68229,400,65000,78263,125,25875,34442
62533,392,64375,70664,272,71250,81389,120,40000,45764
62532,44,0,49827,14,0,0,30,0,29140
62531,657,85855,87039,487,91607,92327,170,52188,66292
62530,643,62212,68984,360,90000,88146,283,45469,42385
62526,14171,40800,57054,7110,61842,73710,7061,30343,38855
62523,336,13250,20048,72,20476,18219,264,11957,20547
62522,6094,49348,62230,3539,64315,75958,2555,35299,41383
62521,14582,57010,78014,9059,70808,92879,5523,38743,51579
62520,659,80188,84241,468,84219,92854,191,47422,54999
62519,37,0,0,17,0,0,20,0,0
62518,59,36250,48907,31,62969,65645,28,24688,30375
62517,77,59250,68032,60,59500,69302,17,0,52765
62515,399,83050,84504,314,89063,94837,85,0,43096
62514,156,50500,72534,118,50167,78801,38,0,40697
62513,646,60263,76266,431,74792,93368,215,38287,41777
62512,202,49000,64557,122,60000,70406,80,41250,55639
62510,743,45734,53945,331,65469,74663,412,33125,36974
62501,1000,76957,88337,728,98333,105174,272,28438,39149
62481,141,52788,59822,118,57500,68403,23,0,15796
62480,234,35882,47131,160,45455,52714,74,25833,33026
62479,297,65129,65779,222,66466,73980,75,36750,41164
62478,107,46420,63898,76,68571,74170,31,0,38719
62477,228,45556,59886,185,57344,67452,43,0,26902
62476,629,53950,62768,435,74563,75294,194,32143,33942
62475,182,61613,64890,135,60524,66528,47,63750,60185
62474,325,54948,64689,226,59583,71578,99,32917,40043
62473,483,59141,56961,332,66974,66559,151,22159,34317
62471,3649,43481,58927,2329,55536,70907,1320,25407,34097
62469,223,47150,58121,162,75781,65857,61,37875,37577
62468,976,68295,70582,661,75919,78458,315,30673,49470
62467,1527,85226,98138,1125,97340,114077,402,46719,51296
62466,1179,63353,67560,763,80625,76640,416,35735,46186
62465,348,70948,77837,278,77045,87242,70,38750,40487
62463,491,52292,60875,320,70833,74819,171,19816,30595
62462,471,48852,69039,365,62679,78792,106,31500,35331
62461,307,58281,75525,203,57054,82719,104,60000,60762
62460,485,48977,70080,331,64688,84833,154,22500,37373
62459,112,53000,59813,85,63393,67385,27,28750,30215
62458,824,47386,63118,637,51891,67378,187,27279,46770
62454,3991,50514,71220,2619,71328,90104,1372,22150,32809
62452,119,34811,49471,89,45938,55312,30,23750,27093
62451,902,51200,67361,567,57530,78795,335,33203,43171
62450,5154,54014,65448,3277,70856,79766,1877,27074,36205
62449,1488,48450,60179,1052,50151,69351,436,27656,34755
62448,2263,52729,67132,1505,73750,79758,758,36583,40487
62447,1289,74150,82164,957,85997,96628,332,28625,38660
62446,150,69643,80489,117,69107,79132,33,0,76752
62445,427,56875,64243,317,66250,72416,110,30764,31655
62444,173,38036,56631,117,48839,71909,56,19038,21089
62443,625,57621,66571,426,59750,77930,199,41289,42060
62442,1181,52813,59816,867,63525,69004,314,18088,28144
62441,2972,68363,80136,2347,72321,83275,625,40019,58274
62440,528,48182,60578,345,68125,75499,183,30469,32095
62439,3170,47297,68342,1974,52692,73612,1196,32984,53569
62438,113,67386,55904,113,67386,54681,0,0,0
62436,226,49167,55784,181,54688,61706,45,14940,21753
62434,134,80893,86312,124,81786,87476,10,0,0
62433,468,52407,67110,263,81295,92525,205,32961,34505
62432,299,113125,104112,220,150147,126450,79,0,39990
62431,366,52315,65730,274,55000,67394,92,25833,60774
62428,1145,46895,68297,685,72676,77859,460,26189,52803
62427,839,58899,70440,559,85179,86835,280,30526,35275
62426,361,45078,51014,272,43750,47668,89,46250,57696
62425,226,84167,76963,150,104688,95057,76,32273,41250
62424,890,68800,84722,656,87813,98621,234,41667,41174
62423,203,88955,81761,172,88934,85356,31,0,0
62422,453,45114,60586,293,66146,74115,160,23500,31233
62421,201,70625,68202,171,72798,72441,30,36250,40757
62420,2045,52946,67324,1308,70000,80745,737,35906,42003
62419,103,53393,77607,62,54167,97826,41,43750,41780
62418,848,46907,69656,514,68250,80518,334,32917,51183
62417,1269,58404,72305,774,61528,84492,495,55417,47019
62414,707,45121,60438,426,65968,77597,281,21354,30735
62413,138,71154,92601,86,82500,115577,52,60625,54602
62411,1755,53295,78642,1169,78552,98520,586,33857,36127
62410,449,71620,89869,367,75114,98569,82,29583,46279
62401,7874,57384,84974,5037,76446,109729,2837,30014,37616
62380,133,56776,55072,81,48313,50737,52,55263,41865
62379,778,56000,76978,487,72697,96212,291,25729,43790
62378,394,54167,74872,237,99583,108074,157,20822,24013
62376,452,64286,80091,325,75417,89086,127,31806,49802
62375,275,76250,78023,191,94519,94165,84,36587,40917
62374,190,45385,48594,70,52000,58499,120,41250,42187
62373,118,36400,70051,62,69615,111905,56,21875,23713
62370,129,57232,68421,59,83021,83897,70,0,55376
62367,543,50855,54933,399,69271,59806,144,22344,39365
62366,591,50489,61996,403,62031,73369,188,26250,35889
62365,201,59792,77418,135,89940,94882,66,28750,32377
62363,2306,40635,60009,1368,68955,77268,938,23661,31797
62362,147,31750,44744,72,60000,63471,75,18906,26767
62361,116,48269,53032,95,49519,56342,21,40625,38057
62360,667,64042,77022,523,74375,83970,144,43095,47252
62359,55,0,81680,35,0,0,20,0,0
62358,214,62000,67643,165,65313,67943,49,0,63686
62357,144,48071,60991,70,48889,75601,74,47778,45374
62356,225,53542,74354,154,90345,94008,71,0,29989
62355,308,50000,74574,236,64091,88628,72,19375,27286
62354,543,49567,61317,427,53355,63982,116,32857,43612
62353,1421,56633,63520,799,76681,78380,622,38017,43033
62352,109,34063,48911,76,40000,53097,33,33438,38473
62351,704,70132,81183,533,85375,95466,171,28125,35552
62349,315,52898,64317,229,62250,73414,86,35833,39107
62348,38,66250,69784,32,73750,74059,6,36667,39017
62347,693,70642,77084,536,75878,83300,157,45954,46375
62346,77,62917,73795,51,63750,53398,26,0,113804
62345,177,65063,70634,121,65987,81430,56,23558,28313
62344,12,0,0,12,0,0,0,0,0
62343,319,47269,62702,220,51042,58919,99,32083,53883
62341,1387,56629,83994,902,86184,109028,485,26264,32338
62340,742,45357,63447,515,54792,74290,227,30156,38844
62339,381,60114,66143,244,79821,84791,137,0,30499
62338,445,63467,69902,333,72652,78883,112,0,36330
62336,16,0,69044,11,0,86982,5,0,29580
62334,67,25938,38587,30,43750,53783,37,21250,24397
62330,798,51154,60520,492,74722,75748,306,25300,31038
62326,967,43750,57822,576,61522,69972,391,26985,36206
62325,161,69625,71580,116,69750,74520,45,49583,62451
62324,509,54323,64942,381,65750,74620,128,24722,33779
62323,82,56667,72237,48,64167,101150,34,0,31418
62321,1623,69345,81189,1058,87065,98794,565,37361,47662
62320,863,65156,68466,612,61630,73287,251,32083,44679
62319,103,0,50808,47,85893,81768,56,23523,24823
62316,296,57857,57246,181,61779,74563,115,14964,25726
62314,273,69135,71284,157,120146,100284,116,0,32034
62313,191,67569,66695,147,78750,76045,44,0,35457
62312,773,54625,64666,492,68182,78298,281,32426,38990
62311,376,36463,44324,159,67723,64948,217,28036,29212
62305,7886,75063,96647,5628,87973,110279,2258,47639,59431
62301,13618,43155,60533,7602,59977,74808,6016,29020,40509
62298,7033,79069,96115,5099,102125,115244,1934,37373,44168
62297,182,60952,68016,102,0,73040,80,62308,61611
62295,530,78750,88800,388,92500,101303,142,42083,52967
62294,5283,86775,101302,3898,108542,120836,1385,31301,43223
62293,1685,69375,92194,1099,103063,117351,586,33000,41118
62292,341,38365,53763,223,52292,64413,118,16477,26872
62289,114,39167,51289,76,37917,53234,38,29167,37608
62288,1191,60734,70632,818,68314,80950,373,26708,40529
62286,2643,56969,75638,1806,74000,84481,837,30644,52863
62285,1745,98424,116340,1396,113125,118453,349,41349,105646
62284,222,37500,52152,165,50673,59793,57,21250,23023
62282,201,72639,77134,163,73750,79220,38,58750,68189
62281,958,100641,118029,775,103776,130683,183,40417,62054
62280,214,92292,127636,182,99688,137998,32,0,43050
62279,6,0,0,6,0,0,0,0,0
62278,2563,63657,89664,1844,81486,105533,719,33442,46241
62277,496,64500,73645,342,76000,88828,154,33214,38667
62275,1267,75938,82030,927,91417,94400,340,40096,47303
62274,2779,47431,58634,1911,61686,69147,868,20588,32296
62273,85,60625,54873,60,77778,62638,25,43542,36232
62272,660,48712,63306,439,54375,72041,221,32375,39735
62271,832,70795,77012,574,90769,92095,258,30357,42324
62269,12419,86493,112975,9221,108623,131602,3198,47364,55433
62268,369,73750,79253,237,105924,99334,132,27857,38081
62266,0,0,0,0,0,0,0,0,0
62265,1720,82614,99640,1031,101307,106070,689,67125,88472
62264,1301,68950,75456,900,81100,86860,401,37639,45824
62263,2138,60804,79583,1424,77984,92682,714,36548,47895
62262,786,45303,56959,491,69926,73455,295,21875,27793
62261,39,31012,34085,8,0,0,31,30865,34742
62260,2747,77083,97104,2074,93750,105014,673,41067,67024
62258,3334,77984,88717,2461,83610,98775,873,52386,56133
62257,994,64091,71510,690,73167,82018,304,36000,45227
62255,317,58625,77216,231,67159,86658,86,39063,48979
62254,2281,68342,79219,1407,81783,98455,874,32384,44800
62253,297,34879,47487,209,34095,52798,88,24318,31034
62250,259,57550,63015,186,62778,75734,73,26458,29792
62249,6559,76859,97421,4520,94098,118805,2039,39462,46754
62248,158,65833,73143,96,81667,86223,62,48182,51924
62246,3655,53380,72672,2223,70380,85788,1432,35752,51354
62245,780,69821,81259,509,80875,92574,271,39904,53158
62244,407,64830,82404,303,92768,98823,104,25192,29664
62243,2255,76653,92856,1725,89583,107393,530,36200,41247
62242,514,61500,70063,379,72250,77959,135,34219,41636
62241,355,69205,71609,263,87670,80184,92,53750,46292
62240,551,34976,51938,389,33591,57065,162,36250,36959
62239,1936,48707,65330,1057,68702,76034,879,28388,47003
62238,252,59722,63590,167,60568,71860,85,0,45673
62237,1053,50250,63228,670,69750,76961,383,23594,37719
62236,5175,108308,130969,4091,122733,142897,1084,49028,80545
62234,13713,58421,77591,8971,72124,85949,4742,32525,58315
62233,2759,53210,67925,1538,77022,89266,1221,29349,39118
62232,2429,61899,88608,1605,77889,105895,824,41610,41835
62231,2795,59883,70492,1988,72917,80225,807,36475,42988
62230,2685,73790,94778,1759,90731,103504,926,31888,77729
62226,11997,58686,82726,7066,86274,109547,4931,32998,41770
62225,1481,74087,83307,1271,76057,86731,210,0,57813
62223,7620,63193,77985,4354,86723,100753,3266,33883,44156
62221,12611,67178,84082,8195,89549,103774,4416,32899,43940
62220,7521,56486,69202,4289,73602,86161,3232,33865,44429
62219,430,51875,53356,252,59167,66583,178,25417,32926
62218,698,85515,99683,505,97656,116991,193,21442,52234
62217,378,53000,65119,239,66250,75659,139,43594,46444
62216,945,81198,101464,699,101042,116013,246,42155,53857
62215,776,85714,89685,593,97724,98840,183,43438,56184
62214,556,82543,81153,424,84327,91084,132,32361,47245
62208,6830,68604,81192,4174,84355,99196,2656,46094,51165
62207,3823,21228,32596,2032,28771,40471,1791,16691,22428
62206,5475,29779,45965,3598,31162,49690,1877,19934,30379
62205,3151,24838,42376,1408,44167,58268,1743,18602,29445
62204,3526,24487,38913,1778,29375,37816,1748,18850,38584
62203,3138,33490,48504,1760,53567,64031,1378,22045,25839
62201,2687,15226,28060,1430,20484,35034,1257,10286,18966
62098,7,0,0,7,0,0,0,0,0
62097,1073,82670,92920,875,90972,96819,198,53542,57471
62095,4434,51392,63189,2618,65417,71550,1816,36571,47245
62094,373,41458,57744,228,65000,76776,145,25156,27552
62093,143,41696,48560,72,58333,47249,71,35417,41177
62092,1106,42885,55390,668,54167,66491,438,28333,35247
62091,138,68750,86360,105,110521,89816,33,18229,35897
62090,505,36696,47175,312,34773,48014,193,22393,33419
62089,192,47500,66748,105,48750,60295,87,27454,69669
62088,2834,54238,64955,1603,66701,79434,1231,40456,44586
62087,876,41769,53035,571,52933,55523,305,32301,36158
62086,501,52361,59063,304,67679,73005,197,25125,37385
62085,61,35625,54310,39,46250,68621,22,26875,27777
62084,710,50962,74273,484,62143,67830,226,37500,87615
62083,105,0,38121,28,101250,93814,77,16335,17869
62082,1031,50372,59323,735,58179,69850,296,25900,32302
62081,114,0,49745,69,70313,61446,45,20781,25318
62080,855,43177,60979,628,57500,71159,227,24659,30530
62079,88,0,48884,80,0,50190,8,0,0
62078,28,47500,51432,20,72500,65875,8,25000,14338
62077,111,55114,54476,59,57083,63059,52,45833,43356
62076,59,42679,56264,28,0,84014,31,27917,31203
62075,1414,63633,72476,972,76585,85681,442,18478,41645
62074,485,72917,83933,372,87188,95841,113,43188,43580
62070,0,0,0,0,0,0,0,0,0
62069,1455,50382,65654,937,64044,80349,518,30377,37559
62067,824,70930,86176,614,83564,101078,210,38274,36065
62065,52,129000,109869,38,0,0,14,0,0
62063,413,58125,77585,281,93750,100830,132,21333,27286
62062,3427,82549,100851,2313,116793,119870,1114,45403,58204
62061,687,75275,85338,475,89323,99273,212,52679,53052
62060,2017,26688,37223,1123,30216,41550,894,25897,31109
62059,172,18500,24602,118,28000,30103,54,12500,11826
62058,345,57250,64338,198,64219,74203,147,32813,47064
62056,4048,50833,63004,2344,63203,82084,1704,21649,35149
62054,152,41875,47728,107,47083,53797,45,21563,27896
62053,182,51923,56775,121,57750,66058,61,27679,36223
62052,4789,66324,84813,3127,98456,109719,1662,32378,36947
62051,369,52869,52792,194,54490,75782,175,14375,27247
62050,116,62500,70603,86,85179,80551,30,50278,40863
62049,2567,65625,75122,1637,78965,92486,930,33068,43488
62048,747,38580,57118,392,58875,70504,355,33570,38581
62047,507,72634,79529,389,85250,92087,118,14940,32374
62046,282,70000,76425,166,88750,97908,116,24375,37039
62045,175,76250,88437,155,79125,94456,20,38750,41780
62044,855,60590,77142,610,75417,87573,245,37171,46427
62040,17726,53964,63593,11428,65243,73079,6298,29946,42801
62037,790,55000,72965,515,88802,96137,275,0,29569
62036,277,88438,93548,169,104063,114879,108,40833,60169
62035,7051,69866,86588,4677,91882,102810,2374,40625,51378
62034,5528,84000,108462,3744,106900,128290,1784,45970,64323
62033,1979,50689,69629,1405,56823,77356,574,28795,39437
62032,339,64250,90486,223,86384,119295,116,33667,34272
62031,284,55000,72012,194,95313,90168,90,32614,32878
62030,55,28125,34915,45,38594,39709,10,12500,13340
62028,304,50764,61279,151,84306,93515,153,22466,29020
62027,238,80227,82253,163,93188,101625,75,19375,36875
62025,12548,84715,111485,8193,120472,141647,4355,37768,51685
62024,4107,67610,73509,2688,74601,82541,1419,31659,48990
62023,30,58750,64640,27,41875,64344,3,0,0
62022,387,79306,83936,256,83167,84575,131,65875,75127
62021,387,87054,93755,296,94655,106096,91,49141,53613
62019,148,51250,58826,121,0,65935,27,11458,21333
62018,1123,46359,49625,815,48442,51818,308,22375,30890
62017,569,42813,59281,253,51458,68055,316,27195,52116
62016,1479,55644,74431,966,66696,91852,513,25563,37852
62015,239,58750,63281,190,61250,69513,49,0,35031
62014,1458,63500,70934,1060,72756,77113,398,42679,48324
62013,224,56293,75673,145,86250,101141,79,24028,28928
62012,2396,80000,91021,1876,85000,100511,520,38512,46335
62011,101,34438,37923,71,35804,45739,30,10000,16843
62010,4469,68875,84558,3165,83183,97798,1304,36107,48196
62009,762,37685,47480,445,59375,64774,317,24712,22243
62006,177,67917,79763,143,78375,89848,34,0,37344
62002,13430,48720,65294,7755,64920,80001,5675,31594,42425
62001,682,68472,72592,414,97500,96221,268,27500,35807
61957,722,52857,60118,508,61890,68148,214,26136,35694
61956,1218,56389,65969,801,77596,74183,417,36641,48833
61955,72,56667,58015,46,55833,51600,26,44167,50042
61953,2500,59038,76892,1499,85368,89818,1001,25612,54293
61951,3076,69475,80351,2098,86651,97783,978,32875,41865
61949,85,53250,60576,48,73667,75354,37,48750,41408
61944,5541,45836,58118,3607,62572,68165,1934,24322,36902
61943,782,46591,59879,448,66923,79926,334,23478,32348
61942,497,63082,68974,359,64730,82303,138,26875,33941
61941,60,36563,41713,60,29063,34717,0,0,0
61940,155,46213,52330,134,46985,56587,21,26563,22771
61938,9159,46468,69968,5373,62144,85718,3786,25888,44248
61937,825,51688,61063,480,62857,75710,345,33375,36515
61936,99,79417,105045,68,107593,93684,31,0,129965
61933,448,45769,69837,257,59107,92212,191,28365,38601
61932,240,58333,66122,163,72188,81383,77,25250,32530
61931,492,46250,54752,334,62143,61652,158,38750,32395
61930,256,69250,81041,189,86042,95808,67,35288,35091
61929,332,53750,82500,177,62344,110543,155,0,45158
61928,344,69167,74662,248,89792,88493,96,36078,36180
61925,425,64922,82058,315,72431,93858,110,39485,46065
61924,971,64844,73791,662,80125,88359,309,31033,42164
61920,9166,46272,66930,4855,59594,88869,4311,28454,39384
61919,338,62500,69853,231,78603,79249,107,43086,43199
61917,243,50114,57278,156,60000,65788,87,23438,41830
61914,834,52000,58551,500,64091,72414,334,25833,36500
61913,610,48750,62189,453,55772,70060,157,30673,31524
61912,639,53359,64844,422,65161,71463,217,36012,49109
61911,1751,65924,78995,1354,80016,89767,397,29955,35709
61910,1535,63451,76980,1115,67091,81500,420,49516,56805
61884,398,104898,160369,330,134211,177985,68,76563,71015
61883,1713,48064,58168,1174,59800,67034,539,34426,38117
61882,284,61250,71689,180,71667,77448,104,38750,58939
61880,1464,85104,81629,1044,98664,98649,420,33500,38206
61878,560,66000,88014,393,96250,104466,167,40375,45535
61877,596,80341,94954,428,85000,102716,168,63056,73123
61876,246,62500,65359,184,71667,73750,62,42625,37531
61875,287,140903,131841,219,141968,147063,68,0,79337
61874,3435,72584,89753,1750,107738,117158,1685,55316,60100
61873,2137,93493,99857,1530,105784,117306,607,34222,52031
61872,253,63750,75718,161,78984,85962,92,38750,53128
61871,138,75500,83792,94,90833,94434,44,53750,58152
61870,492,45577,57287,334,59286,67608,158,27083,34784
61866,5481,43419,57556,3232,50409,63970,2249,35396,47028
61865,565,63393,76993,403,75551,85902,162,43333,50616
61864,583,79803,97681,436,92778,107424,147,43063,64974
61863,295,75625,76668,166,89583,90349,129,38125,58684
61862,250,86250,107964,186,117813,128173,64,47885,46233
61859,479,74740,89415,339,103375,107504,140,38571,43808
61858,1087,60250,68319,770,76167,78176,317,32557,38403
61857,72,0,47368,25,71250,67512,47,0,36653
61856,3258,80274,86684,2293,96373,97822,965,39714,51658
61855,39,0,62190,39,0,61264,0,0,0
61854,557,62163,75359,400,76250,83016,157,41307,52394
61853,4828,98575,111747,3896,108441,123280,932,41667,59298
61852,89,0,80920,64,132500,94961,25,24583,43548
61851,153,60417,77137,79,61875,70789,74,58750,83862
61850,156,55156,62226,124,56250,61412,32,34250,65041
61849,853,81679,111406,634,87596,103817,219,41477,131721
61848,67,53750,56382,52,50000,54477,15,50625,44793
61847,502,69615,80263,331,85313,97549,171,38542,45815
61846,2179,49759,63996,1390,65299,72746,789,37560,46848
61845,161,88125,156117,114,94259,194813,47,71250,61451
61844,370,82632,104592,246,93750,127518,124,41389,57873
61843,832,70114,90604,659,81719,102281,173,34063,38279
61842,1064,69479,71986,722,86169,88909,342,27500,35019
61841,482,60313,67319,323,69107,78654,159,31964,42983
61840,238,82813,94034,213,68958,90053,25,0,105092
61839,252,65385,74872,183,77625,84745,69,32750,48059
61834,2683,69278,84358,1858,79286,98241,825,41514,50555
61833,1005,44670,55625,499,55875,69762,506,42596,41151
61832,14291,38511,54827,8069,47460,64833,6222,28384,39018
61831,83,64583,73623,47,0,83119,36,0,61225
61830,185,64063,72902,142,64375,78323,43,26250,42393
61822,10452,85270,115735,6914,105947,140440,3538,54189,66227
61821,13189,56200,76357,7255,72018,93480,5934,41112,53985
61820,14307,27346,47331,3478,57315,78726,10829,20355,36749
61818,641,59583,74188,447,78438,84368,194,37167,41807
61817,1086,54300,64046,666,71522,78183,420,33000,40957
61816,169,63750,98231,114,92500,123027,55,0,46835
61815,124,59545,79224,60,80000,109947,64,42115,49806
61814,459,58274,65782,330,65625,77582,129,24399,32816
61813,689,50563,64273,429,57375,72409,260,27500,39652
61812,133,78250,108281,104,88125,128522,29,0,31628
61811,304,54167,57511,219,58393,58532,85,41845,44616
61810,111,58750,60883,80,68750,68140,31,28750,41300
61802,9011,48551,69818,4887,66546,89576,4124,35374,45317
61801,12058,32569,52797,3854,63203,87872,8204,23260,35321
61778,265,66125,74033,178,87500,85487,87,46771,49298
61777,488,76272,90767,304,86406,106785,184,75088,60386
61776,491,107175,122578,331,133906,129097,160,69167,101316
61775,138,0,74188,68,108500,114284,70,26604,34933
61774,363,73015,80050,281,74485,83551,82,41667,49470
61773,156,54063,54653,86,78214,73606,70,23750,31099
61772,87,75536,75584,79,76964,80635,8,0,0
61771,235,74583,98288,203,88542,108294,32,25833,30144
61770,452,52750,66146,288,71471,80305,164,36250,41281
61769,246,51667,63401,209,58750,66851,37,26406,38505
61764,5338,54760,74582,3381,72959,89265,1957,29635,47060
61761,19719,58344,81448,10368,97364,118429,9351,28246,38665
61760,968,56397,73872,587,83098,90411,381,42721,47334
61759,579,68523,85510,420,69286,90576,159,41827,56640
61756,871,71563,86464,674,86563,99759,197,29688,37832
61755,1881,80885,95765,1335,92019,108209,546,68359,61485
61754,432,78409,94818,345,85521,109663,87,26250,34594
61753,1137,85298,94622,845,109219,109848,292,38548,50122
61752,1708,80735,90920,1151,94438,103716,557,44018,61725
61751,39,67250,59818,26,80250,64431,13,0,0
61750,61,58348,57262,38,44545,55689,23,0,0
61749,319,61250,68264,141,60536,78653,178,61250,59558
61748,948,98158,118351,694,105441,134207,254,52857,67651
61747,581,67813,80918,380,88917,99941,201,44375,44466
61745,1676,78269,82762,1203,90523,94403,473,32639,51020
61744,728,70795,77853,521,80724,88204,207,32656,43453
61743,66,65833,70229,43,71458,82756,23,27031,40235
61742,492,92500,103154,358,109375,115061,134,47500,70769
61741,654,74000,76494,505,85208,87646,149,28750,37257
61740,581,67009,92981,379,99375,112585,202,40833,53465
61739,1883,61375,73423,1275,79193,88015,608,31912,41600
61738,1535,72764,100065,1082,85377,116207,453,34345,55414
61737,164,75375,77303,119,84375,90558,45,0,42251
61736,717,91327,114285,563,97321,125578,154,90052,69681
61735,170,63750,68396,144,75536,72636,26,33333,44912
61734,1081,68750,79682,829,77546,87546,252,48125,49761
61733,405,66058,73048,257,80327,79510,148,41711,57359
61732,726,81500,106409,547,95197,119621,179,60938,65625
61731,40,0,96220,34,101500,108456,6,0,0
61730,155,60208,72302,103,68250,84623,52,53333,47898
61729,460,68409,77965,377,80179,87205,83,35972,35995
61728,432,61167,77625,273,64688,89573,159,36607,46108
61727,4038,52566,69215,2424,72659,87511,1614,31126,39869
61726,949,61250,88331,741,68594,100029,208,32813,41272
61725,647,116083,132021,511,133542,150581,136,45263,61893
61724,184,66250,92271,139,74063,100044,45,38750,66816
61723,1055,70355,78542,787,77292,84520,268,36339,54536
61722,206,74706,81228,171,74338,79794,35,80893,69954
61721,276,77045,73157,223,79330,80595,53,34583,38545
61720,77,60859,65834,61,39861,62589,16,32500,33163
61705,4648,102875,122979,3589,127792,143588,1059,45234,50941
61704,14834,86383,108505,9853,109474,131708,4981,44250,61190
61701,15197,47773,61378,7260,68510,77020,7937,33228,45752
61625,0,0,0,0,0,0,0,0,0
61616,2788,45921,73216,1271,56463,102145,1517,37313,47097
61615,9472,72873,104219,5644,101132,135553,3828,42356,56579
61614,13175,62042,81637,6738,83984,106625,6437,39415,53288
61611,10233,65714,80673,6783,80498,89363,3450,39177,60368
61610,2257,46250,72262,1285,56583,90930,972,39063,44196
61607,4373,64389,75531,2860,83320,88931,1513,41034,47618
61606,2554,44394,65114,1220,67778,82815,1334,24130,47500
61605,5726,23107,31894,3262,31101,36962,2464,14718,21862
61604,11985,47573,58667,6653,54416,67514,5332,32042,43706
61603,6541,33071,43879,3453,42263,50662,3088,22096,31519
61602,449,0,35599,55,0,75878,394,10600,29976
61572,511,53594,66605,306,68000,91998,205,20774,23667
61571,9521,77811,93950,6670,93556,109612,2851,38877,54593
61570,726,58056,72520,457,76477,85179,269,35592,50268
61569,404,83304,90998,326,91250,99479,78,54375,55547
61568,1610,76129,103186,1167,90655,122708,443,42992,47531
61567,215,58882,58840,132,64286,63407,83,38750,45520
61565,662,61250,67694,417,80078,83821,245,30787,38929
61564,327,58385,63555,274,59167,65049,53,31719,45160
61563,206,45729,52849,132,46250,60423,74,23750,37750
61562,44,0,55795,6,0,0,38,0,0
61561,893,64531,74164,662,73472,82540,231,30179,37930
61560,327,63098,61414,235,64946,70124,92,0,36938
61559,1290,55833,70388,996,63750,78818,294,33750,36816
61554,17629,53602,67446,10289,70713,83844,7340,37931,42075
61553,82,51875,64990,50,58462,60286,32,31667,66350
61552,90,85606,63028,77,86098,71966,13,0,0
61550,7212,80496,99867,4998,93950,118201,2214,46226,52446
61548,4417,96996,122027,3427,115823,138031,990,54313,66250
61547,1455,94344,106832,1198,102931,115720,257,73882,63017
61546,1582,63198,77747,1141,72891,84681,441,32784,52203
61545,284,66657,76638,218,67113,82002,66,52500,57945
61544,297,61776,94307,196,76250,105659,101,32875,69635
61543,72,37500,44428,29,65938,57214,43,36625,35805
61542,1436,61523,71237,987,85368,87470,449,26875,32831
61541,55,30625,45904,32,44583,56347,23,19583,31374
61540,1000,62568,79183,730,75577,89708,270,31538,45364
61539,68,52500,54104,43,53750,59384,25,41250,42828
61537,1167,50708,58804,681,70063,74929,486,24000,35340
61536,1251,61560,72761,852,77179,85596,399,40363,43035
61535,657,116266,112521,616,116612,116194,41,0,0
61534,690,66400,78466,557,70536,85379,133,36438,40567
61533,792,59828,73887,599,65729,78161,193,39875,48791
61532,249,54417,81124,181,68672,85035,68,27500,39044
61531,1315,58484,72477,819,62153,77947,496,44052,61735
61530,2608,57519,77944,1672,73125,92168,936,29881,51971
61529,1007,75587,82056,717,81005,93697,290,37000,50473
61528,1016,135450,156061,845,142788,162628,171,0,123609
61526,295,91250,123949,197,109821,151151,98,0,69269
61525,3192,131736,171856,2629,146250,187920,563,67731,87991
61524,156,51591,64587,121,73472,69273,35,25250,42526
61523,4329,63019,81349,2989,79979,98510,1340,31163,40582
61520,6359,48567,75817,3695,62629,93731,2664,29635,47937
61519,86,47188,83362,63,95750,104754,23,0,22104
61517,1193,74981,114859,934,91029,131108,259,30268,54519
61516,285,76641,88639,202,87763,93192,83,52083,47925
61501,835,40928,54255,466,52177,67736,369,27148,33030
61491,933,57361,77194,612,79250,97292,321,27788,35484
61490,470,57656,75717,297,90625,101207,173,21313,31050
61489,351,65489,79204,239,76188,90664,112,36667,54296
61488,531,54375,64603,357,69208,74378,174,38269,42267
61486,595,65417,79604,431,80313,90354,164,51250,49210
61485,177,47656,58115,115,51042,66525,62,31667,40744
61484,363,50208,57305,257,55156,68463,106,21667,28920
61483,831,52844,60916,558,66033,73329,273,24485,34010
61482,256,59464,62158,136,67500,71600,120,53500,48088
61480,448,54444,59860,341,71417,67609,107,25250,30584
61479,41,0,83951,36,11957,89917,5,0,0
61478,90,121167,108382,34,121000,116888,56,127619,103218
61477,219,46875,55739,128,56250,69116,91,30938,34366
61476,178,52500,74743,136,66000,73683,42,40962,64700
61475,101,82554,74925,67,78281,80200,34,83152,64532
61474,101,52292,64322,69,59219,79396,32,0,30969
61473,550,46726,61467,352,51389,65083,198,36591,37569
61472,250,70547,69188,166,80375,83386,84,0,40985
61471,43,64464,89209,40,58750,84840,3,68750,52633
61470,222,42500,57975,143,75486,78299,79,0,19018
61469,1004,44630,54591,617,59063,65093,387,25873,36820
61468,60,61538,67923,25,0,0,35,34135,41420
61467,437,81563,82067,324,91250,90993,113,33375,47331
61466,121,74107,106783,85,79219,129416,36,48636,45681
61465,550,66364,72016,371,73472,81894,179,40625,50303
61462,4396,52401,67486,2890,66571,75665,1506,35097,46899
61460,121,61806,68703,99,63194,72722,22,35000,47073
61459,151,74263,78236,105,78472,88544,46,51250,54707
61458,239,56641,62629,173,66250,65922,66,33750,52105
61455,7491,40340,60864,3291,78910,92954,4200,23426,35067
61454,202,41250,55712,156,51250,61300,46,24559,36761
61453,260,47500,56987,159,53750,65974,101,34531,41092
61452,100,50500,53842,75,70250,62613,25,20750,26660
61451,83,60417,82827,66,88750,98223,17,0,23047
61450,820,51786,60772,510,68571,76753,310,20000,31571
61449,143,41146,53756,45,47708,53889,98,32500,53517
61448,1399,59625,72326,903,77083,90728,496,28529,36403
61447,439,81563,113768,317,105417,127971,122,38750,72931
61443,5603,41130,53896,3559,49415,65028,2044,21560,30642
61442,319,31375,59792,227,45625,65566,92,25909,44418
61441,418,47105,58369,291,69712,70029,127,30052,29406
61440,312,55500,59114,200,56310,61148,112,30500,46185
61439,108,52500,61119,79,62708,70086,29,33250,36690
61438,290,57361,95128,203,87841,117757,87,30179,41622
61437,360,65761,69392,173,75563,85097,187,46375,53879
61436,300,73265,85305,252,73929,92689,48,47917,46538
61435,6,0,0,6,0,0,0,0,0
61434,1289,48015,56684,777,66202,71493,512,27500,33200
61433,32,0,0,32,0,0,0,0,0
61432,261,62361,77185,146,84286,97728,115,40568,49601
61431,114,44107,77890,85,85250,98628,29,25000,16145
61430,294,58750,78326,166,72000,97019,128,38625,52219
61428,376,70500,102907,289,64688,104290,87,75250,97144
61427,860,63194,84390,575,82950,106532,285,25694,36274
61426,31,0,66300,18,0,0,13,0,0
61425,226,53553,64388,199,55781,70940,27,25000,16096
61424,21,125114,92676,17,125568,93047,4,0,0
61423,266,65143,71577,197,64375,77594,69,65417,54397
61422,1198,48385,55251,691,56146,67376,507,20759,36294
61421,564,58056,63768,397,64732,71630,167,31648,42624
61420,402,45806,54263,250,50000,63403,152,36375,35514
61419,53,0,58370,29,59688,84376,24,24688,26946
61418,312,86429,100134,213,91985,116200,99,47188,64738
61417,128,67917,61620,94,68750,63320,34,0,0
61416,110,21500,36292,43,40469,39174,67,12434,33925
61415,842,58261,66862,519,69083,78499,323,35483,44169
61414,319,65750,68843,235,65139,69226,84,72750,56125
61413,409,67563,81123,279,77708,97372,130,40714,45028
61412,586,51212,66420,386,78750,81806,200,31302,36241
61411,194,77188,101011,142,78750,117039,52,43409,57242
61410,1574,47722,51656,918,57935,63464,656,21681,28791
61401,13494,39516,55485,6910,63872,75639,6584,22764,33147
61379,566,52222,66343,382,59643,75252,184,36341,44992
61378,122,86875,105071,86,90000,116870,36,0,76886
61377,677,50179,61945,412,75357,78224,265,25927,34775
61376,868,45167,57905,597,67697,69245,271,24132,31916
61375,474,69250,73420,315,78906,82820,159,35375,53531
61374,57,76875,76014,29,0,107700,28,0,43196
61373,829,81250,91942,589,92768,104562,240,51250,58523
61372,57,77083,106668,38,117500,134053,19,50938,48932
61370,573,72431,77052,404,82750,87826,169,41875,46684
61369,712,58000,66110,422,68553,78061,290,37031,46956
61368,572,51000,64301,351,67625,76747,221,34417,43515
61367,362,70000,96358,225,105469,125287,137,50117,46470
61364,8427,45550,58729,4699,64946,73488,3728,31484,37829
61363,138,41042,67564,57,82188,112946,81,27031,34502
61362,2357,50849,63575,1516,59221,74043,841,29487,41460
61361,472,65500,73415,321,78542,82926,151,35972,48189
61360,1273,78260,92973,1049,81979,95693,224,60656,70789
61359,185,39494,53802,111,50938,65131,74,38214,34534
61358,138,41964,53683,83,57344,66990,55,24375,33598
61356,4621,54959,73667,2934,71053,87410,1687,35344,47340
61354,4721,55843,74181,2962,74688,92043,1759,28902,41226
61353,500,54444,67552,319,67411,80579,181,38375,43741
61350,9947,59295,74851,6266,72651,91023,3681,35555,43629
61349,447,62232,87591,310,76667,94753,137,50250,70715
61348,1845,63047,72636,1249,72298,81941,596,41875,48233
61346,32,47500,42900,18,57500,53350,14,0,27657
61345,310,86750,94664,245,98090,109012,65,30250,36712
61344,181,59659,63176,118,71667,73616,63,29464,43454
61342,3536,62898,80339,2392,72745,88786,1144,36928,59176
61341,3090,66923,75970,2131,81949,90716,959,32415,42215
61340,159,71458,86389,103,99750,103975,56,34167,54045
61338,100,46000,58136,59,52083,67636,41,34531,36663
61337,197,50938,63799,145,69583,69539,52,33750,40379
61336,230,62500,68307,165,73640,82040,65,21625,32322
61335,125,81042,76697,87,86250,88079,38,40000,44605
61334,274,78026,87115,182,81875,100277,92,51538,57208
61333,122,65000,69814,96,83750,75556,26,16000,34831
61332,68,57000,68047,29,145288,116190,39,0,32249
61331,0,0,0,0,0,0,0,0,0
61330,513,77250,91435,358,85000,99710,155,51406,68468
61329,524,59737,70487,306,87632,86208,218,34545,47698
61328,25,0,0,25,0,0,0,0,0
61327,553,71776,82518,410,92778,95334,143,37292,42794
61326,891,60365,75097,599,71615,89818,292,33958,41091
61325,420,64423,104851,314,75313,106292,106,40769,95476
61324,49,78750,64522,30,80909,82723,19,0,0
61323,44,36406,65980,36,37031,76283,8,20000,19625
61322,535,60677,73576,398,64444,83671,137,28917,33040
61321,103,79583,102274,79,100417,123815,24,28750,30946
61320,265,63036,72845,193,78920,79078,72,33929,51956
61319,537,63950,72298,383,63616,71875,154,47917,66052
61318,263,55688,63600,167,51250,63157,96,52143,58834
61317,208,49583,63070,144,52857,68431,64,38750,51006
61316,103,52750,55852,49,68125,66365,54,30000,36567
61315,82,67500,77420,56,75000,92600,26,36250,39862
61314,358,58750,65314,257,65521,70330,101,38125,49119
61313,112,100789,86379,84,105104,97390,28,58889,53343
61312,183,81250,80527,132,93571,89965,51,45313,54969
61311,136,88750,82881,130,85372,70235,6,0,0
61310,1592,60926,71225,1083,71006,82719,509,41367,43632
61301,4076,54604,68665,2507,60132,83110,1569,34655,42150
61285,663,66417,84049,509,78295,92332,154,34643,47590
61284,803,92798,108273,517,102386,123525,286,61722,80703
61283,522,62500,76847,421,70375,84611,101,26875,35894
61282,3593,56637,66869,2081,67135,80262,1512,33103,43875
61281,1036,67589,80859,771,72734,88750,265,45074,56536
61279,429,61164,80618,281,72188,96720,148,45000,49452
61278,166,48750,73532,113,98958,96996,53,0,23502
61277,1212,81071,87093,766,95127,101977,446,44318,57792
61276,26,60694,60365,8,0,0,18,0,0
61275,1886,79821,99501,1452,91875,110943,434,40000,57262
61274,107,109219,108013,101,115096,114092,6,0,0
61273,1211,80417,92196,864,87647,103051,347,49375,59697
61272,513,49554,60788,344,76667,71706,169,34760,37382
61270,2676,67315,82635,1840,77353,95007,836,39461,53005
61265,18674,57771,72448,11497,76167,87403,7177,33113,47004
61264,4853,66003,88748,2999,97849,113733,1854,34020,46544
61263,248,59643,66147,216,63333,69727,32,0,32591
61262,392,76648,88135,331,76903,90220,61,66094,76823
61261,318,40278,56159,183,63854,73998,135,28686,28314
61260,315,40662,50858,185,51422,65492,130,19688,29778
61259,551,80234,95632,379,116719,117831,172,39931,46717
61258,65,37917,48640,34,0,49365,31,36648,47184
61257,370,50313,68781,302,45833,68647,68,39706,55084
61256,843,72292,83950,598,84643,93845,245,45125,56298
61254,4605,69518,89217,3279,93801,105416,1326,33297,43552
61252,2439,64174,74575,1433,91537,92478,1006,31667,46685
61251,156,66786,88525,104,77857,104384,52,0,56808
61250,1250,79432,77889,843,72469,81142,407,44115,59505
61244,9171,52752,63893,5859,65341,77649,3312,29921,37221
61243,102,105625,91602,61,110208,99170,41,0,80341
61242,495,74338,84611,384,86094,95070,111,32708,46713
61241,2909,66650,83447,2035,77056,96136,874,50320,52356
61240,2487,85650,101674,1800,97076,117264,687,41875,56644
61239,547,27583,36837,353,31417,38870,194,27074,30952
61238,1147,61484,76026,833,77179,86641,314,36103,40319
61236,30,51667,57237,23,51250,48596,7,0,0
61235,694,58125,73596,451,70188,84693,243,36250,48463
61234,485,67813,69861,298,85345,86150,187,33563,41880
61232,578,68214,84995,406,87813,97658,172,52381,55105
61231,2243,54150,66373,1401,75993,86431,842,30000,31143
61230,409,73036,75446,263,81477,82714,146,49167,59933
61201,15628,47835,60449,8633,60737,71987,6995,35266,44317
61115,8583,64187,78988,6202,74375,87779,2381,48458,52645
61114,6391,79280,103122,4245,97768,123739,2146,37500,57147
61112,53,21595,28268,6,0,0,47,21336,20917
61111,9539,56772,73728,5996,66399,84848,3543,41961,50547
61109,10648,53782,61338,6885,57525,68223,3763,34834,43307
61108,12066,53014,66081,7191,66312,81124,4875,31538,41909
61107,13542,62114,85733,7865,81402,106608,5677,40773,53773
61104,8210,27756,39232,4430,31683,43146,3780,19825,31085
61103,10637,40957,58137,6138,51198,69813,4499,27548,40194
61102,6468,36205,53865,4176,47279,64491,2292,24147,32838
61101,7440,36953,48108,4853,44401,55835,2587,21512,29717
61091,29,0,0,7,0,0,22,0,0
61089,289,56250,77050,195,67750,86742,94,32500,52684
61088,2472,82833,98012,1804,91755,106932,668,51583,72455
61087,619,54844,61367,422,66900,72590,197,30083,34924
61085,1364,47212,59099,915,57125,60782,449,38208,54103
61084,1214,76023,86534,986,85306,93745,228,43235,44459
61081,8659,55459,75425,5486,72699,93709,3173,29349,38302
61080,3976,59885,77707,2434,74242,96255,1542,36930,47541
61079,74,44286,59055,46,78750,73263,28,30000,31125
61078,489,56595,76732,356,75000,89536,133,30795,39118
61077,0,0,0,0,0,0,0,0,0
61075,440,60000,80936,313,74196,89667,127,46750,58674
61074,2185,43246,57584,1062,56579,66655,1123,26484,48627
61073,6979,87199,106754,5703,99611,113978,1276,56500,65049
61072,4399,92420,95741,3442,100217,106001,957,35036,49723
61071,5897,51590,66498,3797,62849,76991,2100,33172,44142
61070,564,62500,89634,441,61250,79395,123,62604,124459
61068,5794,55829,67168,3620,68170,80763,2174,30969,42284
61067,355,59837,66981,239,75536,78481,116,35446,41588
61065,3614,78239,97742,2802,81808,106565,812,46333,58896
61064,1708,63615,71662,1236,72623,83091,472,32386,39543
61063,1726,72430,95904,1097,84175,112629,629,35982,60608
61062,747,71437,84999,602,73750,94039,145,36250,41803
61061,3071,70374,75044,1856,84063,90098,1215,37261,48042
61060,624,56250,69502,407,75809,85564,217,31815,37137
61059,101,44647,60266,49,79792,78353,52,43654,43223
61057,20,0,0,20,0,0,0,0,0
61054,1858,47083,54520,853,62270,70056,1005,30729,39436
61053,1157,55265,66173,742,64211,77652,415,35583,41790
61052,414,62500,84982,344,63571,91517,70,0,50170
61051,641,49922,72220,383,83021,87077,258,32500,45840
61050,106,90833,89178,101,90139,84353,5,0,0
61049,220,62778,78828,189,63036,82552,31,36458,46587
61048,1634,57456,73835,1145,77014,90664,489,25655,31084
61047,683,64261,77770,502,66650,83674,181,43155,60150
61046,1046,65435,80396,740,81833,93022,306,37273,48879
61044,81,30795,50027,32,93125,81003,49,21806,29798
61043,49,45625,52714,33,55694,60148,16,26458,32513
61042,254,49348,66297,164,64167,76482,90,37045,47738
61041,652,46029,53093,372,66071,60853,280,32143,40896
61039,333,62036,70465,241,72813,81476,92,43500,40953
61038,316,83375,77170,244,92321,85430,72,0,49178
61037,56,58696,300911,39,0,414069,17,0,0
61036,3228,68497,91301,2213,78125,111332,1015,35651,47566
61032,13487,43853,59066,8165,57881,72239,5322,25781,35944
61031,642,47159,70371,389,59107,83685,253,37550,44713
61030,826,58162,64474,523,63875,77838,303,33917,39134
61028,936,50357,72044,473,76285,84601,463,32240,57181
61027,37,0,0,28,0,0,9,0,0
61025,2092,56734,71228,1306,82222,89733,786,36828,38206
61024,960,63100,70899,645,69803,82298,315,31858,46262
61021,8889,59863,71961,4948,78744,93825,3941,30072,40485
61020,909,76402,91632,751,82813,99523,158,33333,42082
61019,1236,80833,91816,901,83558,94528,335,61406,78393
61018,414,59773,68087,295,70625,76438,119,30417,39297
61016,2142,81111,95734,1551,87917,101857,591,43162,72130
61015,308,83214,91997,247,85938,101099,61,44712,40816
61014,511,56494,63550,345,60268,74731,166,30750,37166
61013,177,57083,60031,112,67308,66730,65,35179,45709
61012,822,76964,85186,635,85080,89087,187,46477,50268
61011,797,150375,148558,666,174792,163981,131,73438,69527
61010,2880,75292,97457,1932,101179,120606,948,38859,45606
61008,12385,61639,83329,8526,79958,100460,3859,30421,40495
61007,152,56250,65611,104,58125,71226,48,45750,53444
61006,653,55046,63038,429,82557,74125,224,31058,40641
61001,530,69375,76887,404,78182,81989,126,57778,59948
60974,114,48750,52818,77,42292,53765,37,43750,38049
60973,107,39028,47796,78,53750,53922,29,18542,27548
60970,3102,44947,60550,1870,62500,76410,1232,25123,34816
60969,23,64688,72291,18,68750,81989,5,0,0
60968,185,39716,63488,111,55139,70833,74,35833,52031
60966,710,40741,56303,418,62292,73615,292,25313,29475
60964,1910,58056,71834,1253,73050,85864,657,37321,42800
60963,553,47450,59586,388,55417,71526,165,20536,28655
60962,247,46875,59557,170,56042,69575,77,23750,33045
60961,317,58438,98407,225,97607,127613,92,20987,26867
60960,324,55893,63875,222,56346,65912,102,52500,58578
60959,495,41793,56935,334,44853,60004,161,25893,45348
60958,679,33342,41534,395,41958,55843,284,13026,20620
60957,2171,56799,77587,1466,74401,97603,705,26186,33129
60955,600,54737,77245,440,70929,92852,160,26250,33256
60954,2124,48317,62759,1233,71027,77171,891,31335,39362
60953,1051,49344,65096,731,62250,78062,320,22411,33518
60952,215,49792,78330,148,65000,92489,67,27250,36054
60951,356,70000,74992,239,76750,84550,117,47375,51084
60950,4712,63046,79982,2855,92566,103160,1857,29279,41576
60949,263,51875,60565,131,64821,74771,132,46458,45018
60948,701,68750,98254,504,96667,123330,197,26806,31370
60946,206,53500,62462,99,74554,77360,107,36681,46931
60945,112,62083,70993,73,82054,77579,39,32019,39574
60942,2389,38483,57537,1394,53882,67783,995,23328,41449
60941,781,75521,101597,565,93472,120179,216,40109,49566
60940,1075,75029,88457,778,91346,104888,297,30551,40714
60938,749,57448,62784,470,68000,77757,279,26750,34064
60936,1957,46192,70237,1082,78750,92084,875,32466,42337
60935,428,78750,103227,350,88750,101441,78,68000,103982
60934,90,41250,101700,45,76250,159580,45,31302,38882
60933,152,46389,55799,101,48750,62669,51,27750,34567
60932,130,200771,154721,102,0,0,28,0,0
60931,198,53500,62870,132,60625,67668,66,47500,45936
60930,308,49167,57199,175,57679,66615,133,32321,43295
60929,268,50833,62399,193,56250,67862,75,39375,44179
60928,261,65313,85523,180,80227,104011,81,39750,41896
60927,894,70625,78007,655,84464,87643,239,44196,47535
60926,24,69583,75800,11,0,90245,13,0,0
60924,674,63478,66099,447,77813,82042,227,24185,33496
60922,982,67593,75940,718,76184,85002,264,41532,42577
60921,716,55357,62380,427,55417,67126,289,0,51975
60920,71,48750,66387,56,0,68418,15,53750,53900
60919,232,77000,81515,153,74375,83473,79,77250,71504
60918,331,66719,74667,247,83875,88076,84,29583,33440
60917,178,80119,75924,139,82083,84909,39,31477,38623
60915,3958,47162,57064,2568,53728,63424,1390,40335,43516
60914,9561,76860,93448,6626,96424,110131,2935,44583,51757
60913,750,69722,80302,586,74423,88751,164,0,48849
60912,262,42794,45727,166,50500,54890,96,17273,23858
60911,547,67868,74034,397,78050,86965,150,34000,37918
60910,207,43542,57944,106,62500,65700,101,25250,48029
60901,13362,49090,64098,8500,63404,76617,4862,26199,36358
60827,10485,34878,50572,6468,42273,57052,4017,28075,38538
60805,7161,79396,92246,4964,97958,107265,2197,47049,54468
60804,22708,53750,67440,17518,56657,71895,5190,30487,38874
60803,9161,56838,71104,5181,72699,86918,3980,36522,45983
60714,11139,63899,86746,7254,85935,106948,3885,33577,48180
60712,4405,90422,121328,3285,99401,136748,1120,46648,75129
60707,15490,64790,84811,10054,84708,102396,5436,33125,49191
60706,8793,74713,89500,6012,92661,103414,2781,41279,56801
60661,6384,125365,148266,2218,159016,184002,4166,107793,128814
60660,20623,53365,78948,7920,70092,95329,12703,46295,67627
60659,13709,54807,76125,9935,63388,84172,3774,41177,50931
60657,36931,94722,146948,11666,184766,251993,25265,74161,97475
60656,12523,68931,87104,7399,87920,107668,5124,47619,55659
60655,10386,99264,114333,6797,129898,140341,3589,56415,62498
60654,13181,128101,179014,3608,221467,301792,9573,103811,132739
60653,15934,34621,63326,7075,55375,81414,8859,21883,47787
60652,13093,71267,81932,9744,80280,90483,3349,43464,48919
60651,19932,41107,57709,14021,44170,64362,5911,29552,37608
60649,22334,36130,55901,8933,49943,81460,13401,27709,36981
60647,36032,82433,118395,16545,98676,147348,19487,70325,91496
60646,10866,100670,141360,7346,126612,173311,3520,41404,65772
60645,16123,62989,89454,10924,71947,100861,5199,46713,60880
60644,17309,28033,44694,9482,37070,53424,7827,18314,31034
60643,17601,69782,99256,11531,90522,120272,6070,39762,56854
60642,9739,120442,140724,3381,143917,170375,6358,107617,123107
60641,24522,67599,89964,15724,82341,104196,8798,40682,58109
60640,36011,59516,81931,12348,96650,118093,23663,50008,61852
60639,25807,51810,71011,19117,57337,77349,6690,27840,39955
60638,20226,68041,85405,14209,82249,97700,6017,40684,51118
60637,20122,30149,65412,9018,38942,84964,11104,21039,46893
60636,10979,26598,44093,6482,38138,53221,4497,19782,25908
60634,26678,72507,88257,18641,85050,100257,8037,36574,52975
60633,4862,52193,63662,2870,66575,76348,1992,27523,43562
60632,25170,46937,61968,18892,51800,65615,6278,23771,41715
60631,11632,102936,126090,7398,132904,157136,4234,57801,64781
60630,20868,78703,97355,13817,96701,113330,7051,45332,60320
60629,31961,43372,61116,22676,53577,67315,9285,23706,38577
60628,23073,44410,57793,14122,54266,68127,8951,29037,38137
60626,23042,45632,63901,8862,67019,85120,14180,37608,48774
60625,30163,73114,99924,16691,84955,118091,13472,60409,74755
60624,12494,25648,39148,7704,32925,45071,4790,14875,25458
60623,25746,34714,47811,17519,40406,51796,8227,23048,32559
60622,24297,106128,145243,9892,139874,180928,14405,90580,118446
60621,10746,23019,35479,5563,28033,41120,5183,17454,28070
60620,25454,39499,53450,15761,47539,61632,9693,25503,36108
60619,27274,40762,54846,13036,53743,66772,14238,28872,41668
60618,35951,85443,122386,21250,104490,146940,14701,66430,81817
60617,29173,43642,60330,18738,52411,68024,10435,29334,42600
60616,24470,61843,82845,10724,79902,102564,13746,52733,66572
60615,21613,44658,74600,7474,86944,121182,14139,33902,48847
60614,33402,117251,191363,12702,215122,317369,20700,83867,112531
60613,27281,84463,121532,8957,145884,195286,18324,66639,83946
60612,13200,44538,79209,6119,55067,96933,7081,30447,61738
60611,21714,108413,176681,6943,209571,282793,14771,86095,126243
60610,24277,95994,153502,6976,186207,249497,17301,81666,113918
60609,21967,40324,55404,13085,47300,63655,8882,23803,39670
60608,26211,57183,75778,14891,61374,83976,11320,49191,60504
60607,13532,103173,133202,5120,151667,169753,8412,87362,109886
60606,2327,121982,177715,407,186729,243459,1920,112386,163846
60605,16266,109194,153980,6096,181104,231679,10170,82346,105858
60604,437,58558,136690,189,0,240308,248,0,57723
60603,644,140125,223495,223,196164,320241,421,107978,172249
60602,977,226276,352835,493,"250,000+",471242,484,167200,232226
60601,8046,109625,197328,2752,183459,317529,5294,92071,133918
60586,13892,109034,116004,12036,111329,118022,1856,73452,81538
60585,7557,138887,162340,6734,143385,169212,823,81250,90038
60565,13568,132016,159505,10935,150547,173916,2633,68259,93863
60564,13926,153455,187462,11936,162109,199347,1990,75870,108403
60563,15780,97209,128228,9650,121732,155225,6130,58041,83300
60561,8898,101055,126316,6509,111957,144943,2389,53590,70667
60560,8219,102091,120219,6439,103442,126746,1780,79861,83791
60559,10194,73492,103483,6309,99004,131668,3885,45690,54223
60558,4460,184412,239352,3844,194731,256754,616,74545,130414
60557,89,92578,96297,89,92578,96297,0,0,0
60556,780,82197,88502,592,90750,100636,188,41250,46947
60555,5135,87241,102218,3321,100635,116045,1814,57031,71427
60554,4560,110455,129920,3416,125521,148214,1144,50135,71374
60553,291,67292,87013,183,99583,112097,108,20750,42304
60552,1628,91546,100634,1269,105579,109222,359,46806,58014
60551,1495,70589,88779,1121,76125,98292,374,47308,53999
60550,546,66272,79520,299,95125,104237,247,41964,47987
60549,55,205515,154193,50,205882,168888,5,0,0
60548,4289,74155,82532,3037,80981,90788,1252,48265,55057
60546,5864,82043,120754,4105,110893,138789,1759,46629,72987
60545,4756,80731,88923,3422,88714,97968,1334,44719,57487
60544,9858,90448,103901,7136,111979,122208,2722,44895,51243
60543,13578,96794,115525,10774,113204,131121,2804,47863,52052
60542,6856,91081,109137,4507,108240,124806,2349,58750,77491
60541,1147,94653,111606,974,106250,119107,173,54792,62536
60540,15895,128617,165121,11823,151688,193982,4072,54063,76282
60539,0,0,0,0,0,0,0,0,0
60538,8627,90429,95043,6492,96321,101704,2135,62870,67369
60537,255,73438,91270,188,86000,103649,67,40625,49830
60536,41,68750,81471,26,81250,89785,15,58750,62867
60534,3634,66144,76561,2333,76892,85991,1301,36745,55803
60532,12416,88723,112251,6969,121113,138597,5447,55043,76323
60531,794,61827,67223,584,63676,71458,210,28056,45378
60530,254,97500,112899,195,94583,100590,59,47083,133715
60527,11286,103648,164023,7623,130956,200606,3663,53899,84975
60526,4933,107860,131608,3582,136328,157123,1351,54426,61264
60525,11695,92031,135491,7781,123229,167360,3914,48413,69823
60523,4212,96531,168159,2667,145163,229069,1545,27472,62691
60521,6090,202115,311290,5046,240500,354508,1044,64000,95357
60520,1159,76726,91950,718,92000,109136,441,41302,60471
60519,18,0,0,9,0,0,9,0,0
60518,1614,60065,67498,1043,70152,80791,571,31250,41108
60517,12573,87053,104968,8444,103665,122333,4129,56436,66464
60516,12085,96409,118778,8167,127576,145897,3918,47319,60388
60515,11459,100727,138119,7031,144140,184913,4428,42242,59404
60514,4033,102554,164885,2562,168362,224067,1471,55660,61563
60513,7005,84776,99242,4692,103072,117455,2313,45907,59197
60512,594,161304,142561,522,161848,151326,72,0,0
60511,607,97734,117646,482,103977,127445,125,81875,77826
60510,10618,102500,125819,7652,124636,148873,2966,39897,62301
60506,19493,64383,81804,13370,73240,92361,6123,39429,53773
60505,21120,54191,70328,15734,61209,71497,5386,32850,57132
60504,13424,87280,106853,9681,96243,116172,3743,59232,72688
60503,5741,113120,123734,4401,124907,135807,1340,63750,74506
60502,8184,127083,153038,6214,139244,169706,1970,72790,88005
60501,3480,52414,71825,2702,55671,71338,778,37143,56745
60491,7605,111843,127531,6301,123451,139541,1304,43182,61973
60490,6094,134518,159927,5649,134424,155463,445,97031,161268
60487,9097,104498,117781,7249,123662,128909,1848,61840,69841
60484,2368,61210,67031,1691,62165,70910,677,42171,48140
60482,4182,56215,68633,2702,68540,82027,1480,35163,42786
60481,4625,64956,78485,2939,76849,89155,1686,43735,54116
60480,2120,95651,119227,1355,117212,140269,765,57625,80330
60479,426,87794,81077,280,90625,89895,146,78750,61542
60478,5704,70196,81642,3802,85357,92060,1902,45766,52682
60477,15335,73959,95532,9491,89688,103142,5844,48143,80311
60476,965,66118,75693,591,85375,94736,374,35288,45084
60475,4121,49821,61111,2491,65846,76109,1630,24683,36844
60474,321,75781,86644,198,92083,100790,123,48438,57624
60473,7533,67113,80285,5599,80690,90285,1934,36738,48186
60472,1556,37177,46774,942,59783,59721,614,17056,23530
60471,5365,64425,71319,3438,79120,87475,1927,25991,38812
60470,199,72083,82415,125,77188,86298,74,50000,65591
60469,1744,45793,53682,1134,61833,66587,610,22083,27566
60468,2325,84934,92852,1550,99167,109653,775,50655,58070
60467,9698,91387,122268,7050,111264,138289,2648,52708,78637
60466,8225,56561,62654,4781,66286,75903,3444,34974,42404
60465,7247,64364,81141,4209,81045,98281,3038,42955,55193
60464,3916,109360,137617,2707,139917,160990,1209,48150,84387
60463,5346,90679,115470,3929,107563,129292,1417,54947,72061
60462,15551,83652,103184,11078,101418,118146,4473,42365,63252
60461,1752,94639,116613,1110,120278,140455,642,56149,74546
60460,490,54583,82404,319,75083,93739,171,30721,57249
60459,9108,70052,84236,6823,79422,94192,2285,40717,45229
60458,5289,56852,70349,3593,62414,79720,1696,37768,44561
60457,4819,67062,84675,3407,79613,96151,1412,31742,55165
60456,1745,51487,57588,955,63523,72132,790,32147,37708
60455,5723,55222,69381,3917,63594,81102,1806,32019,38685
60453,21192,69478,86930,13582,90853,103722,7610,45304,53620
60452,10088,79138,94214,7256,94019,106510,2832,52535,59139
60451,11897,113781,129412,9774,125174,141758,2123,56866,68523
60450,8721,72505,87800,6028,86780,98855,2693,47014,60217
60449,3631,84970,105154,2422,108796,119815,1209,72962,72205
60448,9053,107562,129735,6973,128245,146285,2080,65931,72612
60447,4802,92809,99113,3661,96875,106439,1141,67154,71585
60446,11725,86442,93247,8876,93711,101382,2849,48898,58826
60445,10797,61286,68737,6154,78973,85171,4643,35857,44484
60444,764,77143,88505,574,86047,97338,190,50156,56741
60443,8727,78858,91387,4961,106773,116814,3766,35744,56814
60442,3908,106220,116704,3058,107071,118886,850,71053,103038
60441,12086,80022,93436,8550,94381,104771,3536,46284,55905
60440,17063,79785,93182,12697,89188,101973,4366,50163,60009
60439,8493,114955,133701,6786,131675,150123,1707,43924,56285
60438,10972,57143,74670,6935,70466,80058,4037,43448,55104
60437,57,66250,96974,38,120000,125779,19,38375,39363
60436,6029,50894,63790,3969,61540,73129,2060,28906,39856
60435,18962,61546,73832,11900,77864,86837,7062,37238,48654
60433,5279,51418,64225,3395,65214,76159,1884,31120,37153
60432,6228,53280,64428,4584,53729,68164,1644,42292,47342
60431,7700,93941,112223,5776,104697,125026,1924,55215,63882
60430,7410,80056,86034,5254,90813,98530,2156,38371,53679
60429,5566,52391,77241,3668,65560,90901,1898,40911,42843
60428,3727,41925,59735,2759,45380,58961,968,33805,57627
60426,10038,34580,49798,6222,47772,61788,3816,20712,27630
60425,2870,62313,73464,2052,71648,82340,818,39286,46310
60424,900,67153,85965,692,71429,94728,208,47500,53839
60423,10478,118856,136515,8921,133291,149440,1557,43441,54723
60422,3395,118059,154600,2493,129671,170926,902,65417,101457
60421,1531,97448,100971,1052,103622,109372,479,62379,78505
60420,1814,60417,74973,1161,78375,88009,653,30450,51194
60419,7985,50237,58952,5361,57634,65769,2624,31893,39095
60417,5885,74239,107226,3805,86234,102825,2080,44928,112923
60416,3750,69227,88361,2460,85313,104510,1290,40037,45080
60415,5301,51003,62361,3326,63452,71628,1975,33197,44766
60411,18996,49281,63362,13168,57038,72101,5828,28617,39042
60410,4431,95781,115048,3786,103026,122716,645,55809,67212
60409,14166,50640,57864,8607,55612,66212,5559,31358,40385
60408,2103,73451,90646,1444,90526,97218,659,53809,71563
60407,638,64306,75590,450,74844,83876,188,32188,44057
60406,8637,49722,62058,6034,56328,68690,2603,29172,41498
60404,6798,105591,119234,5119,120938,135270,1679,56339,65841
60403,7583,58390,64713,4243,65305,76466,3340,44669,46299
60402,20936,63270,75751,14256,74367,85699,6680,35745,47619
60401,2865,84330,87338,2005,98555,99674,860,42857,56746
60305,4040,125288,212776,2754,193171,266604,1286,63085,93855
60304,6271,123090,141585,4583,142528,170053,1688,47077,57746
60302,13545,91914,140000,7500,145313,192026,6045,54290,72245
60301,1885,78015,105811,691,107401,154989,1194,56875,77351
60203,1520,123846,162970,1113,138594,190040,407,63583,85319
60202,12886,87000,126064,7440,110048,158133,5446,59777,80668
60201,15032,77371,150365,7744,149054,223782,7288,38711,71524
60195,2090,77778,88206,1071,93354,108792,1019,62795,65015
60194,7564,83585,101799,4804,98537,116653,2760,57538,74165
60193,15340,79924,94806,10274,97134,110576,5066,54314,61410
60192,5704,127351,149096,4669,134562,157370,1035,96082,107620
60191,5262,75000,96275,3732,88077,108347,1530,41197,64314
60190,4339,124965,141965,3318,145064,160653,1021,70043,78001
60189,11613,107996,144490,8274,127938,171450,3339,56614,75954
60188,14911,90973,104083,10942,104332,117386,3969,53027,62394
60187,9909,107793,140886,6877,132129,170125,3032,56984,71730
60185,11074,83622,105647,8342,96893,114970,2732,60110,72997
60184,874,131111,165705,680,150000,188762,194,82564,78788
60181,10895,76142,89419,7293,89462,104790,3602,44773,53867
60180,609,98326,96367,523,99442,102191,86,50250,60945
60178,8391,70445,86323,5686,83858,99727,2705,39502,51133
60177,7778,99414,123019,6072,110043,133959,1706,54705,70701
60176,4437,58637,76611,3105,72034,88110,1332,42232,48122
60175,8541,157236,187489,7591,167644,195341,950,63728,99216
60174,12069,90964,123222,8351,110363,147051,3718,50927,65174
60173,5889,92568,122070,3140,113868,157776,2749,68356,80650
60172,9002,93022,106003,6546,107049,119682,2456,53523,63341
60171,3642,63193,72753,2467,74795,83358,1175,25840,43010
60169,11857,80034,89007,8889,84510,96361,2968,44952,59557
60165,1350,63710,64925,1238,46944,59643,112,43636,52329
60164,6920,62427,72097,5075,74496,79724,1845,37861,44236
60163,1793,71025,82303,1339,72051,89098,454,46923,53578
60162,2751,56343,71442,1667,76131,86499,1084,36641,45841
60160,7840,53731,68141,5429,58719,71823,2411,40041,51002
60157,990,105469,121817,810,112500,135014,180,32563,55638
60156,9798,96588,113346,7627,107850,122435,2171,59327,72695
60155,3009,54537,70090,1768,80000,87927,1241,32772,36488
60154,6811,88861,102022,4385,108067,122296,2426,53421,63383
60153,7634,56623,67839,5065,64212,78118,2569,36528,42921
60152,4510,87792,96124,3450,100938,107500,1060,37296,49548
60151,1494,97115,109481,1177,108371,116377,317,57716,77176
60150,711,74950,95017,481,94417,109748,230,46250,63254
60148,19825,87322,104032,13182,101594,120811,6643,53332,68246
60146,899,67125,85038,585,79821,102005,314,40786,49496
60145,1034,71951,87933,735,69934,90681,299,71450,64933
60144,31,50313,53735,27,50938,55119,4,43750,44400
60143,4578,103118,129631,3385,112092,145074,1193,72772,80467
60142,12804,79089,92361,8204,95810,113516,4600,33406,50205
60141,123,13817,0,0,0,0,123,13817,0
60140,6246,97737,125076,4849,103693,145779,1397,37532,49604
60139,11678,70034,82663,8317,71226,88261,3361,53050,63321
60137,14287,114481,158949,10305,153690,194220,3982,48037,62080
60136,2655,96420,106724,2240,94967,106982,415,87934,84658
60135,2625,76339,93563,1859,82292,107893,766,42578,56829
60134,10300,124982,148434,8031,143194,160881,2269,62375,91318
60133,11082,77487,89207,9195,81141,93545,1887,49515,55040
60131,5713,67903,78468,4139,82608,88930,1574,32024,47047
60130,6695,70670,94331,3138,101894,129332,3557,49071,57925
60129,104,0,94849,56,93906,145088,48,21538,28923
60126,17691,120438,160509,12760,144828,190750,4931,53818,80084
60124,7823,116710,142254,6419,126358,154115,1404,83051,84764
60123,17315,69971,83785,11869,79954,93079,5446,42342,58012
60120,15423,67780,78181,11176,73486,84604,4247,41710,54799
60119,3817,106909,136896,3100,120000,150881,717,46083,72788
60118,6433,95836,120735,4183,111331,146739,2250,54628,68206
60115,16805,45480,64047,8264,68274,85344,8541,29728,40582
60113,116,79583,167374,75,81875,218773,41,64821,73351
60112,1512,69259,89229,964,94856,104284,548,54886,56077
60111,65,201875,207602,47,"250,000+",253428,18,0,0
60110,11265,74934,89517,8587,80975,95261,2678,50227,62561
60109,175,78750,127532,137,101250,148454,38,0,44003
60108,8921,89924,118242,5729,108490,137817,3192,48793,81244
60107,13206,88813,95505,9855,97511,103210,3351,54574,66785
60106,7363,65555,76009,4840,77972,85225,2523,48768,52180
60104,6059,63006,79058,4310,69730,90699,1749,37104,45116
60103,13803,110955,123797,11124,123610,135412,2679,52991,68392
60102,11839,109964,126811,9277,124368,139883,2562,51176,71900
60101,13493,68679,84880,9601,79306,96284,3892,39643,51051
60099,10520,57302,68878,7083,66612,78918,3437,31780,44802
60098,12371,74120,91635,8898,84761,103697,3473,38658,52536
60097,4195,77401,84602,2978,83548,89976,1217,53875,64884
60096,2608,82317,101181,2020,98846,110815,588,47353,62758
60093,7079,205195,337038,5601,"250,000+",389409,1478,68167,137357
60091,10181,161140,254677,7451,206235,294424,2730,71619,145137
60090,15148,71966,90674,9673,83406,102228,5475,59075,67291
60089,15257,118033,141941,11418,141085,163954,3839,54564,71185
60088,1311,55817,66818,879,54331,67824,432,56250,64597
60087,8853,64452,76006,6306,70116,83116,2547,46446,53848
60085,23981,48435,61091,16145,58028,68242,7836,30810,38690
60084,6489,86592,109949,4731,108381,128633,1758,46232,57074
60083,3472,100296,113456,2647,102774,123095,825,73536,76441
60081,3291,101922,123398,2696,116875,134817,595,45156,64579
60077,10184,67273,89142,6876,81145,102117,3308,35168,56421
60076,10793,79359,110329,8217,98629,123687,2576,54202,63660
60074,14493,69416,91573,9310,86806,105687,5183,50026,63183
60073,19510,81149,92750,14960,92725,102406,4550,43981,52583
60072,375,127596,143196,320,139500,159400,55,32813,40385
60071,1621,60566,90088,976,89444,118553,645,34676,45433
60070,6030,67275,100398,4147,83531,113830,1883,42156,66890
60069,3528,119833,180587,2263,182560,215373,1265,37974,116080
60068,14372,113909,151365,10311,146088,181768,4061,55463,72797
60067,15363,108270,140930,10146,135441,169632,5217,60574,80944
60064,5336,42298,53150,3237,56147,62950,2099,21268,33963
60062,15757,116579,171445,11176,160473,208514,4581,55859,78568
60061,10144,100709,129087,7360,124211,147966,2784,59792,76878
60060,13040,93905,117317,9745,105672,130699,3295,63389,73686
60056,20789,84116,103433,15011,103384,122261,5778,40021,52463
60053,8786,87063,105348,6338,110549,124252,2448,42108,53635
60051,8875,87591,114912,6371,105789,128515,2504,51014,72932
60050,12565,74557,93572,8454,97733,112501,4111,36394,51491
60048,10415,151816,202236,8024,189737,232319,2391,52315,99492
60047,14187,142964,182373,12191,160136,198184,1996,55565,79991
60046,11992,104960,120696,9288,120678,135503,2704,53942,65607
60045,7813,189013,260838,5722,227228,310768,2091,67868,123315
60044,4284,98080,161713,2636,162841,217172,1648,57952,70235
60043,730,241591,338988,639,"250,000+",370790,91,0,101704
60042,3158,82601,94394,2113,95240,104645,1045,56709,64609
60041,3296,77188,96510,2016,96000,98276,1280,68189,90697
60040,1967,74875,101096,1267,96449,117478,700,40745,67527
60035,11704,147028,225629,8641,184970,271644,3063,50490,92157
60034,769,75417,85944,609,86042,92784,160,27083,43781
60033,4652,58242,72860,3378,64183,76578,1274,48313,56686
60031,14048,97790,123107,9954,125960,146736,4094,53020,63253
60030,13940,92697,118142,9322,117440,136055,4618,50849,76802
60029,163,201989,292659,133,240938,349165,30,0,41810
60026,5263,112745,171305,3435,166023,227555,1828,44700,62293
60025,15709,103572,152024,11507,132083,181099,4202,50331,71366
60022,3141,192350,323284,2421,"250,000+",392854,720,46731,89050
60021,1958,107500,133433,1587,122019,148468,371,37188,55215
60020,4836,58635,74369,2396,77857,93502,2440,42667,53769
60018,9437,66030,81816,6687,76186,91304,2750,37295,52639
60016,23350,67404,92988,15760,86427,110216,7590,42611,54298
60015,10011,154824,210096,7723,182091,243465,2288,68154,94184
60014,16968,90984,108930,13054,104798,118641,3914,49489,66727
60013,9547,107920,131553,7251,119554,145518,2296,49036,80488
60012,3946,133620,174959,3331,141926,189264,615,59617,93209
60010,16683,146505,195336,13323,171028,223300,3360,51432,81347
60008,8037,77493,97843,5582,87247,112543,2455,53324,60028
60007,12984,85345,104073,8982,105563,121966,4002,53538,60798
60005,12261,87749,110433,7424,113375,137994,4837,53103,67008
60004,20199,101450,127572,13903,125501,151768,6296,61168,71867
60002,9140,94665,112737,6639,107963,124551,2501,43832,72274
59937,5996,63039,99709,3518,97433,129446,2478,38864,52827
59936,152,63750,66118,108,61250,70277,44,66667,55911
59935,1407,37604,63284,982,48333,76083,425,21034,28118
59934,306,50000,69051,235,86250,78456,71,25536,37921
59933,17,46023,47576,17,46023,47576,0,0,0
59932,712,46920,63947,425,46844,61765,287,50293,67179
59931,143,148750,143950,108,0,143355,35,148750,145786
59930,213,22202,38223,148,30333,45780,65,21103,21017
59929,100,53125,75807,62,87500,99655,38,0,31882
59928,93,53906,46024,57,54844,50902,36,0,38303
59927,121,32386,40068,65,58750,57991,56,16250,18264
59926,198,29125,36952,83,33533,36052,115,28531,34459
59925,565,52538,66136,420,55938,74603,145,23194,30643
59923,4424,39544,54177,2559,47188,66588,1865,24458,34614
59922,985,65675,68189,599,68555,80200,386,36205,49550
59920,641,58188,77734,473,61295,78598,168,42143,72245
59919,323,21059,25939,150,25000,28071,173,20191,18057
59918,270,70781,72435,203,72361,79080,67,51250,49381
59917,1985,38750,56353,1332,64688,69295,653,17574,29628
59916,80,48000,65445,61,0,66452,19,62708,62211
59915,199,59338,43929,126,0,37892,73,62972,46770
59914,136,66875,72860,97,71250,70853,39,63438,77010
59913,280,26337,47057,69,63281,87997,211,21193,33669
59912,5864,58636,73366,4104,66121,82171,1760,35242,48078
59911,3785,70531,93294,2400,83647,111933,1385,39095,60181
59910,191,126683,115494,154,170357,136842,37,0,0
59901,21337,57607,74285,13992,70370,89638,7345,31918,42391
59875,1580,55369,70298,1116,59500,80170,464,26964,43854
59874,788,45455,57097,472,51500,66654,316,42037,42317
59873,1273,45445,59227,828,46102,65198,445,37219,47918
59872,885,43242,54293,562,50990,66303,323,16467,29097
59871,105,63672,72437,81,68229,85500,24,0,28083
59870,4382,57949,85248,3258,67620,99008,1124,30594,41851
59868,939,44911,61690,570,57000,74029,369,25064,42629
59867,32,90000,93878,15,0,0,17,74107,79771
59866,446,55577,78416,180,46250,53837,266,0,91718
59865,1278,54211,64302,966,59063,70052,312,29643,41525
59864,2474,39268,49001,1644,47661,56871,830,20307,28686
59863,125,66302,67512,20,0,0,105,65955,52026
59860,4447,53559,72060,2966,64575,82196,1481,29632,45227
59859,1563,49075,57989,808,57115,73831,755,21904,39046
59858,636,53472,66600,344,64405,76144,292,39583,54049
59856,144,34103,51454,108,34786,59573,36,17083,27097
59855,254,19423,22189,165,21528,22721,89,13750,15419
59854,74,63750,66681,56,65000,72700,18,0,47956
59853,348,60093,65030,213,60250,65307,135,38482,60938
59851,50,0,74480,16,0,0,34,0,80924
59848,46,95357,172017,42,96071,187371,4,0,0
59847,2420,61833,75676,1639,64766,80491,781,46896,61664
59846,633,60089,82577,414,62071,95002,219,40913,59088
59845,660,21000,39095,341,37386,51055,319,13480,25485
59844,284,29167,56983,175,45893,77882,109,20481,23280
59843,124,54722,61642,94,66019,72766,30,26250,26787
59842,42,0,117743,30,0,164840,12,0,0
59841,198,51250,60572,182,55625,62767,16,31250,27194
59840,6428,49053,60805,3886,58526,75426,2542,23475,35728
59837,207,51458,85782,158,44583,90581,49,70625,70306
59834,868,62024,88172,589,88938,111294,279,22026,28965
59833,2120,64621,84257,1686,73155,95813,434,30250,38200
59832,269,50813,115779,198,55833,146479,71,19922,30162
59831,206,36429,47542,124,46607,60782,82,17143,26922
59830,82,24167,32856,64,27500,37088,18,0,0
59829,1098,45395,73207,764,51691,69782,334,21607,78971
59828,2155,63341,85528,1698,72092,96490,457,30739,44463
59827,172,62589,62485,101,44886,68745,71,62781,53580
59826,259,52981,60458,149,70313,74096,110,33000,41985
59825,956,62348,85903,642,81429,105256,314,30500,45189
59824,577,54135,64485,390,65550,76207,187,27969,38848
59823,686,67683,76131,473,82523,89175,213,35521,45332
59821,946,52927,65530,651,64861,78688,295,29432,35251
59820,813,57396,74282,615,68542,83634,198,28125,42214
59808,8297,63033,87161,5148,89740,114382,3149,32100,39491
59804,3138,74034,93103,2277,86779,108656,861,36343,46576
59803,6578,80582,110600,4881,95739,126662,1697,46788,60707
59802,9292,52016,69213,4214,73889,95225,5078,34968,46133
59801,14713,41722,60687,5952,61120,75288,8761,31553,49796
59762,103,47813,81705,69,56875,105596,34,31250,33221
59761,162,67143,87785,95,91250,118281,67,45625,44142
59760,122,53438,56234,75,53958,54335,47,45625,56662
59759,1546,54063,66857,1088,66538,78495,458,25385,38162
59758,688,51250,70223,375,70781,92133,313,31063,43254
59756,8,0,0,0,0,0,8,0,0
59755,81,52083,59335,51,65208,64418,30,39000,50693
59754,414,60530,77291,242,60962,80082,172,60094,71609
59752,1575,69253,75211,1119,74888,82773,456,35227,48868
59751,78,42917,68450,50,64643,90036,28,23333,29904
59750,151,68029,82290,100,75833,104920,51,26652,35712
59749,831,65530,73379,558,67091,81306,273,42083,56652
59748,109,69417,89551,63,78750,120705,46,51250,46885
59747,68,39821,67463,49,49250,76588,19,0,43932
59746,61,54375,82505,43,75625,101456,18,30000,37233
59745,35,86250,137274,29,0,153648,6,46250,53917
59743,78,45000,55599,44,58750,66673,34,26974,41265
59741,1925,69057,89346,1410,86524,107734,515,32399,35594
59740,228,38814,64623,140,0,86760,88,21250,29407
59739,131,40313,46880,70,33056,38483,61,51250,54157
59736,69,44531,82400,51,65417,95380,18,43333,45622
59735,108,53333,84710,86,74286,100381,22,0,23455
59733,70,80500,88927,69,80417,89030,1,0,0
59732,82,58333,92499,68,0,89838,14,25000,102371
59731,64,40714,46300,42,38750,47848,22,50750,43345
59730,837,75947,88397,573,88906,106866,264,36667,47100
59729,1156,56172,70671,610,72303,79030,546,32464,61332
59728,141,76875,84638,110,86667,89160,31,19875,68590
59727,97,54063,62473,60,59286,61905,37,36750,63395
59725,3558,43241,63210,2056,67409,84105,1502,22231,34326
59724,46,73125,62474,31,74063,66974,15,0,53167
59722,2017,46159,58086,1226,64286,72030,791,26444,35400
59721,202,65000,83691,146,74375,94026,56,47000,53866
59720,84,41250,48521,32,0,55553,52,41250,44194
59718,16419,73538,94431,9238,89457,116843,7181,52147,62328
59716,1040,82273,118085,630,127599,155211,410,48953,58401
59715,14871,64824,103053,7557,103707,137843,7314,40175,64246
59714,8340,73722,86388,5615,86323,101450,2725,41672,50060
59713,76,0,45318,48,0,51352,28,22500,34975
59711,4163,42655,54641,2387,51540,65320,1776,28750,38247
59710,103,39583,57638,72,46250,58714,31,32083,55139
59703,24,0,66558,14,101250,97700,10,0,0
59701,14530,48913,62563,7923,61587,80817,6607,27607,38752
59648,210,59531,72651,138,67000,86775,72,31000,44229
59647,192,48676,65716,85,0,84742,107,48260,46312
59645,592,46875,63328,361,63194,78507,231,28646,36024
59644,1748,58045,65947,1103,65625,74946,645,47125,50153
59643,179,25288,121476,61,83125,319733,118,16970,18987
59642,31,0,25500,0,0,0,31,0,25500
59640,37,45417,40951,19,0,38258,18,45833,43794
59639,575,36688,51991,290,48750,68552,285,25114,34014
59638,274,61689,68015,173,84375,84091,101,39020,40477
59636,0,0,0,0,0,0,0,0,0
59635,2867,66205,69197,1984,70602,77159,883,34172,46312
59634,1765,101133,113326,1511,106563,122362,254,44615,59572
59633,148,160833,119884,120,163056,144621,28,11250,13875
59632,722,50972,61598,455,51496,67162,267,35341,45645
59631,123,0,71654,84,91250,88936,39,24250,34431
59602,10342,77730,92588,7083,100362,113245,3259,34458,46010
59601,14163,61814,84838,7367,82892,108988,6796,42801,56783
59547,19,68125,75489,15,70625,84807,4,0,0
59546,98,40465,39210,19,52250,82563,79,40091,28785
59545,39,0,51838,9,0,0,30,36548,40230
59544,80,42000,68214,57,40625,50951,23,0,110991
59542,80,33929,60594,64,0,60069,16,31250,62694
59540,134,56500,59682,95,49688,55260,39,45250,42795
59538,1149,47750,58871,697,55694,70723,452,41293,40594
59537,35,64904,89906,32,73333,93625,3,0,0
59535,30,18929,51590,21,0,68581,9,0,11944
59532,65,58125,62385,41,66042,74498,24,0,41692
59531,141,56359,107609,80,48077,49488,61,125050,183831
59530,42,98152,94674,34,98587,102638,8,0,0
59529,81,44896,51244,46,52885,54791,35,0,46583
59528,125,64205,79810,99,78750,91317,26,30000,35992
59527,266,38026,44609,206,38684,49487,60,17500,23618
59526,849,48911,55067,638,49531,60622,211,48250,37406
59525,88,54167,57427,55,64250,74702,33,35893,28639
59524,279,44531,58836,215,40250,58629,64,23750,48889
59523,959,45781,61352,503,72014,84338,456,29479,35998
59522,686,45500,88849,458,66771,109847,228,38000,45726
59521,1117,29958,40780,904,30476,43189,213,20625,27907
59520,415,47031,62913,270,58672,73310,145,29375,43134
59501,5276,54722,62722,3301,70236,74479,1975,31623,42355
59489,184,54118,56567,90,58750,62414,94,53871,50969
59487,557,47841,61407,322,61042,78100,235,30262,33152
59486,465,55536,73376,297,67026,82603,168,30000,57052
59485,200,64000,72703,139,76964,84147,61,36875,46064
59484,61,67583,59813,38,69000,65413,23,0,50557
59483,208,65417,110693,156,94000,134037,52,38704,40663
59482,222,70921,85843,163,85417,97020,59,33250,44853
59480,150,58214,67756,113,62344,78894,37,24583,33738
59479,378,42708,62679,162,61750,66331,216,21429,59940
59477,121,83125,72280,100,83750,77536,21,0,47257
59474,1328,46406,80071,723,66005,115861,605,23628,33971
59472,290,63816,72166,215,77604,87061,75,21250,26472
59471,127,62708,98486,88,72143,121741,39,37750,42262
59469,42,52000,68910,33,58438,74058,9,0,50033
59468,252,46875,67118,156,68125,84265,96,35000,38348
59467,45,56250,106640,31,111250,144658,14,0,0
59466,50,42045,69760,30,0,91160,20,40909,37660
59465,17,0,35859,10,52500,39710,7,25938,30357
59464,174,44286,66018,122,48750,60913,52,21786,75390
59463,65,0,73766,34,143611,115659,31,28603,27816
59462,78,42778,47546,62,43056,51244,16,26875,28663
59461,5,0,0,1,0,0,4,0,0
59460,123,40963,47619,48,43750,64015,75,40764,37125
59457,4108,46648,59873,2217,75386,80726,1891,25794,35296
59456,54,96071,89646,47,96696,91643,7,0,0
59454,94,39091,47022,56,46875,51070,38,38182,36771
59453,164,32750,63299,90,73500,96467,74,25000,22941
59452,212,44643,62690,136,65000,77120,76,31250,36868
59451,47,45781,67145,34,45000,62871,13,0,78315
59450,244,52500,71573,190,67500,78537,54,33000,45017
59448,147,29107,58485,121,34583,64798,26,12000,25900
59447,121,63750,83982,82,95147,113452,39,0,21759
59446,209,50625,72198,163,65688,85219,46,15833,25798
59444,86,42857,46259,77,42946,46095,9,39583,47678
59443,161,71845,85314,132,81250,90605,29,70083,60397
59442,733,57760,70122,460,70769,84552,273,29514,45488
59441,20,0,46870,17,50313,47606,3,0,0
59440,103,71932,74494,55,106122,103707,48,45833,40667
59436,819,64536,76602,611,72288,87338,208,32344,41619
59434,160,57500,64828,105,68750,71678,55,25417,49238
59433,214,52500,66145,125,67344,72702,89,34205,56701
59432,46,48750,55359,38,58333,60797,8,31250,29525
59430,210,66875,102675,157,81250,123280,53,26250,41636
59427,1782,42899,62312,1053,57917,75077,729,31419,41184
59425,1328,55380,73257,904,73750,85181,424,35313,43373
59424,7,81875,84243,5,0,96900,2,0,0
59422,1087,49803,60687,599,62411,73074,488,29091,43168
59421,887,56705,95613,524,63947,111904,363,53036,69591
59420,89,52344,77248,77,57083,83414,12,0,37383
59419,54,40000,71980,33,42188,86097,21,34250,49795
59418,26,0,43935,20,0,52320,6,0,0
59417,2109,31550,42009,1400,41989,52304,709,14199,20701
59416,131,82344,97006,75,0,81735,56,126731,113873
59414,382,54750,56109,238,63387,61395,144,53000,47374
59412,640,63269,80003,450,78021,86983,190,31250,61982
59411,107,90417,96978,67,0,112770,40,0,70525
59410,246,41923,53470,173,46875,58737,73,29250,40401
59405,13608,46020,57939,7849,58096,71153,5759,31205,38608
59404,10867,67609,92151,7670,83598,107295,3197,37101,50938
59401,6354,41012,56157,3041,58508,72528,3313,27433,39630
59354,14,0,0,14,0,0,0,0,0
59353,477,50972,60089,316,80000,70875,161,34917,36863
59351,86,43333,58102,55,51250,62169,31,30568,50887
59349,425,42375,67114,218,62647,94867,207,32768,37887
59347,122,76250,91757,70,77885,89377,52,0,94962
59344,164,63500,71460,135,64583,75087,29,0,51048
59343,15,36250,96367,9,0,144867,6,0,23617
59339,51,48750,60214,26,58750,69904,25,47708,50136
59338,45,0,131278,43,127813,135379,2,0,0
59337,318,49000,65779,203,72697,86689,115,21458,28868
59336,82,56250,83035,58,73125,101326,24,33438,36446
59333,3,0,0,3,0,0,0,0,0
59332,97,0,67413,58,91042,86333,39,26063,39277
59330,3694,51636,68574,2243,65642,82026,1451,33242,45869
59327,1077,53603,66738,718,59242,79671,359,30625,35894
59326,93,35938,56666,79,0,58644,14,35500,45500
59324,463,42462,55262,278,54423,68684,185,19234,33689
59323,956,88636,88485,602,97188,97986,354,60726,72329
59322,22,32143,35914,15,31964,40540,7,0,0
59318,45,0,101984,37,0,118357,8,0,26263
59317,502,61833,79536,369,86750,91900,133,29125,40344
59315,26,71667,85877,20,80000,98770,6,45000,42883
59314,39,50795,48654,33,51477,50879,6,0,0
59313,1064,73333,82721,572,101792,107653,492,34545,53735
59312,11,0,0,11,0,0,0,0,0
59311,81,41875,59040,46,50625,78700,35,22321,33200
59301,4702,54416,72466,2925,74613,90540,1777,32896,38898
59276,15,65625,67420,13,0,0,2,0,0
59275,197,58350,76647,132,63750,89777,65,53125,44555
59274,122,56786,74256,79,75625,93441,43,29625,39009
59270,3388,62283,75629,2063,84480,94654,1325,34207,40507
59263,681,48472,67968,348,74545,94157,333,35560,40232
59262,229,61875,67313,135,70179,75124,94,0,52798
59261,251,49125,66392,157,61719,79607,94,38750,42546
59260,40,65313,72765,26,77500,90323,14,34286,40157
59259,121,59688,60869,76,77500,74018,45,33125,37860
59258,88,0,100268,71,172604,116513,17,0,21747
59257,46,55625,57002,19,0,82068,27,0,39363
59256,25,0,44968,5,0,0,20,0,0
59255,850,34583,44106,507,36793,48915,343,24922,36285
59254,848,51273,82333,469,69135,100125,379,38438,59940
59253,39,56797,90305,33,0,96891,6,0,0
59252,30,68500,82183,25,0,87044,5,58750,57880
59250,94,46667,72953,47,44712,69398,47,0,76509
59248,355,51793,66338,222,57500,73279,133,36625,54632
59247,155,38438,57394,53,73125,71579,102,32500,50024
59244,7,0,58186,7,0,58186,0,0,0
59243,102,55417,101526,80,61250,108569,22,44286,75918
59242,30,0,128160,30,0,128160,0,0,0
59241,199,32917,44150,109,41917,52860,90,25000,33601
59240,7,31250,54443,4,0,80175,3,0,0
59231,181,37386,51255,108,83500,65622,73,30521,25363
59230,2019,52686,62375,1183,69750,76213,836,31327,41236
59226,199,50179,58638,141,39583,58612,58,56250,58071
59225,180,36875,47039,141,44375,51143,39,20250,22544
59223,180,75568,87088,146,76818,97346,34,0,43038
59222,110,90000,72493,80,97969,76153,30,0,46577
59221,773,68242,73405,509,82250,88760,264,26136,41851
59219,97,0,78202,75,0,88376,22,31250,43518
59218,342,67432,82601,213,89297,102859,129,48958,48923
59217,83,64957,74530,70,83571,87687,13,0,0
59215,473,61691,67391,272,69167,77607,201,36615,53567
59214,48,0,86346,23,0,146657,25,0,30860
59213,248,36458,52239,142,57500,61703,106,18750,35980
59212,140,60278,82965,79,98750,105753,61,42656,50921
59211,65,107083,152780,45,135250,182022,20,0,86985
59201,1756,44507,56672,1112,47667,63215,644,34389,42616
59106,7758,106896,154107,5367,129204,187225,2391,58013,76399
59105,13097,65902,81551,8714,80760,94452,4383,43338,52462
59102,20611,60569,84214,11887,79765,109244,8724,39375,47650
59101,17199,50010,64396,9818,63371,78700,7381,31655,42254
59089,157,42266,62399,109,48125,69724,48,40625,44792
59088,557,54955,72885,363,65234,73691,194,26798,68885
59087,190,37500,61689,102,65625,76856,88,30313,38428
59086,417,64861,75208,262,75500,85798,155,57083,54872
59085,67,22708,27121,40,25000,31008,27,9276,21363
59082,14,43333,47850,9,0,58833,5,0,0
59081,34,223152,192968,34,223152,190782,0,0,0
59079,1614,61750,80763,987,87355,105867,627,29642,41244
59078,82,38636,43849,52,42083,54077,30,0,26123
59077,24,0,106433,23,0,111026,1,0,0
59076,18,0,80917,13,106042,103638,5,0,0
59075,93,41607,64014,65,89107,82735,28,22813,20554
59074,196,44167,59061,128,50156,57615,68,27222,53557
59072,2023,46806,60636,1269,53450,66616,754,28686,46759
59071,56,83929,79382,56,83929,79382,0,0,0
59070,407,72837,79811,276,72692,77569,131,85938,82776
59069,192,51500,65362,128,58750,80983,64,24167,34120
59068,1624,50636,68036,763,66211,88286,861,34388,49912
59067,107,58977,68115,94,46667,63771,13,65417,70554
59066,153,43750,65871,113,50313,70297,40,34500,52758
59065,63,103438,97092,58,102917,93321,5,0,0
59064,79,49293,57508,29,79018,83134,50,48370,42644
59063,760,75109,82435,585,84458,90867,175,30913,54057
59062,16,34500,49481,11,0,56282,5,0,0
59061,164,71875,83067,95,85250,93587,69,60341,68583
59059,77,50804,49694,66,51786,55762,11,25000,0
59058,15,0,37900,9,0,50278,6,0,19333
59057,378,69542,105608,311,94219,117952,67,50647,48309
59055,34,43500,57703,23,43750,70700,11,0,30527
59054,126,32188,56199,77,39107,78061,49,21250,21845
59053,158,50938,53509,124,0,57615,34,50476,38538
59052,73,0,80267,53,86719,91717,20,0,49925
59050,379,56806,70683,295,68125,76403,84,39500,47202
59047,5989,52699,74788,3424,75379,90964,2565,29741,49759
59046,163,53750,79547,107,71458,103421,56,28750,33930
59044,4989,72080,93061,3649,86637,110076,1340,32941,43680
59043,707,49276,60478,564,47283,62159,143,0,31004
59041,765,81205,92253,561,87212,103077,204,57955,61760
59039,21,0,49276,9,0,69167,12,0,32725
59038,278,40000,58896,190,44706,64209,88,30333,45606
59037,1003,79289,86792,723,81220,87575,280,77569,75950
59036,598,37411,50175,399,46033,57273,199,23750,29666
59035,89,46094,49015,55,57232,61280,34,33333,29174
59034,1698,49937,67152,1198,67950,76368,500,25926,37440
59033,125,77765,82910,101,77992,75767,24,37500,38775
59032,210,50417,60932,100,62212,93381,110,21111,30895
59031,80,56346,58050,62,56538,61295,18,0,0
59030,734,51136,64972,321,73813,87328,413,44261,47596
59029,344,60536,68048,211,61528,70650,133,58750,55489
59028,231,64844,68797,160,84375,76198,71,30938,51970
59027,368,48667,65809,235,56420,77420,133,27604,45294
59026,98,0,69742,29,107917,124297,69,0,46813
59025,40,71094,63690,29,71953,76248,11,24792,30573
59024,152,65000,76868,77,71094,102949,75,43125,48817
59022,444,33382,51070,343,38558,56220,101,16250,29445
59020,37,53281,58578,28,54688,66732,9,34063,33211
59019,1673,69805,89841,1099,100399,111850,574,34102,46912
59018,233,48375,95835,149,52768,119801,84,43571,53324
59016,297,43906,67141,223,54375,77699,74,0,28934
59015,175,67813,106331,134,83542,125704,41,29375,39012
59014,656,47917,64329,470,66324,76455,186,23889,33296
59013,49,69750,77818,49,69750,77818,0,0,0
59012,86,51875,55631,75,54063,57351,11,25625,27782
59011,1251,52721,63446,846,61667,72097,405,29821,40211
59010,88,87794,80902,68,88529,93706,20,0,37370
59008,225,60859,87380,154,84375,113781,71,29375,29962
59007,55,100938,95135,35,109688,100457,20,0,85275
59006,646,23750,46505,394,38438,60199,252,16538,21733
59003,489,42946,48421,278,50714,60469,211,21467,32548
59002,76,31538,71688,54,31538,82437,22,0,45305
59001,739,66099,86706,452,93056,108503,287,47019,52378
58856,28,56250,108050,11,128750,132655,17,51875,92129
58854,3295,76138,105595,1813,104854,124023,1482,67500,80744
58853,110,58571,61345,55,57361,59171,55,0,56831
58852,608,81167,90511,328,104643,116823,280,45909,59078
58849,384,78864,114161,245,138438,150263,139,53051,50528
58847,148,81618,118718,111,98059,149561,37,0,26186
58845,182,82917,88023,114,79583,104351,68,85161,60649
58844,23,0,42026,5,0,0,18,13750,15411
58843,212,119400,180227,177,119150,134142,35,0,401106
58838,80,81875,106735,39,115417,146733,41,80547,68688
58835,186,98500,118467,149,99550,121885,37,0,96651
58833,85,0,130768,73,0,143203,12,0,55125
58831,159,92917,110042,127,89375,113213,32,41875,75513
58830,92,0,81053,60,82500,109803,32,10000,27144
58801,13041,78885,108716,7845,94295,125567,5196,52667,77134
58795,57,62813,70546,33,54125,74382,24,75000,64475
58794,104,60955,86585,49,0,115298,55,0,0
58793,222,61875,88654,151,88295,106746,71,37679,48824
58792,89,90583,104540,38,105625,152442,51,18250,68849
58790,666,61786,73834,469,81250,89571,197,37125,35711
58789,126,59063,90517,66,81667,124102,60,51607,46340
58788,510,63750,83188,360,95438,91969,150,35781,61164
58787,55,76250,79725,26,147727,108238,29,41042,54162
58785,513,65156,74594,338,93269,97278,175,20742,25779
58784,1124,92159,106249,788,110164,121232,336,59531,71110
58783,178,73214,114504,125,86875,131311,53,0,74338
58782,222,69659,81531,150,70893,87847,72,58750,68372
58781,259,89688,102761,205,97250,107282,54,51250,70894
58779,108,61250,84853,86,61250,85794,22,63750,74768
58778,70,123171,99504,64,123354,104097,6,0,0
58776,172,68830,74383,78,69043,74819,94,0,74020
58775,47,47375,73526,31,67188,89671,16,45750,39856
58773,396,91250,113302,284,113750,124319,112,43333,82306
58772,84,96591,103774,45,107188,109322,39,95114,97372
58771,209,72670,78188,143,69063,80297,66,100156,73620
58770,562,58462,87872,388,69688,94174,174,49000,67817
58769,165,63542,82141,71,0,118182,94,41382,54918
58768,117,65417,83103,76,128750,110983,41,20521,31424
58765,143,54464,65909,81,55469,63457,62,0,53119
58763,1271,67361,88270,806,79821,103947,465,40573,58257
58762,120,93500,104720,58,123750,156893,62,46250,55597
58761,380,68409,86634,274,106667,105775,106,30833,35875
58760,133,78750,94255,73,71964,102223,60,105469,82533
58759,315,87708,92714,248,104821,105397,67,34750,45769
58758,127,64063,91960,82,75000,90868,45,53472,85138
58757,196,67656,70940,147,68086,78405,49,21250,32394
58756,100,77000,63444,69,81563,77159,31,0,32916
58755,73,0,192156,71,0,193776,2,0,0
58752,129,68750,73761,79,86250,90225,50,42143,45944
58750,174,92500,103504,111,123750,127617,63,49688,56237
58748,71,30625,51510,24,86500,101225,47,17212,25391
58746,662,60530,69999,369,91295,87936,293,48472,45144
58744,55,68750,62660,21,69750,82971,34,0,50115
58741,303,101250,102921,229,106792,114930,74,47500,56123
58740,267,80972,86427,177,84107,93129,90,69167,69033
58737,52,96250,85554,44,0,80427,8,0,53188
58736,258,56500,69422,147,69250,81078,111,22009,52102
58735,183,95980,161111,116,0,211924,67,74750,73137
58734,136,76500,84746,111,86964,95216,25,36563,38264
58733,176,81346,94590,128,115521,109350,48,51210,54650
58731,120,73571,80115,100,82885,81508,20,18750,31195
58730,679,64125,83145,370,96389,104390,309,40820,55225
58727,97,78125,95743,62,105313,119544,35,50208,53580
58725,115,85417,101856,101,90417,106837,14,52500,58950
58723,85,53393,71279,56,83167,90691,29,0,30155
58722,636,76029,84433,449,82331,96432,187,41512,50247
58721,242,75313,102661,127,95547,148538,115,31250,51515
58718,420,87321,102175,321,103625,109756,99,17813,29657
58716,80,47813,55129,47,47656,51330,33,0,60539
58713,40,71397,74030,36,71250,72511,4,0,0
58712,42,45000,100186,27,58750,139441,15,27250,29527
58711,125,77750,83754,92,62917,67922,33,0,126473
58710,345,61406,67837,251,67344,78376,94,0,37636
58707,0,0,0,0,0,0,0,0,0
58705,0,0,0,0,0,0,0,0,0
58704,1566,63839,77772,1210,71050,85664,356,33409,49188
58703,9667,69758,85197,5784,85313,103808,3883,41998,54399
58702,0,0,0,0,0,0,0,0,0
58701,13923,65664,86208,7482,89731,111122,6441,39523,54303
58656,173,90972,91892,122,95000,102910,51,0,60759
58655,279,111250,116914,222,118375,126565,57,75114,73232
58654,109,100250,100016,86,100000,100057,23,82250,71761
58653,302,81154,97923,231,90189,94328,71,49375,106896
58652,503,69625,96574,369,90391,114503,134,53654,42763
58651,263,90938,93884,148,91667,93864,115,90719,93910
58650,168,57647,77920,78,80833,104221,90,39375,54992
58649,140,49412,57728,88,55375,70731,52,31000,35721
58647,526,60887,83098,342,65357,102683,184,29250,43220
58646,498,51964,71299,314,68750,90365,184,23571,34264
58645,112,57083,71813,72,83750,99899,40,14524,21258
58643,86,61250,68508,37,82019,109649,49,25313,37357
58642,128,75500,113370,98,83333,121532,30,56974,82567
58641,34,58125,46197,14,59688,69686,20,0,29755
58640,623,84215,109751,388,122722,133972,235,51719,69760
58639,802,50372,72459,472,74500,94750,330,27500,39191
58638,449,49659,74706,290,85658,97039,159,25331,33884
58636,395,62083,100385,225,63917,120965,170,52917,72935
58634,63,145234,122249,36,111250,123211,27,145391,114904
58632,89,48750,58642,64,53000,65833,25,0,40232
58631,476,45238,58128,251,69250,75855,225,25186,37458
58630,278,58750,78916,208,65250,71341,70,51750,98461
58627,60,70000,76908,42,75833,80914,18,0,65861
58626,216,83816,86823,152,110326,97415,64,0,52500
58625,90,109063,186186,68,0,235434,22,22500,31750
58623,865,67958,78922,497,86875,99972,368,36111,47425
58622,712,71233,91847,447,75742,110936,265,52708,49300
58621,619,72539,86320,326,89643,102780,293,38125,68007
58620,56,47500,63545,47,44375,65174,9,65417,55044
58601,11013,68788,93130,6495,101250,119316,4518,41786,52234
58581,140,80673,84815,64,102500,97783,76,63750,71404
58580,140,118750,105616,86,118750,100097,54,0,114404
58579,524,78879,94825,341,91406,110795,183,44375,62036
58577,865,76599,83690,528,90972,101069,337,51779,55962
58576,482,75300,87784,305,84583,104169,177,60114,57368
58575,371,55917,77533,238,73750,92884,133,27019,49235
58573,268,55625,65731,143,81750,87666,125,30139,40637
58572,108,0,102407,85,82813,113765,23,0,44491
58571,236,51333,61225,156,58750,70997,80,30625,37701
58570,167,63542,82971,111,80417,97562,56,48125,50966
58569,48,0,74158,22,0,95377,26,0,56204
58568,252,55357,94550,176,81250,118478,76,25833,35453
58566,58,73000,105750,35,118750,143277,23,0,48643
58565,109,66932,86550,70,92500,112311,39,36823,40310
58564,45,41250,55809,17,31875,42059,28,49000,64157
58563,962,63704,76301,724,77500,91815,238,14667,25379
58562,159,56932,69017,120,80500,81123,39,26875,31767
58561,471,60574,71704,272,66471,81725,199,42212,58006
58560,70,109167,135181,54,0,161541,16,51250,43194
58559,95,98250,100846,77,123264,117414,18,0,29972
58558,440,87246,93091,408,88958,89932,32,37500,44656
58554,11461,75893,94754,7500,94256,111595,3961,44925,58599
58552,771,49250,65073,462,80200,86390,309,20781,31974
58549,107,44583,67583,94,0,73463,13,26875,25069
58545,1455,88934,92181,1058,97696,98280,397,54375,68537
58544,273,49625,85616,148,78333,113332,125,36042,52285
58542,132,38500,53873,73,60125,68512,59,16806,35759
58541,249,79583,70288,203,83393,74972,46,39375,44728
58540,1312,59583,79191,883,78578,95799,429,27382,40299
58538,606,39113,52603,470,38500,50940,136,34643,46755
58535,220,57500,77198,156,72500,93991,64,27500,32678
58533,479,54250,66926,266,72708,88379,213,26125,39659
58532,107,36688,60532,61,77813,80784,46,35500,33676
58531,224,68750,89411,189,72386,97796,35,30625,44131
58530,429,60938,75820,332,78929,85373,97,27321,42082
58529,279,50625,93025,159,92750,104907,120,30000,76768
58528,138,30000,52766,121,32917,55321,17,4750,21865
58524,34,54375,45621,19,58036,50832,15,36458,39020
58523,1631,81886,101934,1093,106875,115718,538,35109,73772
58521,217,97813,104693,172,106250,122279,45,30469,36480
58520,123,79531,92963,99,92188,105145,24,43750,42713
58505,0,0,0,0,0,0,0,0,0
58504,11301,70117,88737,6913,92516,111393,4388,37988,49490
58503,14405,88292,114038,9811,109098,134591,4594,49851,67838
58501,12787,60176,73391,7401,81284,89167,5386,40026,47027
58497,63,0,67183,22,101250,112464,41,21563,42888
58496,99,41250,67344,23,108750,148661,76,0,42737
58495,586,53864,62220,358,63125,71922,228,42000,45960
58494,125,70313,75586,88,72750,84094,37,34583,44054
58492,214,58409,75292,140,83000,94773,74,36250,36186
58490,103,75313,101981,84,77750,106846,19,0,80474
58488,100,0,67042,30,40417,62733,70,92721,68889
58487,192,41944,57074,142,52000,65565,50,31429,31740
58486,110,72500,76850,86,0,76091,24,73125,79571
58484,28,68750,65175,12,73333,75617,16,0,57344
58483,132,42250,66821,85,54688,71644,47,28750,51013
58482,522,50357,63991,335,71106,81983,187,25188,28237
58481,103,89750,108570,87,112344,118238,16,0,0
58480,123,87250,111672,79,91797,115678,44,0,101207
58479,69,106750,101774,45,107639,103567,24,0,97400
58478,71,37083,44789,40,63750,60580,31,21563,24410
58477,68,61154,67143,25,62159,72024,43,47083,64305
58476,208,0,48297,50,145000,146954,158,6531,16010
58475,86,54063,109410,41,0,105854,45,0,112651
58474,1127,75042,84219,780,86757,98368,347,45313,51962
58472,179,80250,90416,134,94167,107287,45,38750,38851
58467,236,63750,73771,167,71875,83640,69,24063,36045
58466,229,63157,90403,182,63729,99499,47,42841,55177
58464,111,55313,76209,55,102614,118109,56,30625,35057
58463,344,48333,61073,129,72054,79341,215,27604,49538
58461,186,64000,80346,126,90000,100533,60,36250,37953
58460,95,75250,114395,51,79375,157588,44,51000,64327
58458,473,68625,76070,312,78382,92521,161,38472,44188
58456,267,75938,73535,151,83906,89217,116,46250,50638
58455,123,59375,81864,94,64688,87053,29,51250,54990
58454,150,56389,67899,92,71250,87704,58,0,36484
58452,16,0,0,9,0,0,7,0,0
58451,47,82917,79123,35,82917,66683,12,77500,115408
58448,149,53750,94822,102,71429,118791,47,33125,41796
58445,70,66667,86126,53,70809,104794,17,0,26906
58444,89,50781,57093,33,66250,67145,56,46667,51079
58443,66,62500,94215,37,0,134943,29,33438,42252
58442,177,50781,67652,116,68929,79808,61,36250,39941
58441,151,91250,110300,131,97083,118061,20,0,59465
58440,49,40625,58620,24,106667,92458,25,22344,26136
58439,69,0,91571,21,0,137195,48,0,71610
58438,402,63542,74193,202,81667,97771,200,47424,50379
58436,741,46464,69257,395,79875,103364,346,30641,29598
58433,555,48875,75125,320,80313,92210,235,26571,51416
58431,58,96250,107164,43,102917,111795,15,80250,93880
58430,61,67083,108752,52,96250,121735,9,0,33756
58429,180,49583,79730,101,93177,118033,79,27150,28334
58428,101,64250,70789,65,34931,48169,36,0,88328
58426,70,78750,141154,59,97734,158527,11,51563,47973
58425,585,60125,91812,358,85455,121751,227,40750,41480
58424,120,41538,58940,109,41635,56048,11,0,82827
58423,34,39167,79838,16,49167,52325,18,0,104294
58422,54,83750,144924,37,0,198686,17,28750,27912
58421,1295,61250,82971,770,102684,110566,525,36354,42200
58420,83,86458,85435,63,94375,100798,20,21250,33855
58418,193,52083,98615,105,89688,143821,88,20000,41760
58416,170,45000,63991,100,66364,85869,70,21500,26707
58415,73,80625,80021,46,97500,109393,27,0,29978
58413,534,46786,61237,277,67969,77417,257,19861,43661
58405,0,0,0,0,0,0,0,0,0
58402,0,0,0,0,0,0,0,0,0
58401,7672,52365,70982,3918,74419,88425,3754,35537,50624
58386,59,88125,90327,36,95000,93244,23,0,85761
58385,68,77500,92046,54,79167,99167,14,0,64579
58384,221,60972,60384,120,69375,75149,101,49750,42841
58382,76,71667,67755,33,83250,88485,43,70313,51847
58381,145,92917,147597,119,116250,168896,26,39167,38915
58380,186,56875,93560,106,83929,137716,80,26667,35054
58379,103,47292,49282,70,37500,46890,33,0,46333
58377,146,59167,110616,109,69464,93849,37,33125,159130
58374,251,56875,88577,149,69583,109321,102,48750,57469
58372,43,61023,84707,42,60909,82217,1,0,0
58370,404,22143,43668,271,26528,50586,133,15096,24206
58369,488,69375,74814,344,91786,96944,144,13571,18674
58368,1578,55256,63265,897,83938,86167,681,18990,31393
58367,534,55625,69635,344,53750,76590,190,51071,54795
58366,428,55278,60377,265,72422,74911,163,29583,34216
58365,113,52083,58736,54,69000,86202,59,30083,33598
58363,46,93947,120030,42,94211,131462,4,0,0
58362,0,0,0,0,0,0,0,0,0
58361,123,56875,82905,88,76667,102097,35,0,34654
58357,142,61000,87164,104,70000,102153,38,52500,46142
58356,785,48281,65350,436,78077,87408,349,28466,36941
58355,25,66563,74756,25,66563,74756,0,0,0
58353,68,65417,72263,31,66875,76023,37,0,69111
58352,201,48606,84514,115,78750,115989,86,47692,42426
58351,150,70714,71193,104,82222,80338,46,42143,49248
58348,385,52019,73020,278,66667,82532,107,36696,47699
58346,296,54167,64110,150,82083,92111,146,26364,35342
58345,53,53750,75040,44,63750,84082,9,26875,30833
58344,413,53320,64919,245,65750,84610,168,33250,35464
58343,17,0,35559,8,55833,54463,9,14375,18756
58341,1209,55082,64757,737,67426,78236,472,28621,38297
58339,9,29583,39433,8,29167,39988,1,0,0
58338,40,51964,66310,34,0,73553,6,28500,25267
58335,357,28413,39203,290,27500,40808,67,6125,19233
58332,156,64250,100985,87,71250,98659,69,0,103914
58331,84,52955,48594,16,53333,64713,68,52813,44801
58330,205,58456,74088,90,73750,113583,115,57575,43178
58329,964,36667,52354,682,44900,61781,282,14500,24033
58327,115,91406,109729,82,99722,130724,33,33646,57555
58325,24,59773,93025,23,59886,96470,1,0,0
58324,710,45568,68728,406,72955,89748,304,31467,37989
58323,20,106250,102820,19,106875,107368,1,0,0
58321,20,0,79305,8,25833,38225,12,0,106692
58318,1643,62029,84326,1021,84271,102693,622,32958,52205
58317,81,0,130632,35,0,258986,46,25417,32580
58316,1952,42819,67179,1402,47306,80222,550,20625,23686
58311,35,83750,94906,19,114306,132984,16,53333,49688
58301,4320,51589,74965,2377,75797,98069,1943,29563,45249
58282,649,44688,72737,331,81375,106712,318,24167,30482
58281,41,102083,117390,39,102604,118733,2,0,0
58278,759,87159,103215,571,103988,114485,188,53804,65501
58277,94,71042,102395,70,0,126101,24,0,33250
58276,238,80000,83166,115,102969,107059,123,70125,58000
58275,267,76719,93440,197,100375,107644,70,41250,50379
58274,424,67500,79505,316,86250,92778,108,35417,40609
58273,75,53125,58299,41,59688,60937,34,45500,55118
58272,128,52857,61664,60,84167,87115,68,38125,37526
58271,242,61667,74745,146,91250,93910,96,37917,45598
58270,813,55256,65322,493,69427,84202,320,30833,35293
58269,105,91250,85756,65,125515,112914,40,31154,41625
58267,499,77159,81183,336,89167,92805,163,25221,37240
58266,58,98333,85766,33,141250,108897,25,0,55232
58265,179,70417,83998,140,78125,96167,39,41250,38464
58262,31,0,58123,6,168333,140283,25,0,38404
58261,572,54925,75687,432,56500,82162,140,47885,52419
58260,67,45694,64360,52,39688,65171,15,0,61547
58259,238,43971,58984,109,83125,83875,129,19738,33943
58258,192,32000,58897,110,65000,76861,82,26553,34801
58257,811,70917,79175,479,87386,97501,332,29333,46881
58256,278,85455,91803,202,92000,92979,76,62500,88076
58254,242,61818,65633,148,78750,84076,94,26136,33820
58251,794,70139,104308,557,77344,123482,237,46858,56427
58250,168,90109,69417,60,55833,66307,108,90543,71145
58249,1209,54688,97589,654,80000,111730,555,32153,77878
58244,31,53125,71913,18,81250,98861,13,30938,34608
58243,270,52237,69988,170,52500,76562,100,50833,55188
58241,56,0,106046,31,138750,174465,25,16518,21208
58240,562,60833,76487,379,85486,89988,183,47578,48527
58239,5,0,0,4,0,0,1,0,0
58238,51,78750,100563,40,94000,112715,11,0,56364
58237,2281,53859,78821,1293,60791,84152,988,39310,64475
58235,184,57500,68037,137,66875,74826,47,37679,45221
58233,108,65000,108862,78,81429,132947,30,47500,46240
58231,166,61563,70358,113,65893,78511,53,41607,47438
58230,299,76705,78413,199,87250,85290,100,65000,64593
58229,41,35417,51473,20,67500,67355,21,21458,36343
58228,407,65417,76101,235,91607,89370,172,40000,54876
58227,228,90469,93308,173,104861,112109,55,26875,34169
58225,485,68229,79241,323,78750,93763,162,57917,49501
58224,17,130313,117606,15,130938,126773,2,0,0
58223,70,44318,81997,45,0,109202,25,42768,33028
58222,119,43438,51670,64,61250,74278,55,16563,25362
58220,995,55719,71960,575,70750,89877,420,46667,47358
58219,25,0,34808,19,0,33626,6,0,0
58218,342,85833,92294,228,116250,122973,114,0,30046
58216,98,0,98088,71,76597,98335,27,120625,96722
58214,145,101250,92990,90,135000,126110,55,33750,37291
58212,185,43125,62794,81,83750,102793,104,0,26493
58210,160,53571,84259,87,83750,96544,73,47734,69618
58205,0,0,0,0,0,0,0,0,0
58204,678,62258,65914,636,62037,65648,42,60625,65055
58203,7676,42292,51747,2996,69474,71689,4680,31709,38382
58202,0,0,0,0,0,0,0,0,0
58201,18840,55270,78040,9569,88942,106828,9271,36759,46662
58105,13,0,0,13,0,0,0,0,0
58104,18856,78799,101215,10523,109824,130311,8333,53654,62560
58103,23659,51326,65178,11508,67717,84528,12151,35127,45290
58102,13623,50881,74425,6239,78388,105768,7384,32073,46245
58081,359,72813,87087,255,93839,101848,104,36250,49844
58079,143,109375,134434,109,120625,143396,34,0,100315
58078,14192,87944,110144,9702,102669,130334,4490,48687,56079
58077,322,82857,94043,230,88750,102803,92,76500,70325
58076,0,0,0,0,0,0,0,0,0
58075,4068,50826,68079,2298,78851,92718,1770,27786,34544
58072,3636,53364,70569,1943,73413,90610,1693,33397,46701
58071,183,74432,84233,113,96442,105232,70,35625,50336
58069,63,64250,79021,42,95893,100814,21,43750,35433
58068,171,70917,93262,116,71250,90233,55,0,91265
58067,109,80625,94461,62,95357,114839,47,34583,67277
58065,27,21406,24274,4,36250,35550,23,0,0
58064,186,77333,93919,142,97813,103069,44,0,60750
58063,179,80347,81862,131,88438,90487,48,51471,54306
58062,81,61477,67460,77,61607,67813,4,0,0
58061,133,71719,75614,75,99688,98639,58,39250,45841
58060,511,67250,82668,338,87188,100292,173,46250,47189
58059,570,94722,98551,465,96250,104366,105,70469,70390
58058,45,61406,74164,28,79583,84914,17,39688,37335
58057,53,74844,106811,50,74375,104320,3,0,0
58056,77,0,59155,36,73750,74586,41,0,45607
58054,1275,59250,72103,774,80263,84443,501,38917,52489
58053,534,48523,66589,286,65167,75490,248,38750,55648
58052,277,76750,97117,197,85750,105369,80,45625,74453
58051,635,102548,122545,501,107054,121773,134,50833,123514
58049,143,90602,113297,95,91157,127749,48,0,84694
58048,195,81250,97004,143,105625,113759,52,51667,50844
58047,1552,136806,169103,1364,158276,185749,188,30909,38421
58046,215,78125,85296,151,108068,106792,64,34375,34578
58045,903,65313,79583,497,79375,97080,406,41389,54888
58043,82,96250,83587,69,90781,90322,13,0,35208
58042,473,112396,135853,365,131250,157190,108,42315,61820
58041,602,65214,75040,424,74861,84808,178,40000,44828
58040,563,59750,70418,331,78060,81442,232,50793,54690
58038,114,82500,96496,85,101458,109720,29,51875,57172
58036,83,72188,83848,67,87321,92328,16,51250,48331
58035,128,95000,93927,65,104375,115586,63,0,71578
58033,163,96563,94435,125,104306,109355,38,25000,41684
58032,324,64444,85221,177,80208,112253,147,47232,52177
58031,161,70156,75431,97,88125,89934,64,46731,52939
58030,245,54583,83872,170,63864,94589,75,38750,52641
58029,24,86250,98250,19,86875,115205,5,0,0
58027,727,50551,68834,362,69167,88759,365,29813,46308
58021,193,80625,99053,144,95278,117965,49,30536,41649
58018,157,90536,130947,130,91429,141391,27,42188,78059
58017,158,52500,77756,115,70313,89315,43,37917,44412
58016,106,88141,87526,90,88590,91887,16,0,63000
58015,101,70250,82749,69,88250,101097,32,46250,43184
58013,73,0,99504,39,0,76518,34,0,125871
58012,1327,55208,93084,785,97188,108898,542,47059,69043
58011,197,80956,91360,138,82206,102778,59,46458,63642
58009,17,0,132012,17,0,132012,0,0,0
58008,92,90000,113137,50,128750,152326,42,49643,66450
58007,39,100417,89090,26,113611,100804,13,0,65662
58006,138,78125,106707,98,112500,129227,40,53500,51533
58005,348,120000,145509,304,120000,151488,44,0,94555
58004,127,89250,90197,100,91500,100983,27,52292,50248
58002,5,0,0,0,0,0,5,0,0
58001,17,88472,93141,15,88750,105560,2,0,0
57799,11,0,0,0,0,0,11,0,0
57794,95,25000,4959,95,25000,4959,0,0,0
57793,856,77614,86695,616,91071,97098,240,23250,47948
57792,41,76058,80737,32,76923,93006,9,0,0
57791,70,0,60724,52,71000,71985,18,0,28194
57790,398,66750,84085,270,73611,84436,128,48750,82284
57788,184,54750,65713,118,95473,86007,66,29750,29432
57787,99,38533,47852,76,0,50913,23,0,0
57785,4058,48705,64263,2509,65841,78867,1549,26964,36931
57783,6963,55560,87079,3807,80920,116925,3156,32397,49088
57782,20,0,117210,15,0,146813,5,0,28400
57780,21,0,94133,12,90000,152858,9,0,0
57779,75,0,0,75,0,0,0,0,0
57776,0,0,0,0,0,0,0,0,0
57775,110,81806,120621,102,82361,127190,8,0,0
57773,77,47159,61413,53,0,71845,24,38750,36208
57772,394,26290,33975,292,22500,24347,102,0,24288
57770,1116,40714,53671,930,44815,57274,186,15795,33746
57769,1451,68938,78677,1146,76200,86021,305,37656,47764
57767,92,248091,180977,33,50375,83000,59,0,0
57766,58,110000,102419,37,0,102908,21,104464,99152
57764,533,27462,50177,442,28281,53183,91,26813,21449
57763,116,55714,73980,78,57143,67101,38,0,86400
57762,192,40119,57685,123,0,74924,69,0,26499
57761,411,86406,91783,326,91111,100681,85,0,50867
57760,487,54792,59584,371,66563,67161,116,24038,34477
57759,65,0,103505,46,0,0,19,0,0
57758,50,0,27690,18,0,49194,32,0,0
57756,155,28799,47952,126,29510,55907,29,0,0
57755,42,0,82840,33,110781,98200,9,24583,26533
57754,1916,43444,53686,842,65833,74407,1074,34194,37327
57752,413,0,38986,314,36250,43016,99,0,25504
57751,404,70521,84511,308,74219,93763,96,30000,53425
57750,67,0,24952,61,0,24933,6,0,0
57748,78,43077,74833,60,44231,92882,18,0,14672
57747,2693,53731,65379,1631,72799,79451,1062,30227,41956
57745,843,68317,70722,568,85417,80178,275,30446,46723
57744,932,60714,80680,727,85515,90911,205,32279,40751
57741,76,0,0,56,0,0,20,0,0
57738,76,44167,48999,35,65795,65266,41,42847,35112
57735,607,40069,52933,328,51111,65050,279,19097,36229
57732,1189,43417,46878,507,52146,62254,682,24435,34752
57730,2572,67723,78096,1794,80685,90902,778,36512,47488
57725,148,63029,73447,142,63173,73030,6,0,0
57724,89,51602,55003,43,58250,67981,46,50714,42872
57722,104,0,43391,53,73188,64351,51,17768,21610
57720,289,66406,82191,178,71607,96310,111,60417,57610
57719,3074,56581,64397,2108,64072,76484,966,28810,36114
57718,3083,75522,78982,2314,80078,89848,769,30817,42477
57717,3334,48444,70033,2100,58359,78165,1234,32546,48954
57716,110,69886,78702,62,71250,88152,48,0,59235
57714,131,0,31251,122,0,32311,9,0,0
57706,1036,53316,58723,782,58542,60940,254,43481,47690
57703,6489,68216,74176,4484,78138,79639,2005,44488,54853
57702,14972,71059,102797,9635,92873,127513,5337,42655,56704
57701,18036,46690,64803,9709,63341,81252,8327,31076,43568
57661,37,52679,55092,31,53750,63319,6,0,0
57660,27,64583,57393,22,73333,61491,5,0,0
57658,118,23250,32944,71,23750,30427,47,14688,35391
57657,65,81458,94618,57,86250,99975,8,31250,30225
57656,314,53750,79506,234,77955,93401,80,32917,36399
57652,118,28333,34492,89,29861,36010,29,0,29831
57651,52,39821,72875,38,83750,86145,14,0,0
57650,14,0,0,14,0,0,0,0,0
57649,74,68750,84027,60,70500,88182,14,21250,61071
57648,165,47188,65266,100,73750,77061,65,42574,47122
57646,124,54063,74239,87,100625,89038,37,46042,39441
57645,72,35938,64310,35,0,99691,37,0,30843
57644,156,70461,76249,81,76875,93688,75,70038,57345
57642,556,42250,52441,402,49375,57771,154,25000,35447
57641,131,44750,63399,83,66458,74922,48,37000,42802
57640,102,87407,84211,63,100781,95084,39,0,0
57639,80,13594,16140,66,14375,16947,14,7188,8979
57638,839,50481,65007,516,76000,84693,323,21723,33242
57636,33,46964,59724,22,77917,76882,11,0,0
57634,54,51250,70950,45,47813,50473,9,0,0
57633,171,63750,80531,125,73750,90408,46,60179,53367
57632,282,63333,73344,173,76164,94597,109,29821,39613
57631,200,57500,69755,134,60000,80448,66,37500,48044
57630,20,0,119945,6,0,0,14,0,102579
57626,315,66875,83692,244,75962,94189,71,26875,43868
57625,1196,37898,50295,883,36534,52531,313,32969,37886
57623,331,52813,78511,273,56250,85418,58,32750,39429
57622,86,14808,25537,60,20625,27265,26,9500,11092
57621,73,27188,74385,55,25938,34296,18,0,195956
57620,260,60435,63609,172,68077,73313,88,50000,43593
57601,1637,49750,84621,946,68851,113398,691,37094,44331
57585,71,31607,53270,18,0,37000,53,30536,54272
57584,25,31250,32144,12,45833,42800,13,13125,22308
57580,1654,53966,60925,1079,69949,73001,575,28074,35804
57579,442,42742,48428,318,46786,55464,124,12381,23165
57577,278,21318,30694,253,21418,30921,25,0,27016
57576,102,37857,61164,48,89038,98867,54,28125,27650
57574,38,67708,54358,25,69063,67296,13,0,0
57572,492,17708,27276,345,19943,29968,147,9395,19514
57571,5,0,0,3,0,0,2,0,0
57570,531,17379,35235,365,15625,26765,166,36406,52270
57569,108,53269,57749,46,53750,70539,62,48125,39652
57568,295,68897,80979,200,71875,89730,95,67614,62559
57567,545,36845,55790,351,47679,74497,194,14868,21942
57566,230,24722,24599,169,25446,28038,61,0,15070
57564,409,65089,97469,275,83125,126244,134,30500,34160
57563,41,0,44056,35,0,48211,6,0,0
57562,23,70781,64443,21,71094,68686,2,0,0
57560,141,25250,31365,101,18281,32717,40,26500,26143
57559,305,46458,54978,164,72500,70168,141,31625,37274
57555,1227,30678,40613,841,31284,45005,386,22857,28085
57553,39,0,71269,24,0,76363,15,0,0
57552,224,46848,64902,138,55556,86653,86,0,29999
57551,837,42429,58799,561,50625,67391,276,32917,38354
57548,407,27917,43335,329,29938,45758,78,9583,20176
57547,81,65240,53215,81,65240,53215,0,0,0
57544,203,63438,74951,122,69615,86395,81,55938,57257
57543,228,39643,38654,148,45114,43851,80,13462,22850
57541,43,59479,60991,36,77667,67833,7,0,0
57540,15,0,140800,15,0,137987,0,0,0
57538,91,41250,67392,66,55000,84330,25,0,22676
57537,30,0,90020,30,0,90020,0,0,0
57536,119,71250,96480,89,93125,111969,30,51250,47307
57534,82,66563,74630,70,66406,71107,12,0,95183
57533,773,44272,62223,455,58897,77029,318,27424,38559
57532,1423,72148,96355,982,92593,119028,441,32250,43011
57531,56,45000,52773,31,45972,67310,25,27083,34752
57529,142,50500,61693,107,51375,61436,35,0,58486
57528,425,52276,65947,272,56364,63888,153,45927,64650
57523,505,44028,66797,305,56991,86486,200,26333,35734
57522,244,57500,68684,186,67500,72748,58,39167,44791
57521,68,0,27453,33,41250,47297,35,25000,0
57520,67,45114,34052,30,49500,41427,37,0,28073
57501,7219,69754,80146,4415,90148,97222,2804,38366,48354
57481,186,63214,80649,129,81023,94905,57,32216,48388
57479,225,92083,97247,177,102917,107692,48,52083,58727
57477,48,70833,102279,40,71944,114380,8,0,41775
57476,193,78750,91777,145,83472,96783,48,43958,58679
57475,53,58750,69223,47,80536,74687,6,23333,26417
57474,60,79375,70658,41,71250,74046,19,61250,54726
57473,96,0,44521,69,0,45590,27,25625,38563
57472,338,55417,69679,219,71938,80701,119,31023,49395
57471,250,50357,68456,135,57411,89265,115,0,43800
57470,27,75313,72389,22,75833,76032,5,0,0
57469,1357,55944,81543,750,81528,103455,607,42995,53827
57468,194,50000,51870,150,42031,49977,44,57917,54850
57467,96,74688,72649,71,75850,77717,25,0,58252
57466,104,42188,57055,81,47734,64026,23,0,32509
57465,154,84167,116831,125,110625,133912,29,32361,43203
57461,145,55750,69023,101,55750,73181,44,51250,53405
57460,121,66932,90103,101,74750,101156,20,29286,34285
57457,35,69750,86057,23,95179,101604,12,56250,56258
57456,285,69688,74232,204,77292,86645,81,36250,42969
57455,51,56750,71333,28,42000,81754,23,62250,58648
57454,292,58036,77190,206,63438,90096,86,36316,42408
57452,101,50536,56156,62,69375,65098,39,34375,40621
57451,879,72560,90709,638,80547,106303,241,39219,48899
57450,220,48125,60565,133,68393,72859,87,27411,40790
57449,79,0,98615,46,0,0,33,0,0
57448,191,55729,77558,128,68750,97383,63,0,37279
57446,267,58977,69037,167,90401,88490,100,0,36551
57445,732,76048,88017,488,94500,105980,244,42778,49483
57442,802,55833,71417,527,67125,83380,275,37679,47247
57441,226,64196,93147,179,64955,105533,47,41750,41972
57440,154,54821,145303,108,76667,119648,46,42500,203963
57439,37,35905,33389,0,0,0,37,35905,33389
57438,497,55625,60924,288,85357,85400,209,22083,26694
57437,704,38667,67809,368,61500,80493,336,21193,51130
57436,236,60000,81583,193,66875,88093,43,46563,50933
57435,117,51875,73250,78,81667,96497,39,31875,26756
57434,191,69145,175050,135,100163,226904,56,37500,47357
57433,199,66250,84171,126,78333,103948,73,39688,46592
57432,152,77931,80520,92,105357,96411,60,70000,56155
57430,936,73846,80209,558,84219,99877,378,37037,49806
57429,44,34167,60273,16,0,90875,28,28125,42786
57428,204,53571,73312,122,74000,88546,82,27273,45956
57427,206,95833,123983,195,97361,127753,11,0,0
57426,10,0,0,5,0,0,5,0,0
57424,61,53438,71110,37,88125,97232,24,34375,30838
57422,104,55000,59128,63,73438,64849,41,0,50337
57421,24,0,0,24,0,0,0,0,0
57420,43,0,41570,34,0,44035,9,0,32256
57401,13806,59529,79352,7880,84747,98798,5926,35378,51608
57386,131,92813,96030,74,116071,116131,57,61250,69933
57385,550,48250,63123,339,54196,73367,211,30821,44200
57384,462,57237,72555,292,82500,88253,170,31293,44450
57383,361,66750,79476,216,80417,98525,145,54821,51101
57382,653,49250,87107,362,78000,84677,291,33385,90131
57381,181,62188,82452,128,78333,97933,53,30417,45068
57380,1095,47292,69222,734,65156,86571,361,20096,29998
57379,41,49750,52559,30,56250,51673,11,0,47355
57376,393,53274,60223,235,65515,74652,158,25000,35778
57375,281,57946,92574,170,69643,126999,111,31696,39850
57374,143,65313,80765,108,78333,92531,35,47639,44457
57373,200,57500,64202,132,76500,72077,68,50500,48915
57371,89,60568,64039,63,66042,72154,26,51250,44377
57370,259,62847,65861,163,67083,72094,96,48571,54230
57369,1054,60000,74257,675,72790,84132,379,45313,55564
57368,440,71500,88315,305,81518,96250,135,36125,66264
57367,116,77885,79055,78,81250,88105,38,56250,54097
57366,1014,70000,78149,704,88333,85058,310,39167,60656
57365,239,66607,68814,145,63750,72073,94,68750,60714
57364,0,0,0,0,0,0,0,0,0
57363,411,47813,67986,223,68906,99953,188,21657,28260
57362,961,46875,69513,565,83393,93783,396,26591,33615
57361,34,0,38826,22,0,39468,12,0,0
57359,259,58839,78094,192,76429,90808,67,42917,41660
57358,15,0,34153,4,0,0,11,20750,19764
57356,618,43409,56060,433,46875,59876,185,31375,37657
57355,536,57875,66194,347,64018,79490,189,41875,38852
57353,318,61087,93032,222,71184,109135,96,46250,53422
57350,6316,50340,64693,4002,60948,75320,2314,34059,42379
57349,601,43523,58673,365,66442,75336,236,23500,32281
57348,334,66894,81573,289,67405,87718,45,0,41838
57346,73,47150,51608,55,46450,48924,18,56346,59811
57345,524,63281,77920,366,78125,88662,158,39375,49113
57344,37,38281,237432,37,38281,237432,0,0,0
57342,167,55982,61233,127,62292,68847,40,40000,37058
57341,61,54219,66110,33,65893,67512,28,53438,59950
57340,90,43333,54341,36,80000,89911,54,24792,30535
57339,403,23365,34011,282,35139,38660,121,8313,18039
57337,44,44615,73959,17,44135,68518,27,46563,77385
57335,134,48750,53012,71,71250,63620,63,30417,40689
57334,362,64844,75920,269,70893,80374,93,39375,51003
57332,237,68036,76007,169,79250,91471,68,35625,37043
57331,149,74479,78480,111,87589,90857,38,0,35737
57330,171,51058,70537,146,56250,75368,25,0,41608
57329,152,48854,57313,119,49219,57628,33,43125,52373
57328,544,62750,68937,394,80461,82368,150,22813,32163
57325,1337,53352,86931,801,76813,105925,536,31691,55603
57324,203,79583,75977,163,86607,83291,40,32500,44100
57323,125,54779,69619,73,77344,96482,52,30000,31908
57322,131,40208,73566,95,49583,89420,36,0,24931
57321,111,62969,77335,84,76875,91338,27,43250,33770
57319,334,55833,90969,203,74327,122703,131,31563,38355
57317,256,50109,56157,188,61667,65688,68,22500,29809
57315,529,58125,68733,380,77222,82313,149,26146,31872
57314,289,61771,84228,192,80833,109874,97,26779,33094
57313,496,63295,73669,321,87250,96450,175,19705,31882
57312,279,55848,100537,195,57188,120562,84,40938,52479
57311,520,56786,77505,375,79125,90242,145,35982,41549
57301,8050,47998,68889,4723,76913,89742,3327,30150,37664
57279,495,55521,68122,307,64115,77055,188,37344,52746
57278,280,54808,70319,206,75676,85347,74,23958,28486
57276,476,58750,74872,294,79828,85909,182,50089,56293
57274,1308,47237,60016,697,74402,77763,611,31650,37004
57273,470,39000,57673,318,46964,59684,152,22308,49019
57272,78,77778,65995,58,78611,68202,20,57500,59590
57271,59,53750,66675,55,58250,67400,4,0,0
57270,316,43571,53463,202,54667,65753,114,25714,30003
57269,128,65833,78338,85,73542,88505,43,44375,58240
57268,232,60000,67534,138,72045,80907,94,33750,47701
57266,202,58125,62259,128,71875,73659,74,29375,39165
57265,84,0,63663,61,83036,75833,23,33125,31213
57264,109,66250,78255,74,85000,97415,35,45096,33689
57263,187,53594,62146,135,56875,67439,52,37500,40575
57262,1927,43628,63041,1216,50217,75602,711,31210,38802
57261,140,42500,126012,101,46875,158858,39,0,37838
57260,400,74565,84851,293,90313,98062,107,44464,46364
57259,199,59375,94549,132,79286,103914,67,46652,63272
57258,39,0,132138,33,0,150785,6,18750,29583
57257,242,35417,47296,166,35833,52625,76,0,30034
57256,71,51875,51872,29,44821,62893,42,58750,44262
57255,201,51250,60123,131,55893,66402,70,38500,47154
57252,1961,63578,82086,1415,77079,94689,546,24100,29692
57251,46,60000,68124,26,62500,78015,20,43333,51080
57249,400,61154,69501,256,72188,79263,144,34667,52147
57248,424,73750,76211,290,83000,84611,134,67750,56158
57247,88,96250,82639,67,107386,100455,21,0,25795
57246,101,69063,95397,58,87500,131216,43,49688,47081
57245,81,0,50964,37,83750,75300,44,0,29757
57243,303,41458,60218,163,77563,78744,140,21167,36934
57242,151,70855,81830,114,72368,91007,37,43021,51859
57241,355,68313,78380,271,75972,89711,84,29815,41510
57239,133,50729,60286,97,60750,61922,36,49318,52581
57238,215,70288,68405,115,69750,84955,100,35938,40025
57237,275,57917,79400,200,101250,93098,75,31875,39351
57236,70,42500,55237,60,33971,47583,10,0,76110
57235,337,70625,78905,263,81563,88188,74,36500,38839
57234,515,65559,70888,383,66840,79392,132,39643,39830
57233,76,126250,130317,60,170147,143625,16,65000,80413
57232,172,98750,180064,135,113250,219916,37,26518,28649
57231,734,66154,78858,491,83750,97396,243,33875,40940
57227,119,51964,75466,108,58333,80371,11,0,27300
57226,790,70441,72843,516,72446,80386,274,46667,54091
57225,878,42125,66511,453,59450,85246,425,30662,46256
57224,48,118333,157152,45,118958,166747,3,11875,13200
57223,472,67308,80197,350,75769,88547,122,47500,55258
57221,338,68542,82171,238,83125,94350,100,36250,50623
57220,305,82589,96649,206,100417,115239,99,34583,57968
57219,215,55313,67536,125,63750,74658,90,41944,49036
57218,107,73083,88607,88,67344,93965,19,0,53195
57217,124,47794,47008,78,55625,52222,46,29643,32261
57216,639,69041,68165,436,73915,75807,203,45114,47806
57214,28,69000,67739,19,84583,79584,9,0,42722
57213,302,72222,71451,234,82125,81967,68,21563,26638
57212,906,67414,83779,655,85288,99131,251,21696,36988
57201,11069,57554,70800,6588,75150,85803,4481,35367,46573
57197,0,0,0,0,0,0,0,0,0
57117,0,0,0,0,0,0,0,0,0
57110,7412,77681,98517,5103,92660,116730,2309,38542,55914
57108,9145,90548,124647,6638,109489,150312,2507,38699,55203
57107,4130,59863,72247,2535,78451,83535,1595,45915,49808
57106,19523,65632,78804,12060,83600,93842,7463,39987,50964
57105,9762,59723,79548,5412,74608,93669,4350,40492,58703
57104,11803,45910,55391,4905,58562,65270,6898,33140,45576
57103,14657,64263,76221,9163,81618,89880,5494,38214,49698
57078,8002,60168,77692,4793,77029,97000,3209,35725,46200
57077,526,85000,88127,404,85588,94065,122,51389,57643
57076,209,88565,90278,162,101250,103844,47,37250,43517
57075,419,84028,109734,327,96691,118303,92,47500,78193
57073,252,44444,66514,149,82788,91945,103,24750,28806
57072,289,75250,76903,181,78438,80132,108,57717,59557
57071,1310,59510,75219,795,87614,90022,515,41356,49396
57070,627,46875,59773,380,62375,70107,247,27375,37708
57069,4494,47042,79119,2167,87097,122359,2327,32077,38000
57068,572,88333,98951,373,88984,104489,199,82917,85132
57067,104,63750,86265,94,76500,92013,10,26875,32250
57066,682,43917,57531,342,65714,69570,340,33462,45019
57065,169,48594,62071,101,64375,71841,68,38750,46560
57064,2191,90129,99475,1827,98160,106019,364,70395,61435
57063,349,69375,74181,273,67361,74773,76,41250,46186
57062,526,44659,60856,290,74063,82445,236,27024,33552
57061,57,36420,49819,19,0,56426,38,36111,44908
57059,560,55761,78104,357,69083,105194,203,18295,29001
57058,683,64837,85513,494,80469,101198,189,34183,42323
57057,107,0,69297,83,0,66282,24,0,79725
57055,569,72269,102405,472,88854,113016,97,53933,50128
57054,273,65481,90135,160,75417,98712,113,47656,77900
57053,753,83682,92648,555,93385,104918,198,46591,56384
57052,102,70625,102972,80,101250,119248,22,47500,43786
57051,140,60000,61111,62,57813,64519,78,32083,52983
57050,125,0,69442,93,0,63316,32,0,87247
57049,3038,79604,120460,1936,103571,145904,1102,48182,71065
57048,509,72321,80820,354,81346,94535,155,27026,48634
57047,160,56250,64903,102,72500,75675,58,31250,42097
57046,399,80288,84522,260,81962,90142,139,58125,73835
57045,477,50282,63348,294,67609,77823,183,26641,35945
57043,609,62240,79509,408,76250,98254,201,28542,40061
57042,3304,60520,74248,2131,73699,89260,1173,0,46451
57041,31,88558,84903,21,0,0,10,0,0
57040,160,62083,62081,115,63906,63666,45,44688,51747
57039,1342,66081,77713,978,86250,89809,364,37500,41597
57038,703,137829,142050,544,139211,161054,159,43875,72307
57037,365,71473,78002,234,63261,70185,131,87656,81111
57036,243,59583,64251,167,75156,75979,76,27500,38482
57035,432,82232,94135,339,95375,105565,93,39792,48141
57034,421,62750,84208,231,97250,112976,190,34808,46903
57033,2131,88036,103644,1779,92721,108652,352,44722,59083
57032,2775,84450,98180,2278,92143,105150,497,48984,59772
57031,452,55000,86523,213,88036,121565,239,50654,54354
57030,1194,68788,80844,790,80909,96332,404,45000,49458
57029,911,57466,63468,663,69327,71774,248,31959,37344
57028,1350,54139,66518,829,70938,80770,521,35391,40481
57027,45,86563,137149,35,0,130146,10,0,161670
57026,466,64773,74147,324,72273,85125,142,39500,43998
57025,1219,64904,83959,804,98929,109565,415,27250,32367
57024,232,67917,100428,179,90850,117444,53,33125,37140
57022,2080,75302,85954,1543,91763,99508,537,43482,46532
57021,164,63947,87187,121,64523,100190,43,47946,49602
57020,524,102045,134193,440,103500,111604,84,81875,240923
57018,569,72072,86725,435,86607,97305,134,52143,48834
57017,537,84659,97407,417,94904,109650,120,48214,48350
57016,366,78333,92752,256,88816,118569,110,29286,32668
57015,289,80764,127312,217,98250,157873,72,30000,30881
57014,643,54911,59860,438,68750,74499,205,17798,24448
57013,1667,70521,90457,1149,88509,107031,518,34942,50545
57012,527,66250,74219,332,83333,84851,195,54018,55247
57010,281,73021,85555,137,87721,124996,144,41389,46288
57006,9911,55429,71131,4702,86486,94617,5209,42525,47704
57005,4383,95666,114538,3200,104819,132205,1183,45750,63001
57004,1571,62382,81760,1073,73958,90438,498,47105,59503
57003,620,83125,92046,493,84732,96038,127,51181,69983
57002,483,75344,75109,330,78125,76814,153,48869,68575
57001,754,57237,67008,496,63929,74283,258,37083,49517
56763,1922,61250,77140,1307,69420,88950,615,44094,46622
56762,1095,59292,66574,674,81000,84819,421,31477,35679
56761,167,58750,92834,149,58750,93411,18,46250,71444
56760,190,79167,78030,103,86771,91354,87,42750,57744
56759,102,78000,84959,83,79250,89859,19,53750,63553
56758,140,47143,62354,86,73750,81930,54,25227,29767
56757,371,60469,71023,263,76750,84282,108,35000,36454
56756,216,63333,72503,153,65208,78930,63,32188,41325
56755,37,61250,84135,25,69375,69216,12,0,115225
56754,229,84792,87275,182,89464,95813,47,35750,45345
56751,2321,64725,79150,1502,77195,91645,819,40037,54542
56750,1026,54500,70523,639,82083,90126,387,27434,34991
56748,266,75625,82064,179,89792,91515,87,41250,60325
56744,216,58125,83346,112,61875,92296,104,48333,73588
56742,355,65536,72338,271,69205,81642,84,27500,36464
56741,0,0,0,0,0,0,0,0,0
56738,588,65789,81710,436,73125,86654,152,41364,57382
56737,386,45625,60849,221,56750,71746,165,31528,43649
56736,338,74091,87085,231,82321,105624,107,39688,46609
56735,317,53393,66775,238,64375,72501,79,45966,46752
56734,217,52083,66552,114,77083,95373,103,37981,33749
56733,161,70179,83839,95,84306,99824,66,41667,60521
56732,463,52835,57537,309,56146,67879,154,29167,36169
56731,48,63462,55352,32,64808,74959,16,0,16144
56729,44,48750,55139,24,66250,73183,20,41250,32580
56728,556,62632,74410,346,86000,90322,210,42833,47046
56727,390,67045,86107,257,74779,88451,133,34107,79466
56726,614,59028,69883,398,71786,84457,216,31667,42000
56725,313,60804,76380,225,73125,87809,88,39500,45895
56724,50,51875,64998,32,83571,79588,18,40500,39061
56723,335,80417,95918,209,111250,116915,126,55417,58863
56722,152,62500,86551,98,82000,101229,54,30833,59298
56721,4087,64410,74945,2551,87299,95298,1536,27468,39006
56720,7,0,20229,0,0,0,7,0,20229
56716,3884,52390,67338,2189,76199,88305,1695,32344,37754
56715,146,60000,67236,91,85972,85371,55,14750,36593
56714,494,56591,64040,308,63125,74160,186,35625,45044
56713,425,68606,75258,294,85714,90429,131,0,39631
56711,0,0,0,0,0,0,0,0,0
56710,227,44896,65641,143,65536,76187,84,40000,44625
56701,5607,61121,72715,3375,77284,86195,2232,39904,48826
56688,40,60000,68863,30,63571,77490,10,25000,38580
56687,20,30000,41505,11,58750,56091,9,25938,23678
56686,389,49792,67271,237,83295,87734,152,0,33819
56685,58,52500,66893,39,54750,80551,19,0,38858
56684,107,53125,71828,83,93036,85153,24,18750,24013
56683,303,58661,75563,218,76875,91299,85,30673,32902
56681,111,48125,53505,76,53333,58439,35,41250,42791
56680,70,44167,63260,38,70000,79311,32,28333,42800
56678,526,55000,69993,368,65625,77240,158,35833,51442
56676,711,54050,62893,442,69833,75191,269,31250,38475
56673,220,52443,63432,156,62321,77401,64,25625,28580
56672,967,44183,61194,582,60208,74770,385,28365,38742
56671,878,42119,47071,623,42225,49938,255,0,31849
56670,356,41667,53660,290,29688,52583,66,0,29444
56669,123,52788,51572,60,54423,61427,63,35625,42187
56668,68,68000,73469,30,66250,72670,38,0,74100
56667,264,76750,92812,179,94028,106256,85,48125,59596
56666,215,32466,46937,215,32375,35699,0,0,0
56663,111,45938,45584,42,63750,67221,69,35250,31630
56662,241,52550,63601,130,54537,77384,111,40208,46719
56661,438,57885,67207,309,75066,78902,129,31250,37986
56660,134,42000,55899,96,65000,66015,38,19423,27068
56659,40,0,179450,36,0,196572,4,0,22675
56658,0,0,0,0,0,0,0,0,0
56657,130,45714,59214,89,45893,58802,41,37321,57032
56655,802,46726,60934,452,60962,76066,350,37500,40381
56654,56,44375,54354,29,52917,72021,27,27969,25478
56653,620,55000,65411,375,65313,75600,245,41827,48245
56652,204,63214,70023,114,86250,95649,90,30000,37112
56651,225,54861,63133,160,55227,65331,65,51042,53512
56650,370,51250,66816,237,80781,82647,133,28036,37560
56649,4228,51378,67784,2417,68036,84575,1811,38489,43544
56647,264,42857,66744,207,51875,71372,57,33194,49935
56646,185,56979,71221,116,86250,88639,69,0,39761
56644,275,48977,59039,157,59375,74518,118,24167,34741
56641,172,51395,55786,99,53125,57381,73,51017,50471
56639,218,32955,44394,111,38393,50765,107,21250,37086
56637,81,69250,71288,61,68750,73346,20,71250,61475
56636,2022,56121,67502,1415,64013,75397,607,33750,44349
56634,643,56953,78162,453,79531,88559,190,28529,48500
56633,1916,55200,71064,1104,47965,68214,812,62000,67542
56630,871,41223,55142,522,56250,67960,349,27596,34254
56629,141,82917,103909,110,89167,110829,31,62083,71552
56628,754,44881,62786,485,55439,62658,269,25234,60136
56627,150,30500,42313,74,50000,55328,76,15938,29641
56626,101,43125,48298,73,43580,57582,28,0,23346
56623,1061,50194,61145,595,66106,77369,466,31447,38749
56621,1866,49740,66132,1212,61579,75941,654,25100,41291
56601,13875,54663,69471,8245,72033,86863,5630,32271,41888
56594,200,77778,109711,145,81953,129080,55,38482,58645
56593,0,0,0,0,0,0,0,0,0
56592,173,50795,74488,103,74688,99664,70,36000,36623
56591,49,50417,50165,38,46250,52447,11,9375,20518
56590,131,54375,80416,89,73375,97658,42,37500,41179
56589,779,52772,62840,560,58929,71482,219,20972,29229
56588,189,51250,64922,148,67857,75478,41,0,24322
56587,615,66250,90960,391,80368,94813,224,40000,82827
56586,797,72019,77516,553,78914,86823,244,40833,52386
56585,434,50882,62007,272,73438,79861,162,23472,30838
56584,576,60208,75521,352,75000,97147,224,31500,39845
56583,86,56250,73437,47,75750,96149,39,44375,45479
56581,124,45500,52781,49,83750,75984,75,30179,37623
56580,463,79948,100920,347,94205,117240,116,45000,47177
56579,429,74107,80489,329,81375,87909,100,42500,50389
56578,269,81979,98120,222,93333,106532,47,40417,50834
56577,4,0,0,4,0,0,0,0,0
56576,348,67143,88777,270,76389,101305,78,31250,41588
56575,308,37500,52773,204,60714,67110,104,14651,23847
56574,112,71500,84306,79,101250,101373,33,49375,43445
56573,2730,55938,78025,1886,73807,93214,844,36461,41608
56572,2155,65625,80208,1570,76304,92043,585,41193,46429
56571,765,68224,83287,553,77917,94666,212,30357,52005
56570,494,57895,70998,348,61500,74665,146,40000,58092
56569,513,44375,57541,347,52292,70024,166,20000,28166
56568,66,0,54555,47,59063,68019,19,15750,21247
56567,1241,58869,65630,837,70598,78645,404,31339,35564
56566,204,34688,40986,146,30625,42926,58,25000,30779
56565,12,46429,45150,10,46786,51750,2,0,0
56560,17283,62361,75570,10010,87431,97446,7273,32190,41931
56557,1036,43750,63018,628,53333,74864,408,29500,38586
56556,415,56964,64256,249,72847,83682,166,27500,32757
56554,1168,85625,109771,900,103611,124989,268,36923,51971
56553,112,54714,67892,59,71823,83297,53,53250,49926
56552,224,50278,85824,128,85000,124845,96,26875,31616
56551,929,55888,70992,574,64524,80695,355,39018,53926
56550,150,51389,63038,97,75938,78899,53,27212,29908
56549,1879,83290,97707,1425,94028,111278,454,38346,47984
56548,304,53542,70866,171,65250,90432,133,36917,43376
56547,1002,80705,92776,736,93750,105733,266,36196,46589
56546,93,83125,92870,69,83125,89772,24,0,71988
56545,308,63438,77931,191,69750,80536,117,46369,71901
56544,2105,59275,72874,1374,76290,86423,731,31518,43546
56543,98,51250,73553,68,83750,82828,30,36458,46713
56542,1120,50000,65501,679,75313,84128,441,24669,33846
56541,10,136250,121390,10,136250,121390,0,0,0
56540,753,62802,70445,484,83056,86534,269,29375,38251
56537,8459,51554,70447,4978,78586,93945,3481,25182,34908
56536,148,56731,77856,106,64643,88847,42,37222,46679
56535,520,45714,61449,290,70781,81605,230,19286,34469
56534,529,78542,111661,403,83239,130345,126,30000,45742
56533,116,64500,77453,86,76250,86572,30,60000,51313
56531,815,58906,92043,543,69896,109220,272,33929,54710
56529,1877,68838,87696,1246,104464,114106,631,32658,32557
56528,702,61912,74768,525,70809,83460,177,34583,45725
56527,317,48854,62929,237,54219,68965,80,26250,38974
56525,34,85833,70121,28,0,68132,6,90000,79383
56524,292,57917,81417,211,69063,96950,81,33750,39879
56523,178,71250,81654,127,89028,94328,51,37917,41825
56522,171,64609,76877,139,64896,79387,32,46000,62453
56521,359,57784,68772,220,65625,86280,139,28125,34835
56520,1782,48322,66715,981,68533,83215,801,30034,45528
56519,95,51719,66344,69,60313,74743,26,41250,41354
56518,146,46429,61348,102,52500,63184,44,28333,49409
56517,107,80625,99927,100,90000,103883,7,40750,32814
56516,117,52083,73662,82,72188,90534,35,25893,28391
56515,1296,64268,81166,907,77981,94028,389,37604,49852
56514,1390,74706,87227,1004,91250,96106,386,36800,53128
56511,838,61250,88767,560,90167,115288,278,28125,32786
56510,987,54938,71034,619,76094,91543,368,21563,31515
56501,7337,61070,90791,4735,78449,111456,2602,36629,50936
56484,1355,52340,71485,820,62019,83613,535,30639,43416
56482,2968,45978,59820,1809,55707,73344,1159,30659,32627
56481,877,62917,70066,632,70610,81870,245,28359,34602
56479,2109,46732,58590,1405,60295,68136,704,25114,33766
56477,1189,46106,59321,798,55446,68234,391,29196,36058
56475,645,55536,68326,431,66458,81300,214,30833,39960
56474,1944,43961,58731,1143,55494,70482,801,31417,40640
56473,1356,61111,74048,951,74567,86120,405,35673,41861
56472,3369,62108,75956,2305,75531,87559,1064,35000,48263
56470,4553,56223,69257,2948,66557,80751,1605,26688,44045
56469,534,54271,61513,299,65568,75158,235,34219,41847
56468,1816,75862,97706,1263,90150,107229,553,47083,72445
56467,1059,63979,74069,829,69650,81669,230,37500,44934
56466,1287,52043,63275,824,61290,73682,463,29471,38057
56465,893,64718,81305,636,71406,89116,257,33950,56696
56464,1714,56149,64156,1149,66767,74896,565,31250,39522
56461,1329,64491,75786,984,73375,83949,345,38264,47884
56458,169,58977,74293,129,59219,74697,40,52500,64018
56456,22,33750,56673,15,0,71073,7,28750,25814
56455,665,56042,66210,449,64519,72287,216,38000,48938
56453,332,48333,62957,241,62679,74033,91,19464,27064
56452,1024,59833,85590,624,75455,98799,400,40682,62827
56450,462,49063,64396,200,57045,66780,262,44286,60872
56449,701,68250,88638,444,90882,110074,257,34653,48177
56448,179,61250,74285,144,68000,82215,35,41875,40497
56447,432,45833,65404,279,57875,78150,153,31696,41239
56446,689,43558,55258,452,55000,61076,237,22321,35320
56444,1428,66522,80292,939,82992,96180,489,28797,46929
56443,617,63516,87622,438,72375,102556,179,39375,49673
56442,1317,68393,103483,845,77372,125887,472,53750,63375
56441,1825,42540,63270,942,53833,83206,883,27250,39211
56440,508,46818,51003,318,59167,60201,190,30417,31982
56438,1074,52988,65399,711,63606,77504,363,33583,40654
56437,493,50685,57240,362,55500,63105,131,26181,36709
56436,22,0,69332,7,79375,65686,15,0,71033
56435,1228,53952,63049,854,65245,70668,374,36500,41395
56434,83,59861,83845,65,75625,93392,18,35000,48389
56433,768,45972,60735,455,59688,74413,313,26250,37898
56431,4197,50417,62885,2635,62131,73973,1562,28171,40407
56425,3395,69771,81202,2148,87665,93357,1247,38875,52740
56401,12662,55168,73421,8236,69861,89571,4426,30215,39233
56389,33,49219,52585,26,50000,62404,7,25000,0
56387,3321,45039,53398,1755,59926,67149,1566,29682,36266
56386,368,41500,60417,193,53542,81449,175,26228,34320
56385,422,48148,62595,250,64167,78668,172,33696,38957
56384,171,39375,49606,106,41250,48110,65,33750,49325
56382,557,64350,75703,388,77500,80528,169,47083,60551
56381,1027,69803,83148,714,81806,93555,313,33036,54653
56379,7015,58750,79663,4299,78497,96234,2716,39748,51649
56378,3177,64790,77447,2192,76598,88666,985,34827,46212
56377,7579,72671,96529,4896,96747,118808,2683,39219,51689
56376,141,74688,73389,86,86500,85385,55,41875,50151
56375,330,82273,88949,241,86964,94920,89,46563,52985
56374,3537,76660,91662,2328,87782,107804,1209,44564,51790
56373,1215,68661,83121,851,83828,96293,364,36750,48318
56371,38,56250,59708,31,52188,58768,7,0,37657
56369,245,45809,53530,118,48750,63991,127,45368,40841
56368,1696,76212,83207,1263,85016,93790,433,39688,48414
56367,2515,85341,95754,1934,91466,102983,581,49205,61435
56364,2143,68157,80147,1536,78021,90155,607,32679,44332
56363,72,63125,71664,36,91250,88378,36,48750,54064
56362,2231,65859,88688,1551,77375,103479,680,36447,50862
56361,969,62656,69553,671,74458,81775,298,30577,38131
56360,1808,56078,69255,1133,63917,81274,675,32868,47165
56359,1395,49598,63018,823,58125,68188,572,30000,50295
56358,1283,63656,70904,898,71977,80109,385,36750,44607
56357,417,84375,96034,344,88750,104756,73,43365,45201
56356,109,65750,67536,71,80417,85635,38,31250,32426
56355,219,63583,73376,163,78750,82545,56,46667,44893
56354,540,68929,79011,418,78125,85394,122,45000,54992
56353,3515,64546,75487,2378,71479,82118,1137,36165,55885
56352,2436,57560,72610,1615,78977,89156,821,28902,37994
56350,254,47917,56950,130,55833,65798,124,0,44827
56349,309,85469,85015,245,91287,95211,64,31250,39420
56347,2817,55481,65718,1951,67125,72625,866,33611,42215
56345,6193,52352,69377,3915,68493,86883,2278,24418,36600
56343,427,55481,82809,281,67639,90358,146,31786,63773
56342,1282,48775,66882,773,62578,75958,509,27413,50711
56340,953,67306,75567,664,82500,88314,289,35625,43253
56339,403,53250,67401,300,66875,76538,103,30417,36808
56338,653,62784,73913,451,64018,82521,202,39375,46603
56336,660,69500,81826,478,79444,89945,182,41875,58020
56335,83,61250,63304,59,66563,67973,24,60000,49917
56334,2567,61917,79432,1597,86402,101612,970,33958,40278
56332,687,69875,82411,472,79688,93395,215,47337,58031
56331,814,82143,109657,654,87500,119854,160,55000,62453
56330,670,63125,76899,511,78011,85603,159,50398,46491
56329,2615,75365,86972,1932,85727,97436,683,35787,50331
56328,66,72500,76558,54,87917,87657,12,21250,26600
56327,342,73750,93287,272,90000,103875,70,44167,50397
56326,705,68631,76005,453,84375,91496,252,26607,47400
56325,80,38750,99685,66,40000,111082,14,27500,43414
56324,459,65729,75336,300,83611,91132,159,48661,44858
56323,260,53167,57522,142,72778,76768,118,21250,32514
56321,0,0,0,0,0,0,0,0,0
56320,3215,83036,97577,2453,95329,105291,762,50793,66177
56319,553,74653,99604,361,100568,125003,192,46250,49637
56318,428,63214,72555,295,75208,84382,133,31696,44151
56316,605,59432,77912,387,64821,93529,218,38929,48595
56315,704,72667,80705,486,82232,92139,218,40000,51695
56314,468,73611,93715,315,84205,111401,153,45417,54590
56313,34,46250,46512,19,0,43111,15,36875,43733
56312,969,67930,81036,693,81094,94446,276,38875,45151
56311,301,60813,75557,200,69063,84942,101,26771,54360
56310,2101,88493,95147,1534,98148,103688,567,59297,69558
56309,575,65125,73571,409,79583,83820,166,41300,43830
56308,11427,66113,86014,7121,87752,105966,4306,35255,50738
56307,1883,75625,88598,1344,93200,106600,539,30580,38655
56304,7129,48360,60591,3521,65616,75575,3608,31705,42810
56303,10651,54036,67511,5907,68691,85302,4744,32667,41916
56301,12181,58156,77027,7056,75565,93161,5125,37112,52610
56297,309,74583,76406,247,80583,84350,62,30000,38924
56296,997,46146,64341,505,65398,82825,492,28864,44576
56295,112,59773,71638,71,70625,90615,41,27321,35685
56294,50,67188,95302,29,66094,61341,21,75729,142200
56293,514,53710,66569,357,73438,79587,157,23878,34799
56292,208,65833,72302,146,74000,82947,62,37000,42784
56291,169,52750,78435,104,67143,100701,65,39250,39811
56289,307,59609,71860,195,72708,86857,112,40833,45719
56288,2018,92568,114668,1429,109594,138947,589,41801,54016
56287,29,45417,48397,14,43750,56014,15,45417,41293
56285,480,64500,71603,297,81458,88346,183,39063,39315
56284,777,66250,72543,549,67639,78246,228,43750,52306
56283,2652,58438,69231,1664,67903,84735,988,32143,40285
56282,616,60000,68726,414,74250,76147,202,39000,49975
56281,263,72250,89498,228,83750,95171,35,36875,52540
56280,215,58068,67745,151,63125,78321,64,35000,41517
56279,501,68047,88576,388,76750,100499,113,38229,42729
56278,1327,55067,67602,768,71957,89957,559,26875,36023
56277,1290,55109,70210,765,70089,94523,525,21477,31760
56276,89,58750,66579,54,86000,86111,35,36875,34989
56274,91,82279,107221,70,104167,117786,21,80956,72005
56273,1997,73988,90710,1467,87004,106274,530,41161,44468
56271,504,60833,78373,352,71042,85537,152,37500,57538
56270,426,52500,62979,258,65000,78022,168,29808,36232
56267,2630,63938,96512,1535,89583,133255,1095,31685,44986
56266,573,55625,72605,347,82083,97437,226,25441,32212
56265,3183,59704,75634,2034,71341,88383,1149,36146,48867
56264,856,63269,72705,574,75000,87580,282,37857,42152
56263,193,63750,67662,116,80000,81023,77,41932,46730
56262,305,61406,84902,224,75000,95375,81,37917,45953
56260,402,64250,72857,280,82500,85880,122,31406,39357
56258,6061,52570,78105,3718,71429,99158,2343,30092,40718
56257,238,51250,55553,139,68125,71393,99,22396,32432
56256,1196,52039,72153,694,64671,92898,502,27100,40014
56255,164,61458,63793,98,66667,81691,66,0,33767
56253,425,63229,77886,274,74500,91253,151,35938,50481
56252,501,52663,64630,314,72500,80965,187,30625,35359
56251,343,67321,84714,262,72500,93683,81,45313,51056
56249,133,61563,109108,89,79583,146240,44,32857,33998
56248,431,67375,68426,243,74875,85119,188,42500,46496
56245,276,76071,95106,212,84000,107781,64,33750,46409
56244,541,71023,95211,395,85337,105602,146,50500,65183
56243,709,56696,72105,485,73875,84542,224,31912,39317
56241,1623,55391,70991,1014,80250,89987,609,29408,35177
56240,362,52500,68703,244,70833,82295,118,29250,40308
56239,252,75000,87537,211,79821,96926,41,25938,34854
56237,231,45625,63726,162,62500,64894,69,36563,60346
56236,129,79688,109346,102,118750,131411,27,14688,25989
56235,225,67656,78792,156,83750,93844,69,40208,43801
56232,973,65139,77809,657,76028,91118,316,38611,44161
56231,158,94167,92842,126,82857,95326,32,53750,54150
56230,304,53438,72121,185,78438,90668,119,37969,40879
56229,750,75909,83275,485,83681,90707,265,41313,69059
56228,418,52188,71154,261,63036,84539,157,32148,41066
56227,102,72500,90838,87,74250,95314,15,30417,41973
56226,91,76250,86564,65,81250,95342,26,49375,64619
56225,309,64375,66387,176,80300,78215,133,37125,49242
56224,133,52159,74326,85,78438,95585,48,27500,34208
56223,573,57083,69825,371,71146,82425,202,35417,42596
56222,835,55313,66845,590,64444,75601,245,28250,40633
56221,307,69464,73972,208,90000,86495,99,35795,46137
56220,1199,52416,67526,814,71855,81832,385,24375,36764
56219,463,56541,65333,323,65250,73721,140,35192,41991
56218,202,67500,77587,138,74167,80182,64,44722,68320
56216,338,68077,72405,243,79219,79489,95,51650,51852
56215,1979,53750,74294,1253,72238,94342,726,23778,36414
56214,289,56250,75879,194,69722,81535,95,27813,58596
56212,222,54167,69911,164,70333,78874,58,26667,42190
56211,198,67692,71506,136,72045,84504,62,37500,42569
56210,3,0,0,3,0,0,0,0,0
56209,919,66065,80282,612,77917,97017,307,39718,44203
56208,978,47581,65152,555,66157,78288,423,22813,46551
56207,99,59926,72001,82,62500,74534,17,0,57871
56201,8944,55960,68490,5755,71424,80816,3189,32002,42490
56187,5087,54122,68238,3492,65171,79148,1595,29583,36910
56186,177,51250,73662,122,51071,73116,55,37031,69042
56185,211,48295,72772,145,53125,69518,66,41875,78747
56183,705,41523,53962,373,66313,73123,332,22500,31955
56181,506,52500,64387,364,58571,69940,142,36667,41383
56180,451,59250,74437,308,74500,84860,143,33542,49765
56178,712,56477,74378,448,82500,90708,264,37708,45383
56177,20,50000,51140,16,51250,54931,4,0,29000
56176,440,59167,77202,292,73438,92077,148,37083,46378
56175,1174,57100,73478,780,73243,87213,394,30000,42764
56174,144,55000,61935,94,62500,62447,50,43333,59304
56173,162,51667,61659,96,57083,72174,66,46471,43465
56172,1392,57381,72328,842,84667,93828,550,22125,38255
56171,753,63380,79360,494,71711,91189,259,39375,54988
56170,252,63750,67330,185,67875,78469,67,23438,27421
56169,293,78125,86965,235,66250,87040,58,42500,49110
56168,336,55833,64524,210,68750,74269,126,34125,45683
56167,325,61250,75388,198,76750,96853,127,30469,40902
56166,95,63906,69817,71,67250,80645,24,33750,35092
56165,134,73750,84487,91,85536,91502,43,61458,65012
56164,2481,52386,70515,1453,69136,83598,1028,35918,50990
56162,102,67500,74334,74,66667,81934,28,0,45611
56161,135,74875,89147,81,78750,105681,54,0,62709
56160,105,44464,52812,64,57500,67633,41,0,27356
56159,1065,47772,56078,700,57258,65363,365,29464,36188
56158,156,65268,73897,142,65556,76406,14,37500,46386
56157,303,69375,84895,204,71759,98990,99,45536,52736
56156,2503,68380,82761,1691,83099,91908,812,23214,58223
56155,217,49719,71581,152,49896,71689,65,35417,66302
56153,94,46500,50795,54,51667,61211,40,28125,36733
56152,551,59844,70449,353,69922,83303,198,31667,45524
56151,327,69107,81885,213,86094,103088,114,31071,41067
56150,1143,55304,66131,712,64891,81000,431,34408,38746
56149,514,52857,69253,279,70781,86242,235,27813,48845
56147,90,59792,80009,53,88977,77296,37,54028,83895
56146,29,44583,51021,24,47500,50775,5,0,0
56145,252,42353,57518,146,61000,71629,106,25833,36264
56144,465,45288,63199,294,65446,80198,171,24375,33481
56143,2022,62969,91653,1224,72328,112583,798,46737,57299
56142,425,53036,62108,252,67500,79471,173,26250,33697
56141,126,60625,66578,90,57500,71914,36,48750,47475
56140,26,58750,61050,16,60000,80013,10,0,30710
56139,154,54286,66974,110,73750,79381,44,26000,35957
56138,413,68990,82319,272,84375,91615,141,40859,61908
56137,462,70268,78067,304,80294,93544,158,43636,46233
56136,532,43974,69022,322,55179,88735,210,30179,37647
56134,181,53594,82990,106,60833,110203,75,0,42572
56132,226,56563,87176,147,85179,105861,79,35469,51582
56131,920,66000,71125,571,82813,86492,349,33750,44500
56129,326,57000,67870,222,79375,82965,104,29000,34085
56128,773,60104,81907,536,77750,98804,237,29375,37603
56127,220,37500,64108,124,83500,89873,96,24016,27442
56125,27,58125,58185,16,78333,71744,11,28125,38473
56123,200,60938,70797,128,73000,85405,72,35000,43271
56122,251,59934,65220,176,62778,69278,75,45417,55463
56121,312,41111,55043,151,65250,68046,161,37585,40109
56120,410,61250,69422,296,68889,75450,114,40938,53617
56119,355,70125,82472,275,81250,89810,80,36000,53838
56118,187,76042,84359,131,81042,93904,56,70833,62030
56117,125,74792,84627,113,80250,81406,12,18750,16000
56116,279,71518,82083,224,80833,88820,55,55536,50365
56115,529,57821,70540,358,71818,83625,171,27361,38236
56114,155,69107,79334,119,82188,88850,36,31786,41550
56113,90,60833,72337,59,54712,80202,31,39063,49194
56111,185,74583,106604,99,82083,131023,86,64559,77476
56110,707,61250,71230,467,76339,86113,240,31875,41505
56101,2562,50652,67808,1582,74145,83158,980,32288,40202
56098,840,56071,72587,527,69338,86566,313,34750,46355
56097,1631,54315,64631,1043,70670,78019,588,32910,40053
56096,1234,70357,82105,783,87015,99997,451,40446,48389
56093,4974,57852,76651,3271,73946,93129,1703,33109,42420
56091,131,51250,60371,90,70833,73036,41,26875,31800
56090,268,64583,78448,185,79375,86499,83,36750,56437
56089,87,36964,46648,53,33542,41968,34,33611,35674
56088,794,58854,67486,494,67407,81394,300,35395,42309
56087,1315,55614,63900,856,65969,76167,459,29042,38474
56085,2211,59838,70556,1566,76802,81868,645,32639,41867
56083,354,51286,64928,231,64219,80132,123,31302,33591
56082,4920,61515,82171,3249,80320,96970,1671,35296,49829
56081,2433,51573,64038,1482,72500,83074,951,23990,33781
56080,266,78750,78883,181,86932,94104,85,0,39469
56078,177,67188,88973,125,88750,104048,52,43750,51710
56075,76,38750,53561,34,54167,62071,42,34038,45814
56074,697,80850,85748,539,87688,95123,158,40938,46344
56073,6953,63180,75766,4525,81003,92252,2428,36523,41278
56072,887,62284,70495,601,73750,81425,286,30455,44410
56071,4539,91862,108414,3411,105266,123840,1128,41250,56193
56069,1822,70278,79724,1233,90734,94198,589,39598,44994
56068,383,65156,80365,275,84688,96607,108,27917,33223
56065,1034,71696,81054,777,77337,87397,257,39779,47051
56063,1150,95521,116094,854,107083,131277,296,53333,66194
56062,1279,60746,75161,892,74236,87421,387,33125,40593
56060,178,58750,64111,119,50938,66855,59,34028,42417
56058,2433,68936,75847,1714,79363,87159,719,40361,44320
56057,1562,68372,79262,1096,84375,92781,466,37031,40458
56056,37,39583,52622,22,56250,66505,15,30313,32260
56055,1654,71833,85996,1187,88458,100109,467,36875,44345
56054,378,80682,81452,269,90938,95346,109,34205,39542
56052,263,71250,83473,181,82750,88146,82,45556,62049
56051,296,52500,59095,198,59000,69155,98,25417,33378
56050,530,61719,75547,349,76250,86588,181,37031,50366
56048,1646,68500,81547,1148,82321,93091,498,41875,51143
56047,45,90625,87749,35,96563,96277,10,56250,57900
56046,38,50833,55874,25,58750,60740,13,31042,29762
56045,404,59914,73141,309,62583,79546,95,41806,50053
56044,805,90231,99863,578,102059,109849,227,43646,68800
56043,191,58750,71705,128,71731,85199,63,41250,42478
56042,338,66667,77174,225,65750,83158,113,46250,48435
56041,427,66563,77485,271,80417,95142,156,32125,43091
56039,315,73750,85522,228,85000,95992,87,43250,54711
56037,681,69375,76342,485,83203,85209,196,44500,51497
56036,798,59194,85749,541,76563,107508,257,28750,37659
56035,215,53542,78686,139,91458,99076,76,33750,40967
56034,187,54125,69119,141,70481,76343,46,38750,44365
56033,151,46563,66677,97,71875,84480,54,27500,32424
56032,139,44375,55057,93,56250,57051,46,31250,40528
56031,5295,51104,70289,3183,72656,89033,2112,30270,37659
56029,320,54500,61271,195,67708,72954,125,36607,39556
56028,498,81429,94755,342,100313,111645,156,44545,54280
56027,320,44500,92893,174,67500,94601,146,40625,85671
56026,880,72273,83394,595,88902,97111,285,38438,49329
56025,176,77500,84874,139,81406,89478,37,45938,59827
56024,1255,75213,90750,886,74286,96700,369,54375,63975
56023,248,62708,71277,175,73375,82515,73,37917,40893
56022,23,51042,61109,5,142917,112420,18,46250,46856
56021,428,76250,98001,297,83542,114989,131,30750,56412
56020,49,48750,61294,29,71875,77648,20,42500,37580
56019,340,56630,67126,205,76458,82693,135,23750,40474
56017,707,76635,93275,478,91667,108917,229,55104,57500
56016,373,65875,86524,273,74625,97123,100,46786,53905
56014,295,49583,61650,189,66607,75144,106,23438,33991
56013,1984,52545,67657,1145,77872,89044,839,31655,36398
56011,3206,88864,100272,2590,100550,107314,616,49013,62398
56010,509,62361,75217,324,73500,92572,185,31172,43204
56009,596,68000,79830,436,86563,89627,160,31964,50549
56007,8967,49914,66843,5467,61878,80919,3500,30980,41467
56003,6167,74245,107648,3962,100155,138177,2205,36586,49378
56001,19126,56509,71924,10186,78522,91945,8940,35687,45272
55992,2330,88642,86383,1669,95183,102334,661,37052,40687
55991,595,82750,91998,435,93875,101127,160,38864,60048
55990,403,64659,73197,297,71713,84083,106,31250,36652
55987,13683,53302,69975,6973,79115,95822,6710,34032,41299
55985,689,66477,82856,464,80000,90026,225,43281,64860
55983,679,69250,78293,446,85357,93936,233,40179,44943
55982,176,68409,99114,137,69886,99637,39,38750,81987
55981,1755,63403,80577,1054,76636,97942,701,40028,53056
55979,370,68056,70006,217,86078,90958,153,0,38649
55977,73,55208,65974,49,56875,79755,24,0,32733
55976,3046,79695,85298,2117,91683,97519,929,31645,48436
55975,1844,64659,78340,1269,74688,92895,575,34938,42547
55974,987,50393,61324,631,59632,74723,356,22411,33212
55973,92,78750,85248,69,99688,100084,23,50313,40735
55972,1864,86940,119065,1280,96111,105091,584,56010,143731
55971,1134,69063,78384,830,85000,88968,304,38654,45356
55970,435,72361,83300,317,86705,97756,118,34722,40222
55969,417,72054,84639,316,81667,92415,101,47656,57566
55968,61,51875,54521,49,56875,56757,12,48750,42767
55967,383,84821,99114,307,94875,108811,76,46071,55708
55965,1027,54345,75242,674,85333,94378,353,29896,37941
55964,1768,62120,80268,1258,78716,93521,510,26042,43775
55963,2096,78103,90822,1476,97722,106498,620,40375,48628
55962,347,58563,68034,226,68333,75548,121,49583,51914
55961,175,72708,78167,128,85625,89122,47,37813,44155
55960,1148,102833,125427,941,113953,139274,207,54219,60015
55959,935,63472,70516,592,80214,79963,343,45619,53014
55957,298,60625,81905,228,71250,86921,70,43333,59347
55956,873,77981,107684,571,105417,134602,302,46528,54789
55955,943,115491,130894,772,122500,141471,171,70625,72777
55954,555,64519,71161,402,69741,80146,153,31458,42818
55953,349,47176,60534,218,63750,70389,131,40163,39121
55952,907,78942,92637,725,87292,106001,182,23594,32998
55951,620,51522,75875,382,72875,90245,238,31190,49728
55950,84,17130,40985,33,51875,71100,51,15602,15014
55949,770,66136,76741,562,74444,89248,208,32917,41082
55947,3168,70063,87272,2222,84643,102611,946,45254,47619
55946,1343,71046,79411,899,84803,92336,444,45000,48203
55945,549,67313,77977,392,81111,89386,157,33438,46003
55944,2740,80726,94093,2124,93304,104620,616,39828,48896
55943,1280,55722,68798,832,69423,81140,448,35000,43484
55941,435,56250,74190,311,72212,90228,124,28000,31602
55940,1136,60000,78383,763,77708,94592,373,31641,41212
55939,774,60303,71525,503,76719,87772,271,30481,38617
55936,747,63237,84854,490,82115,106283,257,31750,40137
55935,378,75000,91901,280,88750,105856,98,44000,47510
55934,1427,73250,84966,1077,80063,95963,350,36250,46474
55933,115,55250,78172,74,73750,93397,41,43894,48722
55932,791,80781,96770,596,93462,112603,195,36875,44773
55931,161,43125,59420,88,65000,71774,73,37361,43674
55929,447,92734,93345,366,97500,98871,81,40625,52131
55927,1640,78311,87527,1215,80507,94533,425,45625,53182
55926,318,83000,93379,221,99792,109513,97,41719,54453
55925,417,67917,90436,299,83750,101628,118,38214,58721
55924,519,68438,90005,381,72574,91502,138,47500,67870
55923,1759,76771,89967,1217,91853,107054,542,40441,47807
55922,396,50000,60670,289,63750,68841,107,23977,32654
55921,2122,59028,78753,1250,87500,104727,872,34659,40468
55920,2879,104180,132348,2177,124293,153219,702,51250,64942
55919,451,61691,76581,318,70526,86619,133,32031,50670
55918,397,62679,73814,254,71875,88556,143,35066,41663
55917,1444,66250,77962,978,79500,89169,466,36667,49516
55912,11412,50998,68941,7331,67038,82780,4081,29536,39975
55910,529,65104,80062,381,75795,89732,148,42750,48165
55909,585,75670,91489,421,89531,108538,164,34375,44441
55906,8165,89297,116427,5470,115425,147051,2695,35750,49892
55905,0,0,0,0,0,0,0,0,0
55904,10572,67371,84228,6584,77050,93762,3988,49758,61738
55902,11027,91627,144775,6767,126913,186536,4260,53483,76790
55901,23207,77712,91629,14022,95345,111378,9185,49389,58113
55814,0,0,0,0,0,0,0,0,0
55812,3569,48528,84614,1545,92723,132440,2024,31667,44856
55811,10824,67989,95773,6553,88050,127124,4271,37420,45047
55810,3495,67881,80237,2145,95365,100738,1350,34107,46519
55808,2483,45078,59876,1367,54628,64595,1116,37431,50961
55807,4246,50250,64375,2222,62583,74481,2024,37094,49306
55806,4295,35625,50041,1626,49487,62996,2669,30238,39925
55805,4879,31872,50835,1475,61417,78084,3404,25852,37847
55804,6115,86849,110448,4249,106261,129018,1866,51371,65029
55803,7624,83988,98108,5072,96746,112082,2552,44469,60547
55802,1313,40530,60924,343,90375,113122,970,25000,41964
55798,242,59722,76079,181,78750,86690,61,46875,44074
55797,694,71148,81637,471,84013,94028,223,57981,53617
55795,626,55278,72460,418,73333,82574,208,31923,40334
55793,324,60833,67457,245,73750,76882,79,28250,31520
55792,4757,44213,57297,2378,64349,73236,2379,23660,38240
55790,837,62784,72610,561,75313,84466,276,37625,45521
55787,277,58250,71699,185,59750,70716,92,37083,69001
55786,156,47885,62744,99,59375,76134,57,28036,34649
55785,114,48750,54796,96,48750,58323,18,22500,31661
55784,56,36250,46830,32,0,56369,24,31250,34108
55783,980,68636,78595,631,82434,87772,349,39583,58737
55782,253,47440,63680,123,77188,85383,130,36146,41044
55781,311,65750,85456,221,80750,98781,90,41875,50180
55780,68,51071,69409,49,60750,81314,19,28438,27189
55779,1469,88079,101933,1064,99444,116621,405,43203,59691
55775,604,78929,89925,461,86012,99918,143,41750,45548
55772,21,58750,49343,17,58750,51006,4,0,21375
55771,709,46875,55903,364,62237,74408,345,23603,34363
55769,1133,56180,66339,637,67639,78386,496,41190,45971
55768,1285,55612,64984,804,73542,75761,481,30273,45093
55767,1054,59808,69282,637,76920,84769,417,35515,44115
55766,7,0,99186,5,130625,131560,2,0,0
55765,361,52981,62415,239,62569,72231,122,24583,41451
55764,266,32500,42892,121,54750,56485,145,24375,29861
55763,311,59866,65667,192,68750,80697,119,32625,40717
55760,1414,50278,68449,915,61314,81711,499,31250,41214
55758,80,46607,51686,39,56250,61813,41,35750,31985
55757,317,57750,62490,206,71000,72398,111,34306,41950
55756,134,61667,64637,96,68000,74831,38,33333,36366
55753,541,44266,50763,312,48542,58038,229,25057,38037
55752,195,65179,65611,133,77813,77215,62,32500,39637
55751,731,74609,76272,499,78984,86617,232,43125,52074
55750,896,58864,65967,633,63670,73573,263,37375,44212
55749,202,75000,74675,114,79375,79397,88,0,68052
55748,647,47083,57440,430,62639,67943,217,28917,33591
55746,7517,47452,63981,4388,68958,79408,3129,28719,39460
55744,8772,56366,73332,5426,75229,91783,3346,29094,41890
55742,129,56750,62736,83,67813,72671,46,0,44811
55741,1565,62009,75112,1018,79727,89090,547,35213,46427
55738,221,64792,78357,164,70833,85895,57,49226,55698
55736,642,48542,57170,369,59844,67927,273,34219,41744
55735,727,52108,59696,455,60568,68925,272,29038,43213
55734,2721,58129,70931,1572,72155,91722,1149,33206,39147
55733,1999,103194,105720,1590,105714,111117,409,53125,67057
55732,634,53846,65719,404,66667,81369,230,30556,37423
55731,3014,48247,64184,1515,78702,90956,1499,32380,35963
55726,407,70729,81917,288,79054,84665,119,32917,42090
55725,51,51250,62333,31,48750,66458,20,0,55940
55724,366,66964,74950,248,75625,83989,118,47813,54552
55723,831,59489,73287,490,76667,90210,341,37813,48103
55722,451,31507,54720,269,54583,70748,182,26048,29968
55721,1381,68997,82665,1044,80833,95117,337,32386,35424
55720,6932,56429,74366,4518,72000,86611,2414,38507,46272
55719,2603,44934,57318,1373,64609,68386,1230,26523,40336
55718,1313,65750,80583,871,88958,100190,442,32714,37825
55717,169,78482,108890,124,84375,125531,45,48750,63036
55716,141,53594,56341,89,50625,52325,52,50833,55437
55713,532,45500,53904,261,65446,71256,271,23906,31234
55712,294,39896,61652,173,49583,67124,121,26940,50999
55711,191,44531,62382,121,64375,80074,70,24167,26864
55710,557,73576,75701,296,82500,96491,261,52639,52123
55709,1693,61276,75938,1246,70000,83500,447,43086,51524
55708,317,47083,59897,140,70500,76939,177,38750,43174
55707,1443,68365,78595,1095,80472,87796,348,37188,45677
55706,846,46890,58301,508,53438,68768,338,32727,39928
55705,1524,47833,58982,849,63075,74843,675,27523,37564
55704,459,50781,63571,301,68393,76059,158,24792,34934
55703,329,58110,64354,191,59435,76538,138,38077,45815
55702,218,61389,72849,145,71806,85802,73,44063,46414
55616,3332,65841,76761,2170,74767,88601,1162,45222,51738
55615,142,52857,72806,73,55625,84658,69,38750,59858
55614,1124,60595,74484,690,80250,93147,434,26563,41937
55613,116,58125,165507,72,0,238968,44,36364,42582
55612,244,71842,84896,140,84167,105044,104,40303,53579
55609,91,147725,127234,91,147725,127234,0,0,0
55607,90,0,69996,63,95625,85971,27,0,30919
55606,136,50568,67274,75,0,95805,61,29479,32193
55605,346,54022,64125,219,61250,68691,127,38438,50617
55604,1624,61214,76102,1065,72383,90036,559,42250,46752
55603,257,50764,58154,110,54063,77296,147,39107,41676
55602,149,44375,63835,59,92188,103947,90,35385,37539
55601,61,0,112695,50,153750,125926,11,0,47755
55455,0,0,0,0,0,0,0,0,0
55454,3473,20358,31182,1453,25940,34309,2020,15097,28100
55450,7,0,0,0,0,0,7,0,0
55449,10091,107053,135572,7825,122292,150183,2266,64612,76915
55448,10452,80775,95184,7382,93199,106380,3070,53046,61909
55447,8691,111808,143874,5707,140712,174328,2984,69643,81790
55446,9752,140656,167586,7280,171451,196469,2472,58611,78785
55445,4169,91304,114363,3208,100536,128382,961,52716,54532
55444,5087,82921,96027,3717,94006,108499,1370,55238,57182
55443,11137,79924,100575,8264,91326,112167,2873,52538,60665
55442,5334,110675,146820,3705,138996,173545,1629,64185,82014
55441,7908,83675,120874,4838,107676,144762,3070,53662,79105
55439,3506,136558,198874,2799,151705,221766,707,58042,105293
55438,7031,87395,129296,4381,121635,165747,2650,55541,65723
55437,7871,82860,109566,4746,109638,135021,3125,49809,68573
55436,5809,107104,170292,3875,158029,223037,1934,48803,63186
55435,7356,69659,102703,3116,111008,150390,4240,48482,66849
55434,11282,74520,81505,7535,86895,90983,3747,43148,57588
55433,13675,70477,78716,8346,84645,91326,5329,43546,53115
55432,11758,65472,77181,7368,75446,87957,4390,43558,53640
55431,7892,91788,102018,4916,101540,116629,2976,50665,73540
55430,7621,65505,72681,5000,68178,74986,2621,52967,58992
55429,10026,56145,72858,6228,63269,83101,3798,40368,48764
55428,12645,58219,73033,7941,74604,84584,4704,37424,50997
55427,10163,80729,94846,6327,103010,114666,3836,44069,59045
55426,12030,81623,97512,5910,104808,121645,6120,55050,72910
55425,3912,66134,81932,2180,82292,89153,1732,50604,66846
55424,3672,193333,269190,3023,233995,304797,649,48313,99696
55423,15350,70106,87883,8922,86037,103011,6428,47566,63413
55422,12602,76803,99743,6996,97126,131000,5606,41836,57662
55421,12166,62189,77181,6477,75130,93259,5689,43477,55407
55420,8358,63271,77612,5180,76712,90610,3178,41842,53248
55419,11095,113675,152912,7144,141635,182651,3951,75451,89784
55418,13553,73551,93656,7004,97482,117159,6549,49738,64121
55417,10657,98105,116579,6594,127500,142972,4063,58829,69848
55416,16887,93155,128335,6837,145258,180067,10050,69326,92106
55415,2204,109667,145070,639,196250,238527,1565,79872,106911
55414,12318,42139,65049,2710,83275,114735,9608,37336,50206
55413,6893,68336,87737,2773,82882,97432,4120,61169,79683
55412,8600,50481,66638,4857,61607,76320,3743,34554,50658
55411,9581,42153,60641,5976,49455,62773,3605,27455,50332
55410,8083,127936,168516,5167,154067,204514,2916,70068,95350
55409,4811,79951,111542,2543,116942,138736,2268,59889,80021
55408,15710,61896,84313,4836,81265,112864,10874,57837,70309
55407,15106,66498,83240,8395,78804,89985,6711,47471,68075
55406,15661,75041,92181,7994,95667,114221,7667,52965,67161
55405,7679,62349,100958,2718,101435,149836,4961,52865,71490
55404,12235,35610,54452,3827,40120,63418,8408,32601,48730
55403,11419,50584,81235,1896,125714,159707,9523,41760,64268
55402,339,58563,74957,14,0,0,325,59438,75738
55401,7154,102558,125638,1774,130804,169796,5380,93843,110816
55398,5705,93851,107140,4319,104764,115328,1386,64516,68688
55397,1034,69050,81989,710,83796,92601,324,41618,48685
55396,955,58563,74401,556,67813,84770,399,39353,55679
55395,1128,55300,61880,582,75625,86730,546,19615,32360
55391,6594,126284,237803,4524,187143,298177,2070,56106,101772
55390,959,93063,96713,708,96285,107383,251,47361,62233
55389,971,73375,81831,723,81797,93109,248,31000,41532
55388,2106,94481,104526,1695,106678,115567,411,39464,54072
55387,4961,101085,116320,3679,117685,133598,1282,39677,63990
55386,2840,165568,180128,2451,190524,199074,389,50288,58973
55385,491,58750,70215,326,75909,84132,165,39688,41808
55384,1265,48661,80440,498,56389,113473,767,36012,57090
55382,1329,77344,95926,900,85588,109265,429,51484,63712
55381,813,70188,78937,516,83750,90681,297,49375,55656
55379,15332,89056,108282,10979,102536,121178,4353,53029,68321
55378,10886,120713,138897,8717,130190,149607,2169,67740,85721
55376,6075,110306,120623,4890,121026,133868,1185,57962,61476
55375,1336,117667,123649,1081,131750,136490,255,50375,62910
55374,5354,131114,139286,4267,143876,155258,1087,53770,65760
55373,2093,80408,111861,1384,110865,136317,709,51672,59066
55372,12177,115250,147389,9292,130593,162349,2885,58601,92864
55371,6356,71706,81074,4467,84018,90383,1889,31035,49304
55370,241,71964,92468,158,86429,103827,83,41875,58889
55369,15579,93779,111903,10231,110814,129662,5348,65686,75383
55368,793,73173,94435,587,95069,110979,206,38875,45097
55367,350,72500,86687,248,88750,99288,102,54500,53361
55366,220,34750,54302,148,38500,59122,72,26000,37750
55364,6542,99485,162042,4240,144167,216859,2302,31552,58398
55363,1787,73555,79600,1335,76063,83852,452,40561,44890
55362,6947,76708,92171,4780,93000,108307,2167,42369,50685
55360,1025,100107,105558,822,105192,113736,203,53958,67566
55359,2264,106081,162863,1720,135938,181062,544,47656,103586
55358,1945,81528,107257,1422,93269,113982,523,46510,85229
55357,1187,116696,175704,943,132083,204467,244,46167,56325
55356,2260,138681,319667,1755,195586,395887,505,31563,52471
55355,4105,59458,79516,2577,75052,95882,1528,27931,39830
55354,1003,72847,86621,722,86146,97370,281,38482,51804
55353,1231,83708,92656,914,95152,104783,317,46250,52280
55352,3201,91581,106543,2416,111618,115985,785,47093,63396
55350,7897,61758,82445,4415,87722,110827,3482,42835,44145
55349,1567,73173,84822,1020,89722,98235,547,42721,55751
55347,11496,140028,184281,8629,167436,211074,2867,60479,99039
55346,6381,118111,139717,4987,131721,154777,1394,69514,82908
55345,8785,112907,142556,6077,146976,169632,2708,44836,76000
55344,6729,78750,106579,3769,96843,128573,2960,65174,77769
55343,12213,68211,88631,5872,86000,109882,6341,51922,67104
55342,751,59583,76874,461,73750,91639,290,40333,49392
55341,1086,112414,135502,889,122067,149521,197,51875,69570
55340,2984,149000,200183,2499,163701,216051,485,61458,109019
55339,376,95000,102356,289,100750,114504,87,42917,53449
55338,411,65341,77637,264,80000,90063,147,41161,50542
55337,17923,76596,91662,11873,94102,106209,6050,46220,58308
55336,2982,65592,77172,2145,80926,88861,837,31554,43170
55335,667,47569,67539,404,67368,85714,263,33371,38121
55334,1168,55608,74225,736,76250,85360,432,29286,53994
55333,322,64688,66947,227,70625,76160,95,25313,38167
55332,743,54097,67187,451,68160,81420,292,30000,43437
55331,7501,140520,205792,5936,162165,228515,1565,73771,102468
55330,13355,93969,103867,9846,102195,114765,3509,51662,62295
55329,802,68684,76736,486,77778,82489,316,43889,65211
55328,3382,99444,113381,2483,116993,135899,899,37375,48253
55327,1565,113878,145032,1227,138315,166426,338,58542,65847
55325,1686,75000,84333,1249,85915,95546,437,48516,50119
55324,437,73750,93371,353,87188,102225,84,35000,44889
55322,1363,99263,114862,1048,111250,129595,315,50469,62446
55321,1789,67938,76406,1177,80662,88849,612,40313,49670
55320,2071,90562,101267,1609,95436,111378,462,49079,60399
55319,1990,91167,111526,1540,98494,121697,450,50185,70209
55318,11052,92094,115123,7211,123664,140627,3841,48742,63844
55317,8002,119690,162588,6012,139432,187156,1990,70025,85169
55316,9099,96469,110412,6794,104402,120156,2305,51661,62043
55315,1922,109393,128376,1551,117054,142601,371,67574,63491
55314,448,55313,83092,300,79750,102566,148,40278,42906
55313,9355,80520,104565,6650,97415,118255,2705,40633,66211
55312,537,75729,82846,422,86136,90250,115,37813,50014
55311,14360,131723,157352,11168,151646,172462,3192,62384,100162
55310,588,62097,84741,332,88056,104008,256,54750,58614
55309,6518,95720,113528,5431,102510,119131,1087,43194,72978
55308,3270,92315,101643,2478,101389,112057,792,38026,53858
55307,1316,66176,74611,886,78750,87921,430,37803,45356
55306,5969,74505,92733,3917,87801,104120,2052,57760,67927
55305,10049,87461,130559,5418,111442,168951,4631,67602,84216
55304,16809,109227,129486,13714,118122,139344,3095,58714,72786
55303,18341,87012,102170,12800,97740,114003,5541,53071,69487
55302,3004,73184,94796,2105,87793,114053,899,37841,47030
55301,4881,96819,106726,3728,113175,117572,1153,51110,60586
55155,0,0,0,0,0,0,0,0,0
55150,70,49286,106126,32,125000,164894,38,33750,55224
55130,5622,40922,56907,3731,44537,59794,1891,26997,41138
55129,9316,130812,153260,7057,143562,172117,2259,70135,92243
55128,11518,72855,88762,7466,93741,102893,4052,44191,57383
55127,7823,101964,141737,5138,134156,179608,2685,44132,66592
55126,11492,96636,120373,7448,127370,148538,4044,54500,67165
55125,16653,100793,125000,12043,119189,142856,4610,57917,75058
55124,20607,90183,111781,14642,108125,130099,5965,51791,59710
55123,9801,120131,150349,7582,142399,171175,2219,62607,73966
55122,13337,76997,102810,7905,109424,126605,5432,50877,63158
55121,3687,68365,86439,1980,92015,108660,1707,48011,59437
55120,1982,90758,131933,1340,128600,166896,642,49688,56572
55119,15158,60237,79990,9689,69434,86207,5469,44333,59979
55118,12292,69375,100219,7127,102161,133262,5165,38545,52042
55117,15985,55821,77002,9929,65840,90451,6056,38741,49662
55116,11707,67204,98788,5425,107163,135620,6282,44962,65027
55115,3539,111114,155644,2568,140000,190313,971,52761,62325
55114,1664,63600,83716,435,130551,130775,1229,54856,66972
55113,17861,72852,96519,10245,98131,121366,7616,46549,61049
55112,16888,78927,97633,10710,99943,116949,6178,46339,60331
55111,64,0,83441,0,0,0,64,0,83441
55110,16301,87341,109072,10999,105021,129858,5302,45113,60869
55109,12409,67435,85212,7587,88967,103248,4822,38197,52406
55108,6416,76967,100530,3485,110391,123918,2931,50364,70411
55107,5347,57468,81571,3095,69205,91544,2252,45644,62790
55106,17800,53617,66672,11499,55983,71063,6301,37012,51069
55105,10601,95696,145506,5698,147039,207925,4903,51646,69148
55104,17583,62009,84073,9004,79174,103818,8579,45454,60634
55103,4969,39047,53303,2472,53782,71725,2497,23856,32626
55102,9832,61295,82764,3588,89483,115635,6244,46815,62528
55101,4546,63250,84179,1116,113676,142092,3430,54508,64824
55092,4017,82561,99925,3188,96053,109676,829,49288,55537
55090,132,50000,69489,87,52250,83233,45,42708,36311
55089,621,84821,99648,449,106250,113349,172,46250,58941
55088,563,103125,134345,453,106845,140598,110,68333,96503
55087,151,105114,109109,120,102500,109118,31,0,100558
55085,184,81250,94600,150,91429,105219,34,35000,40729
55084,701,68125,85004,468,84318,99336,233,38365,50931
55082,13960,99541,133755,9895,113450,155074,4065,52109,77605
55080,1009,84779,102803,765,95221,114484,244,51944,61898
55079,3268,90470,101221,2454,100761,112115,814,52788,61218
55077,5160,86548,127589,3373,113377,155666,1787,53083,58475
55076,9316,82509,92641,6122,94325,107049,3194,47337,58659
55075,8258,63204,72854,5056,77323,85941,3202,38641,47827
55074,815,91534,99988,609,97596,104757,206,59167,78999
55073,1245,101451,119514,903,120060,144979,342,0,45559
55072,1393,45250,56559,745,67260,71764,648,30233,35408
55071,2259,85426,93174,1351,94016,106903,908,59737,64467
55070,2832,86858,93034,2099,87190,97094,733,66220,72423
55069,1882,57014,72523,1239,68250,83981,643,36303,45372
55068,10631,107268,124774,8313,118571,139299,2318,49674,63750
55066,8088,60950,78560,4848,80519,96401,3240,34410,48019
55065,492,97315,111690,337,120536,130133,155,62292,66548
55063,3777,61467,74907,2345,79871,91729,1432,30898,42583
55060,11881,69248,86197,7755,90883,103370,4126,37269,51977
55057,7890,75850,97737,5108,102000,121808,2782,39015,50862
55056,5196,85347,95892,3705,98731,112923,1491,38856,48121
55055,1505,58569,75931,922,69167,86790,583,44193,52978
55054,780,127424,137926,752,126894,135738,28,0,0
55053,390,78571,88574,301,91094,98337,89,51719,52718
55052,857,70481,80040,605,82188,90959,252,36429,47380
55051,3897,56110,70148,2563,70072,81420,1334,35735,43012
55049,904,71154,82222,703,82159,87304,201,50547,51300
55047,996,94722,159014,704,117786,192487,292,60833,77803
55046,1976,91771,95075,1589,103161,101771,387,52188,55940
55045,2716,105197,107143,2074,110735,117807,642,46774,54450
55044,19519,114137,136920,15512,130257,152315,4007,56696,68822
55043,1533,87060,120067,1036,103088,141115,497,65478,70147
55042,3478,149063,194459,2832,164487,202761,646,61765,153538
55041,3236,68773,85326,2105,88293,101416,1131,39669,50981
55040,4985,81548,94148,3436,91959,106162,1549,51285,60929
55038,8280,103024,122513,6047,123194,137536,2233,61968,77642
55037,1980,46111,58874,1246,58514,71095,734,24554,33513
55036,27,27917,54826,10,0,45360,17,18750,60394
55033,11678,84307,98522,8074,99277,117952,3604,37893,49016
55032,1389,96326,96934,1072,106125,108966,317,44732,52003
55031,682,101563,116104,542,105833,121165,140,57500,76586
55030,503,61438,75389,347,68750,82652,156,42083,48608
55029,20,0,84840,20,0,78470,0,0,0
55027,1072,76600,91305,759,87188,105107,313,36339,49235
55026,153,84583,127345,113,116875,155390,40,42500,47803
55025,9943,88502,106597,6973,105962,125316,2970,46726,56560
55024,12479,100520,110255,9713,111238,122009,2766,46343,59389
55021,11249,65005,78799,7468,78662,91489,3781,38391,48168
55020,1437,134836,150970,1289,144813,159697,148,59306,72705
55019,823,93950,108389,649,97868,119868,174,57500,62226
55018,359,86964,103603,252,106250,121471,107,36406,59527
55017,332,62222,75638,227,69531,81250,105,50536,62372
55016,12117,102334,117516,9650,110503,125202,2467,55625,73925
55014,10250,88589,102597,7589,100567,115305,2661,51474,60814
55013,2696,92672,96805,2030,99747,110044,666,36172,48062
55012,741,77182,89013,508,87333,100782,233,49417,60838
55011,3799,110203,111154,3094,111425,117216,705,65958,75919
55009,3402,73929,92930,2241,101339,113558,1161,40880,50284
55008,5984,73852,84368,3865,83140,96812,2119,41534,55076
55007,911,55787,66390,651,66181,73955,260,30500,39298
55006,1496,52400,66291,930,66900,79606,566,30978,39531
55005,1702,85563,98691,1307,92989,108655,395,51506,59765
55003,965,87986,106499,647,113958,131095,318,38824,53590
55001,1185,109646,163640,837,136953,195038,348,92667,84325
54986,2298,76483,90725,1589,90906,105317,709,40594,55929
54985,0,0,0,0,0,0,0,0,0
54984,1413,52644,66950,894,70707,80720,519,31660,42570
54983,1843,60262,69695,1184,66644,81264,659,42031,46506
54982,2982,51859,68098,1930,63830,81044,1052,27929,41258
54981,6826,58963,80627,4041,73539,102113,2785,37540,47036
54980,72,51000,58900,37,80893,82524,35,24009,33926
54979,602,68152,75470,427,75625,75408,175,60250,71204
54977,616,70192,79326,494,78690,86235,122,37857,47447
54974,597,69432,78737,458,76346,85221,139,32875,47289
54971,4369,60456,71434,2515,78708,89313,1854,35726,43708
54970,1339,51793,67143,769,61523,74765,570,28750,53111
54968,1293,50915,59613,785,62589,69725,508,31932,41288
54967,202,53125,63769,134,56016,73204,68,29167,34843
54966,791,57350,74774,611,62917,83110,180,30000,38344
54965,573,64632,78620,421,73036,91073,152,35000,44128
54964,400,72500,84265,294,83088,96672,106,45875,46823
54963,2959,62721,82580,1996,87016,100236,963,38345,43992
54962,485,59464,67989,331,67614,74070,154,43947,49212
54961,5858,63228,83087,4013,76289,94847,1845,42325,52646
54960,1188,46786,58698,738,64423,70974,450,27750,37029
54956,18502,66453,91651,11577,82454,114748,6925,40408,46712
54952,11982,56774,80918,6609,82823,108806,5373,35677,43602
54950,1200,54125,68100,788,65000,78968,412,32500,41493
54949,1412,65375,75837,966,72500,79417,446,35313,63230
54948,100,50000,58229,60,59375,60390,40,41667,50653
54947,937,87917,100423,687,93640,110154,250,52222,70128
54946,0,0,0,0,0,0,0,0,0
54945,1566,58784,75553,1014,72375,83403,552,33409,59565
54944,3337,89123,105987,2696,97700,114131,641,49095,69978
54943,853,47159,60495,540,61477,71409,313,29896,37389
54942,3621,104161,114374,2879,113108,125704,742,53782,67497
54941,1130,59667,82603,743,77284,100440,387,27723,42867
54940,1753,80777,89050,1348,89122,99928,405,42054,50815
54937,8086,70372,93608,5604,88910,110282,2482,46091,53176
54935,17196,55704,68243,10304,71608,84804,6892,34710,39751
54934,95,65729,66021,76,66458,68593,19,0,55732
54933,148,0,53881,106,0,54064,42,24722,51067
54932,442,86458,98033,346,99038,106503,96,50500,64771
54931,130,61250,79643,112,61875,82304,18,0,63089
54930,734,55000,72358,521,67250,84159,213,31118,36235
54929,3878,53000,65982,2480,67917,79684,1398,31724,38436
54928,170,61765,68164,138,64167,75193,32,31250,37850
54927,206,107833,106191,157,117917,123292,49,49485,51396
54923,3612,58019,72198,2416,70435,83314,1196,31375,45021
54922,510,62500,74940,327,75809,90307,183,37375,43746
54921,488,60938,69517,345,67697,82049,143,34375,35004
54915,17578,67490,83103,12035,83830,97594,5543,37269,48505
54914,13296,61279,75946,7631,81993,90902,5665,39900,51205
54913,8788,86916,118411,5983,114082,141009,2805,52524,68130
54911,10245,53852,70087,5815,68610,82586,4430,32119,48143
54909,891,60545,69747,604,67315,82144,287,30234,40418
54904,9718,75633,92789,6569,89781,107575,3149,37220,57754
54902,9932,54175,64591,5208,71860,81852,4724,34228,43253
54901,13449,50579,62526,6727,70126,79031,6722,34227,43857
54896,730,44438,54775,428,60893,68797,302,29125,34555
54895,404,56563,64828,245,69844,83491,159,25893,34151
54893,1824,50774,68001,1220,55926,77542,604,27500,41942
54891,1409,55670,75724,866,78750,87778,543,32014,54971
54889,1096,56146,67128,717,67036,78967,379,28403,38147
54888,565,54948,69810,366,66111,86041,199,33580,38265
54880,13289,51827,66012,7416,71394,80426,5873,32150,44145
54876,782,58750,72342,554,66500,85198,228,22500,29481
54875,571,45164,55457,331,67188,74727,240,0,27095
54874,1469,75250,91829,1116,82500,102641,353,52730,53974
54873,1414,56932,76040,964,74605,88982,450,28214,46408
54872,1251,50383,63608,733,61250,77262,518,32857,42429
54871,1254,51210,63724,842,65761,75667,412,25789,36381
54870,742,61190,85657,543,66797,95492,199,39766,55492
54868,6727,53093,74241,4126,69266,95374,2601,29692,38256
54867,235,28750,39212,150,33000,40933,85,17656,26201
54865,256,53333,64855,169,53125,70482,87,27083,36715
54864,549,65509,71677,385,72813,81473,164,32045,37902
54862,157,41016,52538,72,62500,75869,85,25208,28624
54861,44,62000,64818,31,64792,74913,13,0,40162
54859,919,47171,59350,552,65938,74348,367,25938,36701
54858,755,43087,51011,444,51250,61917,311,19941,32405
54857,69,0,32999,54,0,31798,15,0,0
54856,696,58917,66385,501,65250,69916,195,41750,54349
54855,285,49896,66554,205,70417,79580,80,36250,32273
54854,362,68500,86362,276,81667,99819,86,30417,40265
54853,1803,54917,67716,1175,69356,80886,628,32000,39578
54850,110,60938,111141,63,65469,82760,47,51250,147255
54849,830,68235,82718,525,91477,101482,305,36953,49030
54848,2623,48341,58486,1637,54928,65339,986,28571,44240
54847,1142,57308,70445,760,66296,78057,382,36731,51132
54846,261,55938,65657,214,72500,74230,47,16875,26621
54845,36,66250,73606,29,82708,80941,7,63125,43214
54844,118,46667,68393,81,63906,85900,37,35250,30068
54843,5309,56155,77107,3346,68297,92139,1963,33471,48852
54842,83,87054,84748,65,87411,89948,18,58750,65972
54841,122,49792,56629,65,56250,66885,57,35750,41132
54840,1984,55134,64321,1262,64844,76130,722,25758,36069
54839,138,48333,58083,86,53571,69585,52,31458,39062
54838,476,59821,72038,312,63000,79177,164,46250,55692
54837,1669,52123,66428,994,66842,80435,675,33348,44125
54836,421,82396,102800,333,88083,118561,88,33750,41217
54835,456,37328,53838,304,46071,63699,152,25893,33172
54832,169,51953,59482,98,61250,72594,71,30809,36020
54830,1461,54517,64510,893,63906,73803,568,36429,47411
54829,2266,47736,69267,1394,67241,87070,872,32676,38657
54828,446,52500,63891,273,77926,81434,173,31563,35177
54827,186,53833,60149,88,61500,73495,98,43750,44662
54826,308,55875,73960,205,73393,87310,103,33750,41530
54824,1018,60114,72085,690,72500,78159,328,33684,56348
54822,1941,60528,78297,1350,71538,87191,591,37014,55423
54821,576,51071,70829,371,66953,89936,205,26442,36209
54820,399,46797,60790,227,62917,72732,172,33333,43821
54819,1064,46776,59673,695,59940,71420,369,28472,33043
54817,952,62500,74539,626,79118,89038,326,35476,46529
54814,1265,54614,65347,822,56923,71449,443,39728,48709
54813,260,58125,69770,173,75114,77392,87,28068,51301
54812,1990,47000,62536,1495,54360,70279,495,31472,32955
54810,1112,57500,75549,693,69688,90553,419,33068,42552
54806,4659,49133,62440,2753,62477,73954,1906,25367,41054
54805,646,43462,68559,405,63583,85359,241,20982,39603
54801,3109,51839,64227,1889,71205,81807,1220,28261,35327
54773,1353,59435,74083,882,67222,91243,471,24042,32924
54772,423,58482,67673,312,69286,78014,111,23125,34656
54771,1512,55833,69655,1096,65673,80938,416,26786,34726
54770,839,64669,78468,539,70250,94254,300,31250,47856
54769,248,61250,78404,164,73750,87087,84,53125,61452
54768,1762,53542,67324,1267,61250,75079,495,30083,41022
54767,1364,77159,83486,981,86016,94093,383,49750,52064
54766,713,49904,60804,496,56250,67029,217,27031,43077
54765,7,0,0,2,0,0,5,0,0
54763,500,54808,66497,297,73533,83071,203,26838,39401
54762,512,50227,65079,341,65179,74827,171,30903,41956
54761,484,61667,68720,323,71280,81016,161,40268,44052
54760,104,37500,52848,43,85729,88826,61,16875,27485
54759,652,56364,65102,427,75050,76955,225,33542,39130
54758,1974,63024,72917,1375,72958,83951,599,32165,43347
54757,1402,57708,70299,996,66324,78699,406,35100,43857
54756,420,63750,75668,293,77019,79288,127,31964,59313
54755,3017,53491,69400,2057,66289,81974,960,29667,39569
54754,784,47095,60293,447,56583,69481,337,36125,46629
54751,9644,54380,70947,5013,75959,92248,4631,31414,45269
54750,370,72250,87330,262,87500,99151,108,40000,57215
54749,595,53207,74034,371,71750,91704,224,25000,38310
54748,650,41618,58076,406,41851,56563,244,39417,59770
54747,981,51250,64030,661,61625,68506,320,31667,47615
54746,284,61481,67339,183,54375,61140,101,28750,42179
54745,1020,57880,79024,660,65303,83164,360,32273,67970
54742,1940,68385,83838,1452,86964,97526,488,22955,41386
54741,672,55200,61749,463,64297,67900,209,32375,39833
54740,832,65697,75328,515,82604,91717,317,39554,46817
54739,1941,80760,88045,1497,84975,95198,444,42870,55280
54738,1266,77315,90548,869,95972,109000,397,38203,47525
54737,236,73125,77790,185,81375,85909,51,34375,45863
54736,1802,57955,76037,1233,72165,87264,569,30234,48501
54734,300,64500,76999,206,69500,89858,94,38214,43018
54733,464,49038,70409,348,55417,78668,116,31000,36472
54732,1335,47070,62106,860,59896,75083,475,25727,33096
54731,345,50156,63248,196,63125,81441,149,34779,38326
54730,1977,68240,80817,1339,77740,88091,638,41804,55385
54729,13815,65566,84250,9054,80117,99725,4761,41227,49839
54728,2573,53575,67908,1765,62674,73883,808,34278,50399
54727,1932,57742,66788,1326,67857,77392,606,31250,39632
54726,705,58792,71967,511,65625,76561,194,35833,54416
54725,1258,60833,84346,902,71667,94172,356,39286,49953
54724,2805,54703,67465,1812,74420,84613,993,23932,33764
54723,460,66944,78434,248,84063,103196,212,40263,46400
54722,1432,60517,84749,946,75375,89330,486,28971,72786
54721,559,62793,79083,384,67273,89630,175,31696,53267
54720,3402,62771,74164,1848,76014,92993,1554,37414,51556
54703,17611,61935,74966,9953,85528,92948,7658,36957,48486
54701,16478,62753,85279,9023,84989,112649,7455,39914,48306
54670,516,60000,73473,396,73125,83414,120,33000,37803
54669,2939,77957,94338,2119,100438,112280,820,33690,44079
54667,1897,58659,72344,1210,73750,84099,687,41146,49512
54666,1199,65265,82358,858,66310,86410,341,40729,65317
54665,3617,47320,63819,2211,66969,81088,1406,23042,34959
54664,716,44615,58279,409,64602,78934,307,25938,29795
54661,1632,62674,79208,1041,82109,96871,591,43750,45339
54660,6583,58359,76421,3941,69338,86788,2642,40709,56484
54659,526,52778,63872,352,67727,75987,174,34821,35490
54658,1088,70833,80957,744,85556,94328,344,38824,47409
54657,140,56667,62616,102,63036,71430,38,23750,38961
54656,7113,61015,72357,4694,73348,84060,2419,35712,47285
54655,652,44783,66873,424,61111,81792,228,24643,32910
54654,80,51250,52234,51,52063,59971,29,21544,38628
54653,334,56500,68501,221,69792,76519,113,50035,51891
54652,345,52321,64064,228,70000,71903,117,24250,46402
54651,584,50156,57579,409,61250,67500,175,29821,33683
54650,10575,68542,95630,6649,93321,116585,3926,41087,58114
54648,630,61912,73256,445,77188,78595,185,39583,51128
54646,1659,51553,62339,1084,60231,70236,575,27981,43271
54645,32,0,41444,12,0,47308,20,0,34855
54644,534,63125,72770,365,73375,85610,169,32250,39366
54643,2,0,0,0,0,0,2,0,0
54642,801,61458,73686,581,66477,81110,220,34318,48019
54641,0,0,0,0,0,0,0,0,0
54639,1054,37155,56282,652,62500,70424,402,22240,32415
54638,594,53125,66304,447,64792,72503,147,36563,36980
54637,96,57500,73980,54,78750,103806,42,21250,24248
54636,5353,82597,96122,3952,96223,112123,1401,40042,48059
54635,749,63144,75178,524,73750,87849,225,37589,43180
54634,1618,50307,63469,1081,63319,77030,537,30982,34982
54632,463,62679,74012,324,73333,85814,139,36250,45452
54631,718,51875,70295,412,64688,83305,306,22647,49829
54630,1729,66971,80031,1149,83456,95575,580,42167,47587
54629,1131,63688,72020,732,74500,85515,399,35184,42543
54628,423,55893,68201,277,63375,80237,146,26250,42515
54627,773,63125,76083,488,80556,89931,285,31023,49956
54626,531,53646,75199,370,68958,90856,161,29375,37355
54625,122,33833,51861,57,45938,61711,65,26563,42532
54624,691,63750,69482,473,78563,80604,218,34167,45084
54623,863,69554,92585,591,88558,101053,272,38500,71060
54622,902,66058,74107,595,79176,86091,307,39297,48917
54621,482,66184,80376,380,75313,87421,102,42857,50852
54619,1186,68155,80014,871,76406,91051,315,39107,44784
54618,822,67143,78634,551,79226,88731,271,39181,52172
54616,994,57273,72091,602,71786,83331,392,33000,49940
54615,4166,52259,65686,2323,70943,86104,1843,28246,37532
54614,1083,66779,80873,700,86184,93643,383,36328,55389
54613,921,44226,58779,501,61875,75147,420,25984,37495
54612,1943,56661,71724,1164,66923,82660,779,40625,53011
54611,496,57500,69110,317,65268,79087,179,38750,50181
54610,686,60625,70748,438,71875,81727,248,38000,44196
54603,6475,47982,67184,3360,60814,75911,3115,33330,55832
54601,20418,51573,71981,9648,78301,103556,10770,33241,41626
54568,2354,47022,67953,1424,80065,88100,930,27877,35595
54566,577,44205,53746,325,54375,63869,252,31389,38561
54565,19,36250,35347,13,39583,41123,6,26250,22833
54564,151,46875,51991,89,60568,64473,62,24167,33816
54563,317,60673,76754,241,65446,88877,76,31750,37534
54562,859,53603,76230,541,67350,93126,318,34839,46742
54561,0,0,0,0,0,0,0,0,0
54560,280,65278,68074,189,71250,80731,91,36563,41786
54559,306,58864,65625,183,69375,77250,123,39250,44104
54558,1063,52566,72722,605,61776,83004,458,44375,56597
54557,449,72361,82506,316,80417,92601,133,53281,58068
54556,571,49844,56090,329,61875,70566,242,22308,35533
54555,2400,51869,66029,1455,62083,80057,945,36042,38461
54554,596,45000,68172,365,60598,84417,231,28839,40410
54552,2117,44632,58736,1128,58214,75536,989,29276,37052
54550,268,38500,53600,184,45000,58625,84,32222,37076
54548,2244,63750,107694,1431,92188,131160,813,46250,65267
54547,728,52571,57745,435,62321,68500,293,27708,39873
54546,513,47386,59351,296,76750,77783,217,28958,33336
54545,475,61250,80140,298,76204,100450,177,38850,42353
54542,239,33897,53166,141,49375,71116,98,20000,27339
54541,521,46467,61271,373,50536,67580,148,35441,42272
54540,448,46964,65173,288,48750,76931,160,33000,39708
54539,587,61696,86021,334,81447,113106,253,27083,49930
54538,1446,38333,49099,770,49071,61692,676,22829,33145
54537,208,43889,51991,145,57813,60473,63,23295,27037
54536,89,45179,48375,39,43750,61597,50,45357,37724
54534,1147,39205,55773,594,57143,72728,553,23188,34825
54531,555,51458,77770,410,66000,91171,145,27629,37726
54530,317,40268,49383,182,50000,62350,135,26827,30440
54529,478,57708,66512,335,70568,76960,143,35288,41257
54527,436,45294,55546,248,58800,72100,188,22500,32771
54526,376,37500,46094,228,48929,56483,148,23571,28391
54525,136,48750,70572,73,49531,89666,63,28750,44587
54524,306,49792,56438,236,60900,61496,70,27206,30173
54521,3894,55812,79682,2514,68786,91520,1380,35774,56251
54520,1781,49056,57774,1042,57813,65023,739,38177,44033
54519,627,46417,67346,384,53438,72082,243,27063,57545
54517,60,63333,71965,39,64028,86992,21,34375,44057
54515,255,49250,51701,152,55357,63255,103,23125,30080
54514,896,58333,66938,592,72143,76200,304,30000,47549
54513,234,52273,64909,145,61875,76821,89,50117,44204
54512,471,55938,69663,306,68438,78378,165,42188,51038
54511,565,53080,67041,428,58214,70868,137,31406,35391
54501,8716,58201,75605,5167,72724,92455,3549,28617,49090
54499,1267,52139,66228,780,62560,75996,487,32014,48082
54498,859,55134,72691,631,61750,83170,228,33056,39956
54495,3471,44638,52924,1938,57941,66131,1533,24608,33572
54494,11949,57172,72538,7355,68731,87275,4594,35806,44360
54493,310,55833,59942,200,63125,68135,110,43125,43888
54491,737,41652,60605,437,51932,63689,300,28125,55195
54490,393,54875,62092,277,55673,65978,116,41389,48058
54489,726,58929,75416,481,74044,88697,245,37813,45214
54488,494,47083,64439,344,65417,75379,150,32667,37797
54487,4225,61875,73024,2770,74637,87418,1455,33750,42915
54486,878,50948,61945,525,59219,71180,353,36806,45852
54485,131,43750,57096,96,62500,66729,35,24375,30674
54484,2272,59874,81803,1658,65950,90886,614,42941,51763
54482,4739,71726,96132,2984,94375,122318,1755,39931,48846
54481,11374,49600,63472,5436,72607,85813,5938,32625,39882
54480,538,56786,63333,379,64250,71400,159,26964,35668
54479,1433,65547,81623,1049,76875,92687,384,38125,42304
54476,8001,66242,80196,5173,78474,90520,2828,38690,54321
54475,671,71250,78114,462,78889,90490,209,46875,50409
54474,1777,65469,78282,1099,86969,89270,678,37972,58814
54473,1049,62014,77947,752,82639,93078,297,26394,38568
54471,677,79028,102348,531,87981,108491,146,50568,77586
54470,901,48438,59603,601,60268,71433,300,26667,32544
54469,746,53929,64666,505,60481,70737,241,34904,47859
54467,5566,62804,84036,3679,83063,98259,1887,40790,49225
54466,1186,54551,67654,846,70385,77643,340,32750,40413
54465,273,40521,49655,158,48269,59333,115,25417,36359
54463,290,47500,63365,161,72188,79425,129,29464,43312
54462,200,51250,64982,128,90583,86652,72,24028,26456
54460,986,49783,71811,685,56607,84146,301,34583,39617
54459,544,52803,63331,358,60769,74708,186,25714,37168
54458,42,61250,79876,28,92500,101096,14,43125,37436
54457,3504,57978,77214,2373,71229,92584,1131,32550,39803
54456,2493,53424,62946,1484,64419,76292,1009,30906,40648
54455,7227,80040,93270,5499,88901,105226,1728,37523,50602
54454,559,56917,77630,387,78281,92481,172,27083,39376
54452,8608,60213,72000,5238,78034,88120,3370,31857,42681
54451,4910,53583,68017,3301,67346,81835,1609,24975,36803
54450,141,55125,73848,117,56607,66291,24,16250,95558
54449,11701,57777,80924,6855,76936,100124,4846,31679,50389
54448,1711,78634,90306,1316,87453,99695,395,38472,50142
54447,219,40536,50406,123,57188,63911,96,19583,28892
54446,1110,60313,73100,810,70000,83278,300,39167,42018
54443,836,73182,87937,652,84167,95204,184,41250,55348
54442,465,61719,72515,341,70417,80625,124,42813,45553
54441,371,79375,93946,262,92778,97578,109,61875,85217
54440,1153,68984,77127,836,81600,85695,317,39276,53305
54437,1137,53404,67767,671,77629,84336,466,34167,40084
54436,836,55606,65683,582,61000,68792,254,32010,45567
54435,822,60603,71209,556,73523,83101,266,37500,43317
54433,759,51467,71360,491,69531,89453,268,27500,36050
54430,59,53125,68480,34,80000,82144,25,44107,49896
54428,466,45833,57452,299,59234,67879,167,35273,38302
54427,537,59250,70754,355,85208,81647,182,34608,39886
54426,1689,65139,79611,1282,78409,89816,407,29931,43901
54425,771,55380,69378,557,64598,78362,214,30893,38363
54424,712,73833,81616,518,83200,92056,194,36250,48890
54423,911,100152,103855,768,107000,113529,143,44044,42410
54422,405,51016,63301,330,51875,67338,75,38750,41700
54421,1445,57188,72805,1043,64191,83096,402,28056,38809
54420,462,68375,76043,378,72200,82725,84,22857,31094
54418,383,68542,77366,308,75536,82469,75,48125,52428
54417,11,0,54391,8,0,63000,3,0,0
54416,643,52344,62148,436,65000,71641,207,28295,37552
54414,1308,62000,70624,969,73393,79771,339,33828,40866
54413,70,58750,57141,47,51250,55702,23,60250,51804
54412,850,66667,81014,600,73421,92560,250,34167,51200
54411,1949,62560,76997,1407,74725,87724,542,33448,47711
54410,927,66339,73962,700,78571,80927,227,57560,51470
54409,5716,51370,62925,3598,67287,76635,2118,27608,36139
54408,456,61818,68935,305,70811,78195,151,40313,45426
54407,555,75298,93485,418,81136,105235,137,40625,54034
54406,1484,71793,83247,981,93431,99582,503,39158,46945
54405,1002,48816,71731,730,51607,71172,272,35978,65186
54403,10091,55768,74193,5931,71539,89753,4160,33056,49395
54401,13432,53378,77298,8101,73902,99624,5331,32407,41939
54313,15602,93288,111688,11718,105665,126860,3884,47655,59607
54311,13807,67507,91731,8883,89193,109029,4924,39172,57597
54307,0,0,0,0,0,0,0,0,0
54304,12287,51277,61628,6826,63576,74765,5461,34501,40638
54303,11726,43177,52971,5857,53874,60876,5869,31825,40312
54302,12789,46513,62158,6893,56735,73393,5896,32956,45397
54301,9448,62648,74402,5027,75865,93563,4421,40809,49228
54247,1049,69353,83487,759,83083,91030,290,38125,61508
54246,406,55500,75981,267,74432,90433,139,38839,45276
54245,845,75156,78610,589,83819,91548,256,40769,47073
54241,6449,52758,63031,3736,67404,78017,2713,30845,39011
54235,8231,61137,81003,5245,72160,93348,2986,32943,57312
54234,909,49688,62028,630,60887,73044,279,30673,34468
54232,449,48036,61286,245,62350,75473,204,26422,37369
54230,1819,66549,82159,1337,78854,91818,482,39375,50151
54229,2169,74436,84759,1586,85942,95302,583,64297,53481
54228,1163,65122,78968,898,69167,88398,265,35865,42531
54227,608,71786,82739,466,92917,94988,142,36389,40372
54220,16988,54732,69291,9947,71175,85242,7041,34719,44358
54217,2890,73990,85793,2128,90900,99192,762,37045,44850
54216,2662,63125,71662,1860,79722,84281,802,31096,38945
54214,152,62813,65551,91,80078,80709,61,0,40241
54213,561,62917,76758,423,76932,86722,138,35000,42495
54212,430,72917,106159,308,87188,120406,122,63333,65301
54211,126,84000,92828,76,104583,122372,50,31667,43364
54210,350,70238,80601,206,94250,106673,144,39375,43303
54209,680,70000,108075,489,80125,130808,191,39583,48437
54208,2366,77653,95022,1804,93462,110127,562,39722,44025
54207,67,62969,70913,44,63438,80102,23,0,48813
54205,812,76625,88604,611,89886,102284,201,32917,43353
54204,708,71944,77700,521,81681,87627,187,38125,46705
54202,806,64028,81859,482,97500,103092,324,42254,49702
54201,2092,62381,70366,1483,75208,80991,609,35156,41027
54180,1231,73920,87735,865,92557,100502,366,51371,52947
54177,1315,50133,62888,881,60815,74948,434,25978,36201
54175,555,59076,64443,387,74219,75691,168,37917,36636
54174,1399,59960,69297,888,66827,78002,511,40234,51760
54173,1667,81688,110757,1336,86563,119807,331,68801,71129
54171,1379,94668,102579,1072,108407,117571,307,0,50112
54170,1351,70372,85456,1016,76848,92758,335,37455,56550
54169,1071,113125,126467,867,126181,138820,204,62365,67307
54166,7149,53336,68495,4501,66355,78875,2648,34588,44938
54165,3078,70112,82854,2146,79524,95354,932,40533,49493
54162,3471,71961,80209,2550,87068,92299,921,34364,42934
54161,1142,54643,71105,755,73005,81181,387,28472,50467
54160,101,61250,75299,71,76250,83244,30,44500,55137
54159,563,53993,71734,378,70833,84703,185,41563,42633
54157,2660,58156,67408,1426,63864,74080,1234,52500,56410
54156,726,35625,46363,373,56042,63368,353,17467,27989
54155,2924,81175,114836,2199,86437,136603,725,33802,46372
54154,2391,54107,66784,1458,69013,82913,933,26952,36532
54153,3166,57353,64863,1983,63702,73819,1183,39830,46153
54151,1445,53567,65991,986,62439,72920,459,35446,47429
54150,318,50208,54334,254,46786,54913,64,0,25911
54149,575,51607,64374,370,61463,74438,205,36375,44258
54143,7109,52657,67250,4069,71264,87916,3040,27372,37102
54141,896,78333,90735,665,86914,102179,231,53456,53948
54140,3822,61352,66841,2271,73274,78939,1551,38438,47597
54139,1269,71875,82370,939,77802,92172,330,36731,46888
54138,461,43393,57938,289,54063,69070,172,33125,36320
54137,465,68523,84438,323,83990,92410,142,34000,64892
54136,2762,60341,68805,1785,71860,85267,977,28850,37329
54135,1038,46473,71102,772,50000,77764,266,31500,43678
54130,10719,72237,89343,7412,87406,106613,3307,37683,47239
54129,1314,73971,88633,1024,83962,98120,290,46094,51751
54128,773,57292,64414,526,76875,77302,247,26898,35140
54127,22,0,107500,11,0,0,11,57083,69482
54126,1314,81786,94002,957,94554,108993,357,40223,50148
54125,276,42500,59781,171,63185,66466,105,22321,45518
54124,1543,49470,62083,1037,61484,70722,506,29800,40358
54123,121,69028,78410,61,82250,101192,60,50938,55248
54121,1460,51864,67966,916,66563,86635,544,28654,35116
54120,110,42000,54239,67,66250,69828,43,18958,27974
54119,253,50625,63453,172,57917,69087,81,26979,42995
54115,18116,82179,99376,12450,94159,113862,5666,48137,62081
54114,2492,50529,59632,1591,61312,72185,901,24214,33947
54113,1427,72102,104198,1094,80694,111719,333,52047,67417
54112,1072,59929,66121,659,69450,78905,413,31705,44568
54111,1014,61471,70817,626,66818,82247,388,50469,51263
54110,2020,73250,84383,1530,87073,96213,490,35588,44698
54107,1477,62974,79199,1012,72283,89854,465,43750,52298
54106,2159,73781,79206,1547,82831,92632,612,35250,43415
54104,554,50469,57348,330,51136,56352,224,44821,57597
54103,191,43125,56976,112,66500,73799,79,31339,33127
54102,455,43542,48568,196,47188,58093,259,39063,40716
54101,1047,79730,94269,791,94583,106788,256,46944,52023
54082,694,110816,116666,557,112617,123415,137,53964,87364
54028,1084,59286,69937,727,72723,82069,357,30625,38571
54027,407,75060,85483,284,80625,95616,123,48250,57991
54026,908,66100,87444,623,71875,92824,285,52216,72795
54025,2651,75099,87969,2034,80417,95318,617,44698,49622
54024,2045,58179,75210,1301,68050,85664,744,36250,54313
54023,1670,88000,96750,1218,98421,106582,452,58333,65720
54022,8243,74938,95353,5103,101696,115949,3140,41413,55922
54021,2917,85467,97975,2103,97443,110098,814,45417,61797
54020,3042,71087,80608,2076,78780,93498,966,34949,49907
54017,6925,80211,93330,4888,93405,110088,2037,41060,47609
54016,12716,101117,122848,9374,120123,141350,3342,51145,64072
54015,1354,88125,91392,1005,102102,97951,349,49519,56295
54014,818,75658,88251,610,80500,93620,208,46250,65375
54013,1350,72143,79145,859,85729,95069,491,38603,47166
54011,2720,78700,91245,1827,89243,104163,893,50197,61049
54010,21,0,0,0,0,0,21,0,0
54009,970,74896,82440,675,80598,91252,295,49063,57789
54007,419,68681,78948,264,78750,92313,155,48438,53728
54006,291,51420,64068,198,58000,68498,93,43125,48812
54005,1194,65795,80421,815,73848,89042,379,41394,57142
54004,963,57458,66715,657,68173,76585,306,38468,42508
54003,356,82292,102461,271,94107,113117,85,58750,64279
54002,2501,75373,85120,1826,87155,99713,675,28229,42029
54001,3248,66379,78641,2242,81615,93228,1006,28235,40861
53969,146,56833,66436,90,57813,70323,56,50000,54693
53968,944,58942,71485,629,69583,83002,315,34688,43551
53965,4755,57738,71826,2944,67193,87112,1811,39119,43455
53964,1427,52850,66613,919,66202,74147,508,33906,48905
53963,5296,58548,70000,3384,70915,82716,1912,42731,42623
53961,372,64878,83653,254,69000,95885,118,62661,54268
53960,1476,69737,82303,972,82661,93998,504,36587,51731
53959,5273,65981,82293,3691,78125,96782,1582,36149,44285
53956,1248,56875,72948,909,67454,83812,339,25662,41097
53955,2376,79263,90838,1615,87550,105528,761,47928,54335
53954,2909,70396,83327,1952,84338,93528,957,45039,56313
53953,140,36563,42626,74,36250,48836,66,39167,35662
53952,1428,51103,63178,890,63590,75509,538,31833,39588
53951,1036,50900,67588,623,65625,80346,413,38171,45290
53950,2054,53226,77111,1222,62632,93695,832,38276,46028
53949,2757,54194,64995,1632,66190,78432,1125,35130,43412
53948,3412,52463,69305,2009,64908,81780,1403,37974,46818
53947,98,35556,44580,49,56250,65653,49,11914,22239
53946,1805,61250,74869,1252,76875,88414,553,30069,41833
53944,910,55750,68795,629,68693,75151,281,32708,43640
53943,382,58864,84219,283,63021,94369,99,47250,51147
53941,1183,70241,79206,908,72857,87777,275,35625,43755
53939,131,64375,140283,95,64375,68923,36,0,324397
53937,366,69167,80346,282,78833,90272,84,36667,45215
53936,598,42955,54703,391,53750,62447,207,26215,35470
53935,101,61458,59423,67,70313,70621,34,33750,37356
53934,2028,44167,52975,1110,56509,66523,918,24427,35661
53933,1393,66685,73743,953,71587,82686,440,35000,49877
53932,956,76316,82458,676,86591,94239,280,42917,46025
53931,81,75625,75837,56,91250,78886,25,54821,54988
53930,545,67250,75215,346,82222,86049,199,41424,50281
53929,1136,55943,68569,713,62438,75138,423,38625,41604
53928,38,68864,65268,21,73125,62486,17,68523,67635
53926,575,60156,74706,396,71563,81281,179,41929,57154
53925,3387,72067,85500,2322,86000,99810,1065,39408,48409
53924,526,51250,60072,339,64028,67926,187,29375,40085
53923,798,69464,82366,540,82619,89869,258,39167,61929
53922,423,73594,87847,286,82500,96394,137,61094,67666
53920,265,49950,69316,164,76667,87066,101,24732,40493
53919,958,72095,87570,679,90938,101191,279,43239,50406
53916,9903,61196,77064,5872,74605,89393,4031,42083,56405
53913,9169,56809,70417,5486,73234,88347,3683,30025,41740
53911,531,86250,91230,390,95000,102630,141,51875,57349
53910,1634,39813,54708,942,52000,63948,692,26964,39385
53901,6213,59971,72298,3781,72722,86447,2432,35993,44615
53827,83,54375,51047,52,59500,57488,31,24750,33255
53826,564,50469,61166,359,58125,68731,205,30804,36520
53825,167,51354,67407,122,63333,77476,45,37188,40107
53821,3293,50578,66960,1881,71285,79932,1412,30647,47129
53820,922,61857,75944,640,75000,89038,282,40500,44052
53818,5713,49545,62479,2831,75740,83260,2882,30488,39802
53817,94,42955,48826,61,43523,55079,33,0,37267
53816,275,62188,70482,211,73125,73872,64,0,54255
53813,2242,65595,76649,1599,76331,90686,643,26708,38774
53811,1268,68469,87409,900,79516,102557,368,34554,46232
53810,148,53800,62637,110,53750,67665,38,42500,43389
53809,1535,55691,66399,1069,61903,75218,466,37368,41518
53808,428,53125,64996,254,67000,74433,174,33409,40340
53807,1875,68197,77785,1272,85261,89191,603,39696,53043
53806,736,50000,59405,467,58977,71776,269,27639,33315
53805,2154,44816,62224,1251,64250,80724,903,29792,32624
53804,535,55170,67920,353,60750,81105,182,34038,37660
53803,513,57083,67607,337,66339,76723,176,40167,43435
53802,21,47708,37010,11,48958,52682,10,11875,19770
53801,435,54205,66677,317,67361,78815,118,25000,32492
53792,0,0,0,0,0,0,0,0,0
53726,2255,41883,93288,682,153750,195839,1573,26324,46922
53719,13895,79992,103912,7478,106742,122445,6417,61266,78108
53718,6868,86263,102936,3767,108027,127584,3101,60945,71830
53717,6157,85546,121480,3439,111990,157690,2718,61460,74301
53716,8098,78532,94204,4917,94880,111591,3181,52077,65004
53715,4660,35740,62079,1012,76607,85098,3648,30446,54556
53714,7391,58247,68806,3740,75054,81011,3651,43121,54884
53713,10190,50782,64635,4955,61602,74280,5235,41674,52445
53711,20864,84683,108627,12005,111030,135987,8859,53906,70093
53706,63,11635,15865,0,0,0,63,11635,15865
53705,12024,71818,101932,5827,108262,138082,6197,46086,66440
53704,20829,63805,79561,10181,83342,98841,10648,46753,59131
53703,17551,42153,71007,2420,114643,172490,15131,38137,54354
53702,73,0,85511,73,0,85511,0,0,0
53599,28,30417,40761,3,0,0,25,30625,41828
53598,1101,97697,114269,821,111681,127632,280,53716,54882
53597,7463,101411,127344,5278,126847,148936,2185,50922,69493
53594,2290,56800,73946,1493,86844,89260,797,28015,43252
53593,9920,104047,133548,6823,129176,156213,3097,60337,80185
53590,16018,83936,97798,10398,104750,115327,5620,50652,61760
53589,8316,72932,96726,5745,89953,110851,2571,47485,60062
53588,1744,71179,83036,1112,84300,97840,632,43036,55809
53587,534,65469,84373,344,73929,91021,190,38333,66423
53586,856,52000,62866,610,60000,70734,246,25000,37939
53585,807,61343,70043,556,71944,78809,251,35368,43129
53583,2483,75846,84457,1675,91250,99929,808,33462,46976
53582,438,67656,78998,311,76705,90734,127,38365,42712
53581,4459,51519,62593,2668,66812,75812,1791,29880,39131
53580,202,57500,69325,132,68500,84058,70,35500,38914
53579,654,64375,74431,446,76786,85303,208,27381,46420
53578,2819,65018,85430,1701,90282,109503,1118,35195,48320
53577,554,71833,95389,383,91875,116165,171,22292,41415
53576,931,71691,75646,639,80539,82617,292,44688,51672
53575,6703,94381,119048,4691,114818,139307,2012,54549,64236
53574,1475,81536,103206,1134,93750,115239,341,46250,57783
53573,1331,49089,63757,792,62333,75879,539,30547,41752
53572,4991,60327,94806,2512,106447,132857,2479,48543,54326
53571,18,0,0,8,0,0,10,0,0
53570,1124,66755,85530,728,80096,100416,396,41310,55998
53569,465,57361,80497,345,69911,90119,120,31591,46813
53566,6606,58148,74513,3797,73338,91344,2809,31863,47309
53565,2043,60048,77130,1187,86115,102277,856,28676,41283
53563,4293,75959,91470,3131,86262,103144,1162,39556,54315
53562,11169,83576,128194,7103,112977,157557,4066,50144,73293
53561,793,83583,109494,561,99792,122932,232,43500,73822
53560,1461,76926,93905,987,87063,105063,474,46154,66929
53559,2265,80273,89490,1729,81566,94972,536,60227,68621
53558,4979,92621,112161,3695,103240,119944,1284,65235,86907
53557,178,63125,66015,129,78029,75851,49,39792,39416
53556,1061,53598,67427,654,58636,77918,407,35417,42272
53555,3734,90338,108464,2596,101333,121136,1138,53558,76916
53554,376,56042,65689,283,63583,72729,93,31094,42231
53553,265,62431,77227,176,76250,97860,89,20938,34381
53551,3412,75000,91865,2378,88250,104706,1034,41333,50882
53550,462,74722,86126,380,81250,90393,82,47500,53609
53549,4299,62708,78926,2591,73465,93375,1708,32060,52886
53548,8202,55677,69968,5415,68545,82915,2787,28633,41128
53546,12585,58750,72248,7571,75412,86828,5014,33313,46621
53545,9953,57440,74694,5765,72735,88921,4188,42347,50920
53544,321,78958,90022,241,88646,100980,80,37000,56279
53543,740,64605,74314,492,77917,88217,248,33750,46153
53541,387,57679,71366,263,70156,79543,124,30500,51114
53540,94,38438,44029,48,66250,61254,46,21607,26054
53538,7440,66990,84224,5074,82592,99510,2366,34480,46857
53537,399,61838,76766,258,67500,71274,141,50694,83577
53536,3635,72485,82549,2384,95710,103350,1251,31942,39577
53534,4700,69478,80635,3160,74981,83626,1540,48576,61592
53533,2917,72072,88331,1987,91660,109964,930,36071,41417
53532,6006,88662,103791,4419,106306,118784,1587,42851,51946
53531,1715,84896,102862,1270,92786,110932,445,53164,58970
53530,1802,54810,66128,1155,66186,74948,647,32208,43869
53529,791,94141,100896,601,105865,112557,190,45208,58543
53528,2547,95457,109890,1684,113243,129344,863,41161,66674
53527,4006,95341,106805,3202,108289,117495,804,54861,61121
53526,240,65000,85536,153,73958,102071,87,41250,50760
53525,1551,70313,79106,1172,75568,88147,379,34726,47288
53523,2117,82083,100725,1369,101165,115834,748,51339,68304
53522,396,62143,69980,285,71250,78861,111,36250,39402
53521,1398,85882,102684,1017,101417,120257,381,46309,54611
53520,2811,63850,74184,1843,73601,82840,968,36515,50786
53518,623,50905,61369,400,56875,71749,223,36250,42151
53517,670,76458,97198,521,81771,106542,149,50536,58607
53516,1055,76518,99895,592,84583,100222,463,67337,96652
53515,938,78250,105659,603,112031,128838,335,42250,62578
53511,18443,51597,65691,11595,61073,74088,6848,33030,45922
53510,598,72963,78512,403,91250,89715,195,43750,50019
53508,2241,84628,97199,1667,99583,111358,574,50463,53530
53507,789,92760,102787,569,103173,112227,220,46250,69960
53506,435,48920,66262,297,60063,76040,138,27083,35596
53505,153,73125,108184,94,108667,137678,59,60547,61195
53504,893,69875,79640,621,79531,92157,272,30357,44697
53503,838,59779,83863,518,86000,99089,320,39821,56026
53502,984,62813,77076,597,84250,89302,387,53516,53006
53501,0,0,0,0,0,0,0,0,0
53406,10892,66997,82535,6809,86197,97607,4083,40071,54085
53405,10372,58244,70478,6598,68712,80469,3774,38125,45654
53404,5387,36224,49250,3204,41745,56050,2183,30850,37162
53403,10406,41157,61043,6470,53875,75270,3936,22212,32155
53402,13674,60829,84980,9272,75085,98241,4402,34137,53372
53295,0,0,0,0,0,0,0,0,0
53235,4854,48879,67776,2190,82901,97420,2664,30816,42222
53233,4212,16134,25522,764,20189,32157,3448,14443,23304
53228,6606,65887,76002,3558,92232,100420,3048,38683,45036
53227,10609,53682,66179,5334,71846,83159,5275,40039,45684
53226,8343,74851,97540,4456,109028,132501,3887,49063,56908
53225,9853,45232,55643,6080,50910,63244,3773,32690,37655
53224,7432,59198,70320,5009,61035,76761,2423,43388,51314
53223,11925,51156,62602,6911,63912,76144,5014,32099,41977
53222,11149,63004,72262,6640,75802,84291,4509,41576,51617
53221,16118,52327,68176,9634,64722,80672,6484,35122,46006
53220,11589,59499,77160,6597,74958,90568,4992,41245,51825
53219,14745,60232,67261,8137,72917,79980,6608,36852,47077
53218,14040,37737,50201,9258,41739,55078,4782,24365,36024
53217,11918,106911,157364,7701,138438,198320,4217,60875,80440
53216,12558,36171,48263,6977,45138,58849,5581,25078,31191
53215,18865,41810,54143,13284,45194,59071,5581,25783,33544
53214,16106,49994,59940,7525,63722,75995,8581,36994,43643
53213,11626,83143,107162,6673,107301,138256,4953,46847,63565
53212,13314,39152,56240,5702,42139,67793,7612,33842,45824
53211,14440,64532,102175,6156,120377,163938,8284,38115,54164
53210,9348,36378,63162,5963,42056,56582,3385,22553,71071
53209,19683,37288,52783,10626,45796,65525,9057,22354,34380
53208,11621,36436,54100,5869,50955,64480,5752,27131,40864
53207,16471,66706,77172,8283,79967,90983,8188,54181,61256
53206,8543,29260,42126,5262,35814,49994,3281,17029,24939
53205,3304,20597,39073,1838,24464,39185,1466,13606,34887
53204,13459,33625,47970,7447,34174,49407,6012,27392,42236
53203,1051,73208,89865,205,101563,118801,846,65375,82854
53202,15818,53812,82714,2768,127917,184818,13050,44986,60797
53195,65,64464,61020,37,85074,67824,28,63250,52025
53192,11,0,0,0,0,0,11,0,0
53191,1288,58125,90832,819,95139,115287,469,34125,44933
53190,6680,48237,66783,3277,73693,90111,3403,27026,42609
53189,9911,97867,115591,7672,109808,132261,2239,43481,54722
53188,14135,73397,93160,9294,91322,111634,4841,38815,53492
53186,14681,57949,74785,8682,77401,90409,5999,38516,48362
53185,7599,89930,104894,5655,108131,120481,1944,46696,55987
53184,1620,63306,87820,1075,78750,103924,545,31838,48207
53183,1014,103571,163268,809,109635,182048,205,59583,85664
53182,3278,77500,97389,2358,87155,103481,920,58603,68791
53181,2781,71761,99889,1979,86927,110271,802,45761,70387
53179,2660,79960,86809,1941,94005,102543,719,23946,34852
53178,1068,72386,80433,700,80893,90136,368,45227,59522
53177,2518,71389,84183,1540,87266,94827,978,52355,63972
53172,8461,57286,68982,5202,66909,78040,3259,39709,50364
53170,934,68796,111100,604,86500,120796,330,62766,90768
53168,3541,81250,101560,2496,103019,116452,1045,52415,59934
53167,276,34052,50400,182,51525,65316,94,0,21517
53158,6340,103069,113571,4350,123441,131631,1990,62778,70312
53156,1362,71771,82743,968,91402,95740,394,35469,45811
53154,15348,75657,93285,9523,95464,113431,5825,54342,56556
53153,907,110417,114194,725,125340,122471,182,44545,76439
53151,13586,85429,108192,9308,105698,126571,4278,49425,64361
53150,9921,95365,112560,7417,114421,129243,2504,44092,61503
53149,7380,101130,119597,5700,116667,136226,1680,50372,59265
53147,7397,72352,95326,4829,86015,115401,2568,40847,55450
53146,2936,86622,125833,2241,100607,145782,695,42639,58156
53144,9948,62048,83744,6317,79269,100038,3631,39883,50742
53143,8475,50839,67236,5256,60300,74777,3219,33811,48095
53142,12962,70634,87657,9023,87120,99884,3939,37545,51833
53140,12083,48041,60293,6378,59480,72556,5705,32009,44283
53139,1016,75769,91952,679,98878,108017,337,42621,46795
53137,641,89554,97480,514,101389,107671,127,0,54268
53132,13514,82125,104599,9192,108183,124223,4322,44269,58890
53130,3219,72819,88526,2022,96105,106931,1197,37708,54788
53129,5727,74731,94593,3507,98427,120187,2220,39875,50152
53128,3136,66900,80889,2544,68841,85628,592,31515,50747
53126,2728,93043,107358,2163,103218,119484,565,52841,60567
53125,778,84048,122684,555,93750,145360,223,46042,64439
53122,2190,112500,169015,1658,131655,195844,532,35893,77362
53121,7782,74320,87681,5211,86406,101965,2571,43838,55000
53120,4115,80506,97476,2856,94717,110044,1259,54727,64670
53119,2258,89444,101370,1771,102868,113280,487,31827,55597
53118,2824,90481,106874,1873,106406,122295,951,60320,72932
53115,6508,61633,72859,4341,72306,86930,2167,30264,40184
53114,927,72083,83804,689,82292,91611,238,47419,53238
53110,7875,63280,72967,4703,71149,81273,3172,40786,55318
53108,1367,66902,87877,1049,78058,100540,318,36409,46104
53105,11935,74966,93973,8379,90366,109850,3556,39246,51559
53104,2117,87617,104683,1582,96892,115041,535,47250,73274
53103,1531,92563,119914,978,118750,151499,553,45855,63611
53098,4535,59571,75994,3127,76034,89705,1408,32222,39282
53097,1975,150694,198612,1716,158409,213285,259,56023,96898
53095,11994,69604,90998,7527,93206,113747,4467,36686,51039
53094,7512,57500,70507,4942,70648,80250,2570,38772,47996
53093,750,85556,89857,575,87377,98938,175,46250,57417
53092,8448,108602,159972,5901,134495,188355,2547,45982,81551
53091,839,65685,71502,548,82727,82636,291,37569,49299
53090,8901,76635,84891,6047,89888,99373,2854,37277,48395
53089,7346,94383,111919,5269,116250,131301,2077,43456,59853
53088,181,68125,65535,92,96000,83946,89,52583,45527
53086,3444,83262,100035,2435,92375,114799,1009,44075,63886
53085,5213,59796,75412,3348,74444,93200,1865,36849,41932
53083,8446,71242,86451,5950,80417,98446,2496,43348,53608
53081,17852,51611,62899,9463,65735,79251,8389,33558,42762
53080,2320,63426,80435,1494,70946,96713,826,34077,46286
53079,576,78056,91189,436,87000,103700,140,39250,48303
53078,693,82829,90740,456,90882,103152,237,64688,64075
53076,1298,101844,125487,1154,105926,132916,144,49412,55026
53075,1293,71494,83534,954,81250,92451,339,47891,52106
53074,5410,69360,83159,3452,83435,98857,1958,41413,50087
53073,6197,69741,81144,4159,83040,97193,2038,34470,45412
53072,11078,88188,132721,6863,123383,169824,4215,47775,70656
53070,1935,67319,85029,1412,79565,97162,523,43906,49780
53069,347,109577,103197,271,109496,109280,76,0,39114
53066,13604,101446,128036,9474,118678,143780,4130,52742,89207
53065,945,88250,94130,688,98214,104646,257,47404,63342
53063,627,69750,90539,401,94018,111769,226,48214,51180
53061,2176,66759,71532,1441,78980,87157,735,30845,40186
53059,735,75149,88980,567,82625,100016,168,37813,44617
53058,1423,89917,139389,974,121316,169886,449,56458,68706
53057,646,73750,90626,474,91875,102415,172,46042,55565
53051,15434,86572,116290,10315,111273,144128,5119,42554,55004
53050,2702,60773,69953,1717,73750,81307,985,42324,48192
53049,1065,76750,86617,755,95114,103163,310,50116,45612
53048,1345,62679,66655,850,73711,75707,495,37350,45650
53047,13,150750,351938,8,150500,144375,5,0,0
53046,507,67332,84397,299,79044,101840,208,52206,58060
53045,8669,104745,152039,6008,134958,191058,2661,44728,62421
53044,841,95250,151282,627,105694,171105,214,41875,92151
53042,2775,64691,78336,1788,84079,95198,987,42379,46304
53040,3329,80083,96564,2420,92619,102148,909,48869,76769
53039,1632,69571,79388,1107,81477,89794,525,46971,54417
53038,1723,82750,92669,1182,98971,110339,541,35573,49954
53037,3946,85417,98568,2589,95358,111693,1357,53250,69884
53036,1076,81053,94169,806,90962,101764,270,70769,67183
53035,890,70900,82785,625,82159,91434,265,43125,56767
53034,689,65292,74801,489,71458,84052,200,43500,49352
53033,2219,95281,129776,1708,105625,148572,511,51063,63689
53032,2118,47325,68726,1183,62132,81709,935,27111,48830
53031,0,0,0,0,0,0,0,0,0
53029,8057,100496,140273,6162,113667,155855,1895,46440,86361
53027,9082,71949,86837,6429,88245,100182,2653,39893,49754
53024,7727,79785,101427,5098,99739,124294,2629,45554,53960
53023,567,67708,90757,412,84500,108323,155,40884,42892
53022,7630,88852,113314,5409,107244,128948,2221,49250,71872
53021,1829,88042,106520,1330,98448,117182,499,65020,76446
53020,1565,73892,91816,1243,82434,100854,322,36357,51961
53019,742,75000,82272,571,83750,90473,171,39338,51131
53018,3198,103646,138212,2262,123929,142318,936,46667,119690
53017,1977,137930,162755,1821,139070,171263,156,53333,58285
53016,133,65250,64272,91,70938,71390,42,38125,42769
53015,1123,70125,79880,788,78472,86065,335,44531,62202
53014,3147,63045,74844,2069,81026,91709,1078,32143,40785
53013,1349,79219,92795,913,92981,109068,436,39211,57385
53012,7525,90700,117740,5332,115644,146741,2193,32442,46220
53011,901,74375,87523,585,86940,101977,316,42000,57726
53010,3442,92838,94106,2718,109545,102522,724,40764,57423
53007,912,45250,60651,389,95875,91777,523,28656,35767
53006,704,74833,83308,513,79861,90483,191,50938,58197
53005,7701,106484,136259,5835,120893,154282,1866,68750,78396
53004,1348,81583,92893,1024,93571,103334,324,46071,53270
53003,50,0,70458,31,106563,104142,19,0,15495
53002,955,82531,82529,648,94375,98215,307,47135,47172
53001,826,75114,92682,517,86625,109354,309,61050,63760
52807,6535,65984,91932,3977,94052,116871,2558,44398,50823
52806,10804,55929,67083,6673,68517,80191,4131,33355,43105
52804,10782,52395,64723,6437,61669,74958,4345,34580,44925
52803,8593,55010,80916,4817,75503,98653,3776,36843,57020
52802,3853,42250,57209,2265,50299,64305,1588,31092,44033
52801,759,24067,36112,79,0,82853,680,23426,30078
52778,1603,62388,95395,1097,74258,99238,506,40703,83623
52777,526,42955,56802,364,48333,63685,162,35417,40210
52776,1619,68022,82486,1184,80114,95872,435,40875,42389
52774,48,56250,67252,25,81250,91308,23,37250,40196
52773,1097,70518,82382,699,83625,91631,398,35208,59360
52772,2156,70471,76126,1481,81179,85801,675,38828,50461
52769,251,79554,87622,173,79732,93083,78,51250,65906
52768,554,76607,85527,411,82574,92880,143,38542,57573
52767,29,0,0,10,0,0,19,0,0
52766,370,58333,66503,178,74904,82925,192,51706,51117
52765,181,95260,94001,101,118250,121841,80,51429,58841
52761,11816,58280,75384,8041,68958,84525,3775,37917,49168
52760,231,54769,69601,111,83646,102518,120,35875,39153
52758,112,81875,89104,76,73929,83246,36,101500,89250
52757,97,56042,61445,67,64250,65330,30,43750,44703
52756,651,103239,130735,512,125156,154266,139,30917,42353
52755,830,79048,85445,653,91420,95040,177,37917,46833
52754,559,63150,99240,387,64250,113692,172,53077,56711
52753,1861,86490,121435,1482,99891,138477,379,44011,54013
52752,195,54453,63955,133,60179,74856,62,32000,35756
52751,333,63750,81514,204,80000,99773,129,40945,50810
52750,197,72321,80015,121,80938,94074,76,70536,57633
52749,341,89464,98273,293,82463,101965,48,37500,50210
52748,3670,80200,104582,2922,88697,115859,748,54756,58985
52747,801,68063,79570,525,90950,99823,276,31563,39250
52746,413,71875,88480,370,66250,88656,43,45592,40914
52745,235,66250,78234,119,94219,100860,116,28750,52522
52742,2828,63938,87724,1966,81953,107358,862,28839,40651
52739,229,49750,56157,154,63750,60518,75,36131,39883
52738,1412,57545,69758,945,73350,86013,467,28578,33314
52737,146,65395,65010,104,66711,75218,42,31154,39733
52732,11403,47314,63176,6671,65172,77628,4732,30192,39857
52731,298,63214,68099,196,68750,77031,102,42143,50336
52730,2206,53160,60790,1355,71291,77539,851,30665,32982
52729,362,66912,77039,254,83333,94676,108,24844,35256
52728,449,73004,74592,230,80294,82030,219,65917,60375
52727,119,50781,74525,75,0,97960,44,35000,34580
52726,2255,87267,96914,1619,108482,113424,636,41154,53494
52722,14904,86202,112335,10010,104314,134289,4894,45186,64751
52721,326,79500,89770,264,89444,99289,62,36250,47568
52720,332,73571,91755,196,130250,121178,136,45962,48788
52701,62,53125,47487,60,53750,48552,2,0,0
52660,71,32371,41490,63,32981,44092,8,0,0
52659,595,43098,56798,339,68194,77359,256,25694,29005
52658,391,61302,69177,302,63672,76150,89,29063,36193
52657,19,68125,69553,18,68750,70422,1,0,0
52656,937,67321,91947,580,83250,107303,357,42083,66998
52655,1638,50938,70893,971,68710,82973,667,31384,51337
52654,612,70061,76543,446,76000,77215,166,35395,66773
52653,1313,69410,79305,923,79219,92670,390,36400,42821
52651,240,34107,48640,143,63977,63601,97,0,25707
52650,259,75625,78770,169,76991,91524,90,53088,54461
52649,373,55417,83130,288,65938,95768,85,27917,36791
52647,71,68438,68054,44,86250,82125,27,40625,45119
52646,147,63977,56215,105,75114,61275,42,0,39481
52645,1379,56875,62492,925,71250,72539,454,31625,39185
52644,162,62500,67657,126,64028,73867,36,44375,43133
52641,4511,54489,70410,3033,71801,82822,1478,29248,38861
52640,568,77667,90145,397,100670,108727,171,36250,46622
52639,763,61676,71101,574,62564,77555,189,45074,47281
52638,217,68393,75322,180,72500,78626,37,47083,49541
52637,1103,63224,76210,729,82321,94601,374,29353,36757
52635,430,55625,64239,291,63125,66335,139,43042,59240
52632,5455,45108,57718,3435,57378,69669,2020,24925,33877
52630,147,43802,53196,83,54063,62961,64,33889,35634
52627,5167,50286,64480,3207,65076,77628,1960,32885,39783
52626,541,42750,49200,319,55774,58011,222,29722,35833
52625,981,62009,74914,750,74875,87147,231,23859,33657
52624,212,127636,102840,175,128139,111592,37,73203,61446
52623,727,75598,86156,526,99091,104453,201,29188,35622
52621,306,85167,98745,259,92375,108091,47,33750,33591
52620,344,58929,69234,229,64716,81043,115,29659,42847
52619,307,65875,66207,263,66054,68683,44,0,50857
52601,12561,49098,70073,7686,62262,82592,4875,32469,47462
52595,161,47292,53628,101,56563,62291,60,21667,31335
52594,152,74063,78870,126,80938,74210,26,18750,101062
52593,67,76458,115440,51,85179,133259,16,61250,53463
52591,1303,52969,79551,832,73158,95022,471,26488,50085
52590,399,41098,44316,255,47438,51998,144,30556,29554
52588,8,0,0,8,0,0,0,0,0
52586,246,62813,63002,187,70156,64827,59,34750,38781
52585,355,63194,68609,243,78523,85500,112,31250,30969
52584,156,67273,70202,132,72500,74926,24,48333,43371
52583,150,56563,73932,108,73500,89612,42,19375,30517
52581,127,45250,68503,87,56250,84613,40,26711,33465
52580,349,43875,55651,236,59138,64590,113,33708,35236
52577,6074,55173,67219,3860,75040,83922,2214,22654,35356
52576,204,64318,69063,140,76500,86378,64,21932,31188
52574,239,46625,54578,145,55250,62224,94,30000,40620
52573,60,0,154427,60,0,154427,0,0,0
52572,427,51250,56452,258,54583,61592,169,32132,46449
52571,575,68375,88429,424,83333,103821,151,38523,43544
52570,358,61000,105633,264,61250,119169,94,0,66687
52569,349,49583,56753,206,56591,69353,143,31518,38601
52567,300,60242,64843,193,62434,73164,107,43073,47341
52566,85,67750,69879,75,78125,74652,10,41250,34090
52565,786,48263,61693,513,55573,78164,273,21645,30360
52563,634,66333,76484,438,72667,82928,196,56250,58292
52561,366,47000,59667,248,48000,60440,118,37500,41737
52560,100,0,78055,84,0,85604,16,16364,27250
52557,0,0,0,0,0,0,0,0,0
52556,5079,46209,72461,2692,61569,92062,2387,28865,49224
52555,123,36875,47325,78,50909,53133,45,33036,36538
52554,544,45472,49726,310,56500,60707,234,32115,32012
52553,660,53478,60345,522,54815,65341,138,26250,33307
52552,387,52083,65404,284,85096,77278,103,21198,32661
52551,224,68929,68971,165,81058,84335,59,21083,26007
52550,278,39444,47741,104,73214,70688,174,31000,33761
52549,241,44732,59104,186,50208,58562,55,23750,54547
52548,39,53125,52921,28,51250,46604,11,54375,63218
52544,3353,35820,54434,2006,39603,60436,1347,24250,43151
52543,147,63438,80459,147,63438,80459,0,0,0
52542,133,42708,55559,95,44792,66156,38,21071,28637
52540,524,52500,60911,346,57400,73514,178,0,31556
52537,2574,69196,83395,1907,81993,97836,667,29441,39452
52536,411,47545,59624,283,68906,73533,128,27875,28871
52535,409,52557,63900,239,66193,70080,170,47868,51882
52534,130,38214,64042,81,82917,90143,49,14191,15741
52533,493,51563,64085,266,59792,79529,227,24931,42396
52531,2394,57206,73456,1422,80083,85694,972,26818,53810
52530,450,52143,65507,305,78958,82332,145,24805,30117
52501,12159,45113,60634,7778,57350,71646,4381,30699,38383
52411,2985,149653,204241,2647,164671,220441,338,66071,73416
52405,11079,61198,74034,6715,82736,90283,4364,39418,45736
52404,16811,56898,71519,9439,68909,85773,7372,40688,50455
52403,9772,65759,97254,5914,94731,121323,3858,39189,56558
52402,17329,63635,79080,9933,78765,93573,7396,44504,58025
52401,1143,39361,57661,237,63125,69301,906,34944,53317
52362,411,59583,67184,311,70694,70841,100,31667,54579
52361,1860,60200,81239,1193,74429,99977,667,42005,45607
52359,81,58854,74422,67,59028,79851,14,47500,47379
52358,1476,68194,84221,969,90598,98918,507,37083,53353
52356,1054,51429,68145,677,74034,80233,377,39099,42736
52355,122,58056,66741,74,61250,79639,48,50833,46856
52354,156,60938,69476,120,64375,73520,36,53929,55997
52353,3722,60466,68538,2622,66676,77136,1100,33984,38839
52352,717,71594,77407,531,96635,91373,186,31742,34556
52351,495,106250,115809,384,114643,130288,111,60938,59876
52349,3232,51650,68042,2061,70995,87567,1171,27416,31995
52348,38,62500,66221,20,90000,91080,18,25625,38594
52347,523,66719,84233,396,75000,94879,127,31875,41400
52346,482,81250,96702,394,76563,97309,88,53000,63143
52345,515,91875,93418,380,101250,105339,135,62083,58689
52342,1324,47262,60673,828,64853,74548,496,30750,36055
52341,494,91651,112474,387,91439,106515,107,0,118111
52340,1571,77969,79611,1043,89009,94884,528,31364,46908
52339,1350,46250,55844,882,57683,66517,468,25833,32430
52338,1303,108008,147601,1079,125893,165432,224,61250,61151
52337,331,62750,71131,198,65000,74164,133,41375,46891
52336,1131,77569,75500,764,76250,80731,367,66544,61516
52335,312,37115,56628,165,65625,78355,147,25625,29173
52334,94,88750,76189,94,88750,76189,0,0,0
52333,2629,98647,110904,2025,117702,127780,604,44375,51431
52332,800,82333,79135,618,96071,88747,182,34464,43965
52330,360,82500,88876,262,92917,113124,98,0,24051
52329,315,75243,98856,258,75714,106404,57,49375,57160
52328,1169,129875,158554,1006,137083,170738,163,68542,81902
52327,1367,67917,82647,1103,69188,91232,264,33571,43638
52326,258,67917,75104,193,90197,85769,65,36250,41463
52325,268,52197,81721,196,56607,91013,72,37273,54199
52324,617,105625,116379,474,111667,123452,143,75750,88155
52323,382,50278,60149,235,67250,75192,147,33311,34965
52322,851,69688,83039,475,103563,108746,376,37500,44672
52321,155,37109,48330,115,43750,52768,40,23333,32933
52320,503,55677,63251,359,73417,74988,144,26071,29769
52318,419,71528,80884,296,77384,94259,123,38438,48058
52317,7730,89233,108386,5170,104906,125469,2560,62802,70580
52316,686,55500,63799,390,66087,75322,296,32262,43212
52315,495,61576,76443,336,74167,90650,159,41250,40147
52314,1786,77778,95568,1216,94511,120342,570,28824,39408
52313,103,75774,82577,81,76985,92543,22,53125,41255
52312,27,34375,37437,11,51875,56882,16,23750,22363
52310,2698,56748,82065,1655,83688,105630,1043,35461,43708
52309,303,81979,84280,224,89833,94879,79,0,52900
52308,84,80250,70582,37,80875,68946,47,0,71328
52307,30,0,81653,21,0,0,9,0,0
52306,618,63889,66887,434,70909,79042,184,26419,30555
52305,247,76250,78280,163,81563,83677,84,75398,61923
52302,16422,74630,93233,10783,95683,113584,5639,39602,51840
52301,1476,59369,72906,948,76768,89943,528,36250,41340
52257,84,75208,76240,70,76667,90040,14,25000,7243
52255,586,61250,73873,368,73611,85977,218,33958,51894
52254,385,53594,64393,234,68929,78589,151,36319,41913
52253,1128,77108,86504,793,101691,103396,335,31131,41759
52251,257,76089,79642,168,77500,94030,89,0,50754
52249,385,63068,66450,276,67955,70573,109,34861,47847
52248,737,66188,85638,481,88365,103849,256,37361,47438
52247,1859,60609,72922,1351,69957,82024,508,33293,42095
52246,10346,47888,83185,4648,92222,131639,5698,28341,42775
52245,9916,62847,83813,4708,97794,117086,5208,38713,53033
52242,0,0,0,0,0,0,0,0,0
52241,8690,68038,101320,4977,101279,123269,3713,35678,69397
52240,15298,45785,68562,6942,84725,105705,8356,27277,35917
52237,547,71316,72351,479,71781,77502,68,20000,33596
52236,259,58185,117212,184,0,149418,75,40170,38201
52235,366,61167,66411,231,69087,71719,135,43125,49481
52233,2864,48202,66915,1755,64913,80423,1109,36061,41791
52232,120,71618,64338,92,80345,74529,28,23750,30850
52231,129,63125,67081,64,102788,91563,65,44107,42977
52229,286,75700,77258,222,77300,84318,64,0,51667
52228,1282,107286,161355,1040,124423,182834,242,63750,67017
52227,1066,91389,98620,763,108229,110408,303,43664,66840
52225,146,56071,59461,97,59625,69052,49,50625,39822
52224,762,61250,76559,477,72426,87430,285,24205,55829
52223,409,65391,70172,236,76400,79972,173,50469,52943
52222,261,51518,60208,155,54844,74531,106,30417,35376
52221,85,68750,66049,61,65750,71472,24,0,42871
52220,108,58438,67101,80,58984,75823,28,51042,42182
52219,75,55625,74911,49,65417,90002,26,33750,41754
52218,777,69464,81480,556,82051,97098,221,28285,34181
52217,232,52813,72916,119,97639,105131,113,0,38920
52216,612,57500,66240,364,68636,82988,248,41250,40618
52215,407,83750,84818,318,100473,92506,89,39107,50096
52214,1365,74250,96321,1025,82083,109461,340,39167,54603
52213,1465,75139,84641,1128,86645,94280,337,37261,42842
52212,133,71094,66718,107,90590,80051,26,11304,11850
52211,1077,56936,80061,697,72886,94901,380,39722,51042
52210,288,60714,69432,198,77500,80732,90,40000,42954
52209,440,64773,71952,325,76528,78267,115,32443,48788
52208,1299,56705,65301,851,72469,79327,448,24688,35170
52207,171,39479,89493,102,93750,134015,69,16898,20472
52206,915,95750,108581,766,100769,116816,149,54583,58964
52205,3272,53942,66995,2019,74058,79098,1253,34803,44334
52203,947,84942,109163,729,99338,122809,218,46429,61253
52202,400,81429,86866,323,82054,92041,77,39659,49565
52201,591,87679,92783,455,93185,101403,136,48182,58748
52175,1531,52835,68228,867,71118,82486,664,31940,48602
52172,2634,52597,62684,1463,76678,81587,1171,28937,37472
52171,426,66667,80669,283,84583,92867,143,41750,53552
52170,266,56550,69870,164,68833,79092,102,55852,53973
52169,129,63438,76634,79,70625,72589,50,37500,81456
52168,118,0,33890,38,78333,74387,80,8690,14653
52166,42,48125,56569,30,49688,67250,12,0,28408
52165,418,77500,71992,273,91069,85192,145,35938,46890
52164,127,61250,82563,98,68750,93736,29,28393,40872
52163,149,48984,55961,96,66500,70593,53,30625,28600
52162,1193,62426,71394,870,65128,74062,323,40417,61132
52161,606,70385,92648,413,77917,112530,193,39886,49669
52160,418,71011,97085,315,73036,111144,103,34583,53586
52159,1101,61193,79206,679,73750,93813,422,37105,50875
52158,131,37917,46160,53,39583,55526,78,29286,38513
52157,881,41942,64285,540,65833,75870,341,27688,43578
52156,195,68750,111452,145,90104,137997,50,21944,31784
52155,596,61786,81805,435,64010,84174,161,43438,67299
52154,358,66111,66748,233,81875,82002,125,23594,38314
52151,939,49663,59005,500,62917,74966,439,35768,40206
52147,434,56750,68618,267,62708,79039,167,34740,51076
52146,390,60000,65035,293,61042,71863,97,38274,38928
52144,457,70398,86028,330,81458,101096,127,32083,46636
52142,648,39417,71872,322,56250,76794,326,23088,65511
52141,572,56121,71936,361,75344,84506,211,33984,49176
52140,235,46467,63723,127,84875,86672,108,0,36738
52136,2341,54229,66587,1566,65426,74785,775,38310,46114
52135,291,60179,61895,157,69904,76597,134,30833,44557
52134,111,61875,76920,87,68958,86592,24,32500,37250
52133,280,56837,64414,241,55995,65600,39,0,32587
52132,887,58598,72813,591,69141,81560,296,40565,53769
52101,5109,61789,78304,3143,88604,100458,1966,32724,41788
52079,313,51406,75788,182,89375,107708,131,24018,27424
52078,223,67250,72422,182,71786,77474,41,32813,47354
52077,149,59375,68470,108,93750,82394,41,25417,31007
52076,955,54750,64772,554,69583,81291,401,39050,39521
52074,131,88313,82211,121,88563,85998,10,0,13880
52073,571,77448,88923,435,92330,104545,136,29643,35476
52072,120,68382,70574,86,71429,79530,34,40750,45521
52070,465,51771,59038,326,57900,64853,139,35781,44358
52069,583,67264,68322,438,69643,71412,145,65845,56223
52068,1650,102656,134224,1362,104316,146928,288,51765,70599
52066,36,43750,54572,23,87917,69413,13,23438,28308
52065,362,60625,69760,270,77917,80594,92,31739,36290
52064,303,52422,75000,229,71250,88921,74,25750,30470
52060,3581,51144,65371,2174,69148,78457,1407,30663,42031
52057,3305,60836,91398,2176,73333,117013,1129,35662,41571
52054,299,89063,95024,227,103854,108913,72,0,49983
52053,358,74773,79542,274,92500,92643,84,30000,36096
52052,1414,49455,69695,864,73250,91290,550,25109,34443
52050,209,70625,86031,143,88125,101207,66,52500,50461
52049,551,69740,77152,364,84643,91643,187,37109,47236
52048,137,57188,59831,88,59167,64647,49,41875,46537
52047,275,56354,68899,211,58750,73100,64,39583,50575
52046,952,76719,96503,770,83333,107305,182,31429,44410
52045,1009,60956,71034,680,85750,83482,329,37212,44286
52044,81,64708,78906,78,64000,64806,3,0,0
52043,928,59500,61652,530,76923,73015,398,32935,40345
52042,619,63164,72044,371,82663,89395,248,31250,46089
52041,701,73024,82414,459,84306,95200,242,43963,49784
52040,2418,64632,71686,1635,78149,85448,783,36327,40153
52039,350,99722,97737,273,102868,110259,77,0,53013
52038,182,83077,102734,146,83846,83316,36,0,176833
52037,406,65682,79685,297,81719,94750,109,31528,35517
52035,421,45250,62042,318,69000,71627,103,30298,28927
52033,1272,68000,81315,818,81471,99195,454,29231,47516
52032,632,71121,72696,483,77216,78668,149,40694,53336
52031,2163,68886,89418,1561,91518,106451,602,37500,44360
52030,185,52902,58124,134,53611,60197,51,38750,42586
52003,5241,81383,108555,3612,101627,130330,1629,45504,55798
52002,6670,77120,101093,4807,90120,119881,1863,33125,50796
52001,17642,51625,69276,10117,69323,88845,7525,32867,40265
51656,20,53750,62620,13,65625,69877,7,41750,49143
51654,163,72813,65482,110,51250,60318,53,0,64913
51653,588,70375,83107,430,84091,93738,158,48448,50341
51652,634,56667,65471,384,71875,84397,250,30556,34244
51650,134,47500,64942,62,56250,72603,72,37500,58344
51649,134,76316,82374,117,75592,85877,17,27917,36447
51648,91,78224,91464,74,79107,101730,17,45750,46776
51647,57,0,75075,30,0,107803,27,12232,16807
51646,362,63750,70840,232,91591,91166,130,30833,32137
51645,111,61131,103991,60,125385,158845,51,0,39457
51640,759,46964,62368,444,62500,82813,315,27109,32520
51639,360,59688,72118,213,78750,89734,147,39609,45171
51638,598,51071,69105,274,67750,92030,324,39167,48742
51637,114,39167,46537,56,38750,51121,58,50000,41972
51636,211,59375,60643,146,66875,68785,65,0,40097
51632,2659,52512,64358,1622,64861,79120,1037,27027,39461
51631,132,43167,104176,100,46667,128459,32,23750,25556
51630,59,73750,63097,49,58125,60655,10,0,0
51601,2522,46466,59456,1589,61653,69326,933,30951,41369
51579,900,62500,87652,664,74545,101846,236,31591,44237
51578,40,91875,118463,29,0,135652,11,80625,73145
51577,530,51250,64637,306,76607,84531,224,26429,35345
51576,806,94464,109538,650,108214,121609,156,43173,55972
51575,547,87880,99874,443,94844,105282,104,33750,74028
51573,451,79375,84479,350,87750,96268,101,35625,40664
51572,205,54688,60367,116,67500,76594,89,25250,38757
51571,220,79773,96833,159,79102,94808,61,78750,94407
51570,432,48333,67716,256,65714,83345,176,35789,41164
51566,2894,54455,82301,1799,61202,73719,1095,27099,89739
51565,260,86181,88381,188,86319,99449,72,0,59218
51564,182,49773,56338,93,61458,63840,89,38542,45290
51563,299,57107,71808,260,57429,74312,39,25875,47351
51562,169,52750,75587,124,62500,89260,45,28750,37327
51561,439,65938,99848,284,64868,118190,155,58906,64090
51560,781,61250,72643,531,70733,80942,250,15769,40767
51559,659,71313,81990,496,84583,95514,163,40139,37963
51558,239,53750,67606,171,70795,79316,68,31250,37497
51557,397,72292,84294,284,89167,97236,113,37375,50995
51556,197,76250,88168,152,103125,102886,45,28393,32220
51555,1998,66186,73998,1303,78792,86477,695,40880,47381
51554,61,66181,67548,43,66181,72588,18,0,0
51553,380,69219,93786,281,90313,110885,99,29013,41634
51552,131,51875,55220,81,0,54960,50,0,55640
51551,661,77216,115362,428,96250,148991,233,44306,51912
51550,65,41250,56500,45,55625,65644,20,28750,29960
51549,211,76458,94932,155,108750,107823,56,33500,56195
51548,185,85208,103541,159,86736,112524,26,31719,40546
51546,1155,85444,101196,894,91234,116796,261,38958,42496
51545,135,32708,44548,73,48438,61334,62,16000,20873
51544,322,43750,64384,218,53333,76094,104,30000,39838
51543,212,45227,53651,117,45938,59368,95,30250,39576
51542,392,97115,142661,344,105804,154563,48,58676,57367
51541,140,55000,56720,92,62083,65378,48,24605,32773
51540,140,57500,69651,102,96125,85915,38,25385,25176
51537,2916,60083,78834,1765,79023,96737,1151,33002,47654
51536,183,56250,69807,122,76250,90075,61,24375,29220
51535,746,66563,72955,516,73429,81794,230,32391,49656
51534,3341,79112,91906,2297,96196,106230,1044,45071,55923
51533,412,64063,77074,289,79063,88763,123,44375,49576
51532,288,58929,68239,209,68472,71880,79,45625,43386
51531,284,57679,71399,180,69375,83064,104,43750,48771
51530,286,48553,91466,189,63375,120183,97,26741,35313
51529,855,49250,60119,543,64489,73944,312,30227,35371
51528,342,48438,73620,208,69773,103348,134,25625,26134
51527,248,57500,73846,199,54972,78590,49,36875,32506
51526,739,75757,94567,500,84632,101633,239,53368,77725
51525,490,65156,80270,311,90987,98278,179,42083,47946
51523,169,77396,86637,126,91250,102605,43,30625,36081
51521,817,53813,69384,467,74191,83722,350,31250,46466
51520,103,51705,56776,95,51856,58696,8,25000,30550
51510,1342,52163,76678,956,71375,85221,386,34091,53206
51503,14624,66528,83051,9243,86751,101111,5381,33610,46125
51501,14108,50115,60661,8577,59552,69496,5531,32078,41104
51467,253,58750,76107,194,71389,84977,59,35250,44095
51466,490,58636,79083,316,83125,104400,174,22500,31991
51465,302,55833,71258,209,78250,81728,93,39375,40569
51463,237,57750,71712,161,58917,77397,76,47000,59667
51462,472,55625,68117,324,61818,77125,148,29792,44238
51461,541,61477,78661,369,66420,85095,172,47500,59969
51459,36,63750,77272,26,0,81565,10,21667,28220
51458,535,51650,73459,356,63167,90799,179,34028,38826
51455,1014,66296,89221,576,89400,113520,438,48554,55066
51454,539,70282,81940,390,74167,87319,149,34886,66413
51453,309,58750,76470,204,65000,77168,105,33750,43986
51451,48,47500,62988,35,77917,75486,13,38250,29338
51450,688,65500,80410,448,87188,97029,240,21731,47743
51449,887,59135,72949,642,74545,82930,245,25903,42142
51448,240,43958,60324,170,55000,68681,70,33750,40027
51447,102,96324,87560,79,97792,94751,23,82604,60957
51446,235,70313,65223,174,73269,68193,61,46250,54477
51445,1145,59926,84140,689,78697,108755,456,39167,44666
51444,103,48750,65305,60,68500,72138,43,41696,55770
51443,568,68971,73455,369,82750,88208,199,31875,45117
51442,3301,54169,85953,2435,63162,87956,866,27847,76696
51441,181,38523,48498,103,48125,59906,78,23750,32513
51440,136,54583,64189,89,79063,75178,47,37813,37768
51439,388,50078,55498,237,51116,59178,151,41927,47024
51436,414,51429,72748,271,81750,92485,143,31412,35262
51433,234,46250,52269,198,53077,50198,36,26875,37778
51431,163,48194,63075,111,70750,67220,52,35833,51213
51430,416,63625,76088,366,66875,75981,50,43750,45246
51401,5188,59082,73967,3115,82190,89938,2073,29611,47072
51366,136,61250,86182,104,96667,102881,32,25000,31909
51365,141,49250,68843,87,67083,85970,54,26875,29780
51364,351,54034,81381,219,65417,107836,132,29667,34436
51363,92,39444,52098,77,38594,46316,15,43750,49180
51360,4311,61292,79301,2378,76404,95904,1933,44032,53403
51358,543,56823,65038,342,68421,78654,201,32404,39890
51357,323,54345,70138,202,71071,85821,121,45179,39968
51355,513,54073,94300,256,94167,150670,257,32917,38151
51354,534,60500,62146,345,67853,72496,189,32639,43254
51351,2038,59970,86166,1415,66875,95724,623,36632,60283
51350,199,55268,56528,105,63125,65429,94,42100,41316
51347,673,66938,80359,395,98393,97650,278,42000,54267
51346,907,44539,58707,561,64659,75246,346,22167,27372
51345,205,44899,82538,125,82250,106147,80,43729,45320
51343,86,117955,108034,74,119318,116608,12,0,50567
51342,588,66429,70602,395,87031,86454,193,31354,34345
51341,14,46250,53671,8,63750,76550,6,22500,23150
51338,415,59609,67990,288,77000,79409,127,33281,40809
51334,2871,59192,71656,1663,71694,85635,1208,35550,50935
51333,194,51944,65254,113,83438,78765,81,0,39023
51331,581,64625,78199,313,86161,88632,268,50365,65935
51301,5648,47989,62451,3253,68348,80620,2395,26417,37133
51250,2981,79415,87367,2183,89700,103766,798,26292,41014
51249,1407,63090,73446,827,68250,81109,580,50833,58541
51248,738,55385,59719,426,66875,72324,312,32500,38938
51247,1839,69090,88741,1245,79861,101324,594,42578,60319
51246,1406,64875,76530,1014,78000,91324,392,33462,38260
51245,564,57000,73650,385,70938,87797,179,37750,42280
51244,48,69091,79229,43,69659,84226,5,29375,36260
51243,263,62604,70162,171,59479,75739,92,56250,55200
51242,80,70313,103310,56,81250,88423,24,48056,138046
51241,809,78250,84980,611,98341,99844,198,37929,38645
51240,806,71986,74569,577,78672,77945,229,34250,47492
51239,1037,74313,97079,809,81402,110220,228,38833,47437
51238,476,60795,70605,327,64514,77464,149,46534,54262
51237,679,54750,67134,500,66250,76994,179,23438,37143
51235,413,62431,79473,318,81481,91518,95,37019,34143
51234,475,66607,86219,382,74375,94200,93,39375,42589
51232,307,55208,66423,214,71042,73583,93,36875,45831
51231,191,87694,78286,146,88664,92169,45,23482,33242
51230,159,39934,53436,138,39808,54714,21,38125,38238
51201,2524,57643,72605,1461,88239,95558,1063,35329,39950
51111,36,39300,47892,36,39300,47892,0,0,0
51109,1424,62059,64331,860,69050,75151,564,30250,43373
51108,2068,60905,82390,1453,80288,97125,615,50702,46687
51106,10403,65703,80772,6430,84365,93865,3973,39319,54897
51105,4067,46193,53819,2533,56131,61211,1534,26298,32220
51104,8251,64539,81939,5655,71171,89130,2596,36907,54766
51103,6094,47908,58221,4001,56132,65187,2093,26746,36692
51101,371,17394,33428,83,49427,80923,288,16220,19741
51063,455,59398,75861,340,75833,86927,115,41875,40194
51062,264,30833,43999,82,73750,90402,182,0,22766
51061,213,61458,70892,108,82917,84209,105,41875,56423
51060,296,43333,59041,161,67625,82601,135,29432,30059
51058,407,61023,89889,238,85625,124143,169,22344,39387
51056,195,60495,62226,130,60833,67537,65,0,51129
51055,557,69583,78760,380,83958,88760,177,34073,50650
51054,1999,86563,110917,1542,84583,105373,457,56806,114283
51053,477,61792,73098,316,64655,84656,161,45375,47849
51052,475,70625,82674,263,86146,89700,212,53333,68270
51051,40,40625,47345,23,44375,59096,17,32656,31447
51050,1088,81912,96102,787,95625,108663,301,34861,49507
51049,260,47500,53487,161,56635,65035,99,27188,32984
51048,221,59280,69496,140,75000,81193,81,56875,49279
51047,359,72269,92918,237,79219,105799,122,51786,65041
51046,691,67340,79595,394,89167,102129,297,33750,49098
51044,114,71750,76511,79,107974,101599,35,0,19883
51041,2470,74847,80504,1689,83338,94743,781,40804,49183
51040,1584,49659,62959,907,62113,80324,677,31277,37501
51039,1127,88164,92861,819,100088,99316,308,44000,70756
51038,717,70875,74315,540,84400,84074,177,34583,43508
51037,184,27022,46840,67,86250,78318,117,26207,28560
51036,309,94205,102261,236,108710,106514,73,75347,82505
51035,777,65744,89618,494,81731,111379,283,32917,50556
51034,776,50000,57896,432,69118,75423,344,28279,35855
51033,216,39773,52015,110,56875,59623,106,31275,41266
51031,4919,69342,84992,3560,80378,99158,1359,34871,41475
51030,674,92000,90297,484,101016,103561,190,48750,51907
51029,177,65724,70233,92,82500,79295,85,40893,56296
51028,919,62467,88735,654,87206,105627,265,37625,47048
51027,412,70611,80125,328,72778,86005,84,22857,29951
51026,425,65208,75176,295,75139,83931,130,42500,54082
51025,797,57669,68148,523,62083,77891,274,35179,42677
51024,912,92613,91895,690,94557,103252,222,43056,51101
51023,1276,56810,77967,934,74643,89597,342,41797,44225
51022,331,78422,78831,271,79365,87880,60,31591,36017
51020,309,47614,54046,168,78816,81960,141,25000,19847
51019,295,64950,92724,207,64850,94541,88,52500,85788
51018,265,65208,67956,228,69375,71853,37,22321,33684
51016,530,48625,63506,352,69464,77019,178,33750,36784
51014,204,66250,79352,131,85625,95054,73,36375,51104
51012,2751,52898,70248,1563,80074,86009,1188,33696,45857
51011,28,54167,65236,20,60000,71120,8,0,50525
51010,174,63846,73879,102,76250,75590,72,63462,62900
51009,59,40417,50639,35,44063,60114,24,25833,33925
51008,67,64792,82710,37,91875,97032,30,56364,57067
51007,212,87917,124221,171,95156,138876,41,44375,55607
51006,468,69167,80958,316,66250,80658,152,25833,66659
51005,660,61932,73498,450,71818,83017,210,41833,53101
51004,419,53859,68147,268,73333,86212,151,30982,35977
51003,740,86875,91925,623,95647,99204,117,45875,53167
51002,1060,59615,77518,661,77120,93139,399,47658,48852
51001,894,57500,70138,616,71591,82881,278,33929,39353
50864,863,52750,63307,485,67417,69706,378,42206,53347
50863,84,56667,77062,58,97500,90426,26,0,47250
50862,71,57813,91048,53,59688,102147,18,43125,35828
50861,120,76250,107927,91,113958,109790,29,38958,89148
50860,65,42917,60531,36,44167,71556,29,28750,36028
50859,282,56750,71929,210,66136,82635,72,28864,32375
50858,286,52500,56986,200,63750,67523,86,29500,30651
50857,98,61818,65017,52,86818,91454,46,31324,35133
50854,972,49250,67292,616,69423,84647,356,22500,35933
50853,331,60875,67185,224,72857,84036,107,20179,31910
50851,811,53625,78125,534,65000,99219,277,27452,37458
50849,1206,51181,65152,658,80903,87590,548,31184,36146
50848,102,38158,48972,68,38816,57137,34,28500,32641
50847,29,37188,49493,12,68750,72925,17,23125,27988
50846,464,57000,67713,282,73913,69307,182,37917,60023
50845,242,56500,68038,163,72583,81598,79,36042,36044
50843,186,41875,47183,92,37143,53767,94,45000,39560
50842,34,42083,52024,22,47500,63918,12,0,30225
50841,1110,51346,65125,640,70455,84070,470,29183,39142
50840,313,65592,87495,188,60000,100555,125,92788,67016
50839,28,50000,48457,17,58393,63124,11,0,25791
50837,149,56705,72041,108,57500,78436,41,0,51241
50836,166,48571,74102,58,78438,80002,108,27188,68090
50835,41,52386,84698,22,152885,124218,19,50341,38932
50833,880,62500,71445,589,67629,82092,291,31875,47068
50830,676,66667,75407,462,80455,89944,214,38281,43227
50801,4056,48167,61112,2324,73049,79081,1732,23333,35136
50707,3650,53819,56954,1939,66094,65048,1711,48187,45774
50703,7782,33701,47530,4344,40814,55815,3438,20704,32697
50702,8490,52655,61625,4827,66442,75626,3663,32864,40592
50701,13102,53348,79587,8129,69925,96032,4973,34565,47146
50682,730,72763,77247,535,79960,90345,195,29844,35865
50681,164,61042,82238,119,65313,96299,45,32917,38156
50680,494,54167,81877,303,61750,101724,191,36359,49773
50677,4473,70554,82418,3072,85230,97258,1401,35774,45709
50676,999,71563,76671,723,77813,85086,276,33917,42010
50675,958,64028,80475,629,82569,91111,329,27344,38942
50674,1602,64412,79511,1112,85341,91105,490,43661,51151
50673,71,63750,70755,52,77857,78702,19,47188,49005
50672,223,54554,61361,146,73125,69066,77,30417,46705
50671,105,46602,56636,40,76731,81383,65,45792,40432
50670,914,64375,84638,676,73333,83414,238,30000,78193
50669,1045,69779,92533,705,91042,107361,340,40833,60708
50668,472,64643,73729,348,74167,78675,124,53700,58753
50667,301,64375,81342,218,80000,93650,83,34063,45346
50666,385,66194,68972,290,68438,73273,95,51838,51666
50665,1159,61884,72033,821,70772,81395,338,30833,44936
50664,14,0,0,14,0,0,0,0,0
50662,2751,39529,55515,1611,54474,73759,1140,21364,28245
50660,482,58214,67800,357,79041,78035,125,28750,33019
50659,2421,65589,77831,1520,76216,97189,901,35439,43692
50658,975,53935,77622,647,74402,80870,328,31667,37404
50655,372,56500,60831,219,66250,74108,153,26375,35578
50654,161,58750,68920,118,61944,81659,43,38224,33960
50653,292,67250,78158,187,80568,93069,105,35903,46519
50652,41,42083,44346,27,51250,49070,14,23750,35229
50651,1417,65825,75287,946,82500,88794,471,35625,46404
50650,325,49648,59115,229,54028,65786,96,42500,39564
50648,1506,82283,86924,1242,86813,92895,264,35000,53298
50647,943,84083,88362,699,96761,101116,244,31548,43317
50645,527,50563,56414,323,60179,70763,204,0,31544
50644,3580,65060,83743,2365,78229,104628,1215,24429,35604
50643,1059,99432,101678,795,106403,111141,264,47283,69136
50642,263,81094,92060,214,90769,101593,49,43304,45592
50641,518,52389,138274,321,69861,198563,197,25966,37961
50638,1351,72995,84800,926,79593,99271,425,43490,48648
50636,909,46366,59870,589,52917,71586,320,28800,35473
50635,627,57472,79615,359,82875,108165,268,37500,40107
50634,340,65500,79027,221,94583,95580,119,44750,47778
50633,252,59173,69409,89,79338,84231,163,58770,61097
50632,515,59321,77491,345,78618,94908,170,30833,39538
50630,715,57386,70832,457,78393,88493,258,22045,38703
50629,921,83125,93290,700,89919,101149,221,44464,61640
50628,482,56058,63351,323,69625,77267,159,25787,31411
50627,1244,54474,60997,803,67384,76204,441,24150,29448
50626,617,70875,82529,465,79931,88257,152,31818,62774
50625,447,56771,67052,337,66406,74408,110,22083,40657
50624,632,86042,107213,424,99412,121325,208,36618,76416
50622,1204,91667,109534,855,102225,125034,349,54659,69980
50621,674,62647,83719,480,80521,88427,194,35000,67865
50620,24,41429,45008,11,0,49855,13,41458,40915
50619,851,60438,79559,605,74821,93801,246,31618,40616
50616,4454,45496,63705,2589,73646,85141,1865,28722,32721
50613,16343,66839,94888,9168,97430,127744,7175,39649,50493
50612,165,68565,98267,134,0,102649,31,0,0
50611,175,62386,65482,102,88629,86025,73,0,36049
50609,131,86875,102877,97,92708,108886,34,66250,85732
50607,132,75278,74994,103,75417,80667,29,42841,35648
50606,349,40625,58430,265,53850,67295,84,18889,28651
50605,106,63333,59390,75,64676,71137,31,25250,30968
50604,744,52302,65771,441,62574,74977,303,42240,51400
50603,208,53281,70888,140,73333,79433,68,45833,50503
50602,659,56771,66188,407,72159,81819,252,34464,39697
50601,1035,52361,71963,665,73047,88348,370,27321,40272
50599,214,64833,69862,118,85179,86554,96,41250,49344
50598,419,67371,68939,275,82930,83349,144,26439,38453
50597,428,59706,66874,276,75682,84592,152,26750,34038
50595,3711,56764,64761,2310,68125,78599,1401,31553,40375
50594,97,56083,70228,47,88125,78930,50,51250,62048
50593,21,24583,40719,7,0,63171,14,23333,29486
50591,181,59750,71539,148,75833,77011,33,25000,16788
50590,395,54583,67407,227,51875,73459,168,50938,55655
50588,4616,49990,66646,2721,70058,83995,1895,33906,38099
50586,119,45208,56101,83,55156,66135,36,25000,32681
50585,505,61587,68165,325,64408,76023,180,33333,45672
50583,1190,53421,71602,677,71705,92482,513,41971,42240
50582,111,52292,62009,72,71471,77401,39,28594,33123
50581,341,48661,57251,249,39107,54122,92,35000,49373
50579,1010,43534,63378,637,64010,83471,373,19861,26859
50578,286,56923,67821,178,58947,77606,108,47000,46908
50577,181,42063,51809,104,50000,59258,77,38750,39939
50576,129,50938,57091,95,66042,65117,34,29583,32747
50575,326,56500,67652,207,76979,84193,119,38438,36430
50574,962,48750,59092,468,77000,80092,494,26868,37525
50573,36,34167,48297,20,48750,65220,16,32500,27144
50571,153,77538,85193,77,63750,114129,76,77823,55237
50570,82,58125,81622,58,69722,94174,24,56000,50571
50569,339,58906,62601,217,82750,80492,122,26429,30563
50568,537,60139,73753,357,85568,91227,180,31667,35063
50567,117,47917,57226,70,67000,74197,47,26625,31951
50566,179,70536,91485,143,88068,101534,36,47500,42567
50565,171,55625,85883,106,88250,121642,65,20625,27497
50563,1156,60682,73405,704,75577,85107,452,38684,53204
50562,168,59000,97554,90,98000,143936,78,31458,40223
50561,228,59545,76182,171,58813,83656,57,34219,34981
50560,265,61750,77901,176,67500,86218,89,48906,57494
50559,160,43750,53148,96,59167,67280,64,17000,27548
50558,255,75893,88838,165,79922,106283,90,36250,53299
50557,344,61250,75074,179,73021,101803,165,44044,45342
50556,115,0,97868,75,0,129537,40,28750,38485
50554,776,52273,70048,429,61250,87516,347,46375,47161
50551,43,51875,54219,32,66667,63084,11,31094,28427
50548,2467,57429,68421,1483,71678,82322,984,32273,46693
50546,180,55000,63072,99,75417,79252,81,28854,40104
50545,69,0,45829,47,67250,57483,22,0,20932
50544,219,49485,61436,159,69063,77031,60,0,20108
50543,609,56477,71693,395,73583,89696,214,26719,36532
50542,355,53906,71470,247,75625,83921,108,38333,42733
50541,396,51667,63668,263,72039,78525,133,25938,31936
50540,404,81429,80923,308,88214,91594,96,23611,34515
50539,200,49286,62021,139,62813,71225,61,33125,41046
50538,208,46667,56274,124,56667,67893,84,36250,38824
50536,1834,53629,65763,994,80357,85905,840,34103,40965
50535,457,58021,73449,296,58203,70723,161,50694,72984
50533,1691,58496,71980,1058,66087,82119,633,37098,54752
50532,356,48750,57274,266,53750,60054,90,37857,43923
50531,124,0,114266,53,48750,56587,71,0,156724
50530,500,62697,68366,337,71513,84122,163,22986,33793
50529,328,51364,67365,213,59219,71811,115,26696,55604
50528,136,98824,122804,102,103750,146536,34,47500,51609
50527,78,48750,55403,58,53750,62736,20,31667,31330
50525,1651,41991,58596,955,62825,74457,696,29018,35460
50524,223,73854,94665,154,101250,116602,69,62583,45010
50523,222,51500,63594,134,80000,80618,88,30714,37485
50522,356,71071,75698,290,79688,83014,66,31667,38558
50521,46,9022,11250,30,0,0,16,0,0
50520,69,0,55284,52,68750,66773,17,0,18694
50519,282,57727,77439,177,58988,70060,105,48295,84950
50518,182,71813,67459,124,81296,79156,58,50833,42452
50517,448,47273,66945,290,59000,78430,158,33095,43769
50516,271,59821,73469,158,87917,91368,113,32917,46953
50515,103,32120,83068,39,88472,129156,64,30972,54983
50514,636,50125,56204,360,51429,62112,276,44423,46980
50511,3217,52625,68110,1781,71273,88750,1436,33241,39185
50510,442,67500,92795,278,95000,119147,164,37250,44374
50501,11952,49551,63367,6458,66049,77480,5494,31938,43383
50484,152,68750,69413,108,74000,73169,44,42500,54680
50483,287,77578,80793,205,79453,87358,82,44000,60315
50482,319,59750,73113,232,71176,85201,87,23125,39286
50480,297,59297,71160,218,78542,85546,79,28958,31462
50479,284,53438,72088,191,71250,82594,93,33958,44142
50478,435,41625,57948,187,83938,77828,248,33000,42777
50477,123,57813,62882,90,59792,71986,33,24688,37127
50476,293,44886,52576,193,61307,64224,100,21667,26434
50475,571,55417,66871,388,63611,77502,183,42989,42289
50473,96,79091,67808,73,90625,80033,23,31375,28774
50472,1035,67893,83256,703,75625,101875,332,36667,40699
50471,256,53375,66939,151,61719,83660,105,33542,37194
50470,107,52917,57450,73,48750,57463,34,65357,55171
50469,646,69167,79421,417,85650,92025,229,36420,51447
50468,609,57473,78362,398,73125,95394,211,35625,41285
50467,43,46875,58309,26,0,81492,17,0,22853
50466,775,50391,62740,481,64712,75905,294,32159,38278
50465,81,37344,54136,44,57500,75841,37,22708,28324
50464,215,68523,89391,181,69205,94506,34,33750,34191
50461,2400,60305,72947,1553,75580,89858,847,26938,39512
50460,157,71779,72568,93,71875,79759,64,67250,62117
50459,1237,60036,74339,793,77161,90065,444,32071,40606
50458,905,75368,82832,651,89844,93348,254,39531,50460
50457,170,71000,76855,132,79583,82490,38,43571,50861
50456,737,71339,72364,505,77917,82751,232,29583,41640
50455,165,80365,73914,126,80417,72047,39,42917,60472
50454,26,0,54296,19,0,0,7,0,0
50453,244,56250,81414,199,59688,88309,45,35972,44513
50452,469,52109,52417,388,54643,53833,81,29375,42199
50451,240,49000,62949,115,49063,63215,125,26250,55571
50450,1285,63429,69331,780,75238,83800,505,35074,44957
50449,348,60980,72312,237,62181,83272,111,33438,48239
50448,341,55469,71634,206,57174,72286,135,32750,57334
50447,557,66172,66217,350,66250,69431,207,57188,59005
50446,213,64583,68642,160,79167,75866,53,40625,44326
50444,130,68750,77758,94,72222,89337,36,31667,45892
50441,2230,44605,67306,1455,57813,80089,775,20272,41615
50440,171,93125,99454,111,118850,115705,60,36500,50360
50439,106,53846,61233,77,62188,68930,29,46250,40797
50438,1763,64375,73208,1325,77004,82756,438,33750,41990
50436,2212,53255,71689,1389,66583,84975,823,41620,47181
50435,265,67440,80704,198,83663,96818,67,21736,33085
50434,281,32375,44159,110,68125,77405,171,0,22773
50433,94,45192,48819,35,85234,67309,59,41806,37851
50432,116,65000,64592,72,82000,75878,44,40500,46127
50431,88,46667,53084,62,55278,61398,26,0,33258
50430,211,48125,59350,109,69327,79754,102,27143,35228
50428,4090,62268,96164,2550,84943,115784,1540,34432,62213
50426,24,41500,53621,12,0,67992,12,41389,39250
50424,680,51786,71508,388,89318,105120,292,16960,25349
50423,1126,53253,62722,673,68156,76047,453,36875,40808
50421,1193,51705,64806,768,63056,74347,425,31510,40806
50420,123,65083,65563,81,65417,72598,42,60000,51998
50401,13264,54154,67754,7600,69112,81537,5664,33919,44977
50327,4451,81677,100933,3343,95085,109097,1108,51037,67120
50325,6714,106985,128732,4695,126708,149179,2019,50903,74878
50324,2038,69490,83924,1250,93023,101463,788,50114,52113
50323,5123,144180,161237,4180,166190,179249,943,64297,76436
50322,12351,74205,91013,8188,92852,108570,4163,47931,53992
50321,3357,61828,85052,2346,78438,95406,1011,43125,53581
50320,8147,65137,79675,5899,74991,87711,2248,39022,49862
50319,0,0,0,0,0,0,0,0,0
50317,14011,55294,64413,8783,64929,71049,5228,39662,47620
50316,5190,44869,52638,3099,47185,59054,2091,28535,37372
50315,14449,51710,61364,8180,62157,70280,6269,33533,45969
50314,3902,39370,49641,2064,43780,52966,1838,33061,43228
50313,6900,54387,62202,4453,57191,69839,2447,34301,44529
50312,7904,66194,107838,3531,124358,168650,4373,39481,58180
50311,6079,55066,69649,2918,73355,87443,3161,43064,49671
50310,12996,64213,76391,7264,75383,90492,5732,47087,54042
50309,5634,50549,69601,866,107174,111965,4768,46283,61361
50278,308,61477,72614,199,70982,78267,109,40469,59992
50277,172,67857,71910,99,69554,83288,73,0,56479
50276,890,79271,99434,632,95938,112862,258,40833,64192
50275,228,57500,59678,169,69453,72560,59,20938,22775
50274,89,64261,73622,55,64830,82100,34,56458,59912
50273,3597,63464,83162,2472,76250,102004,1125,24623,39811
50272,57,0,52546,33,77813,74203,24,19000,19858
50271,221,72841,86696,158,85208,84872,63,33750,82597
50268,423,42574,50788,254,50625,59500,169,25865,37582
50266,13720,74435,105829,7114,104693,141308,6606,56257,65706
50265,14265,71560,98116,8491,93157,117878,5774,46474,66777
50264,195,51402,64287,145,65417,68348,50,41429,51518
50263,10501,98546,121593,6924,129515,148414,3577,57837,64399
50262,130,47500,66982,110,56250,74123,20,25714,22860
50261,891,123427,140174,769,130729,150557,122,57083,72260
50258,464,68036,73549,349,73264,86635,115,27917,33102
50257,443,75170,86012,401,74514,88307,42,35000,38148
50256,236,75833,95565,205,81691,102347,31,19750,23148
50255,27,42083,48293,18,46667,58617,9,30893,27644
50254,82,79000,97573,67,105179,108567,15,33958,40773
50252,63,0,62589,34,0,91924,29,18988,25031
50251,563,74826,87238,395,84479,95115,168,61500,67007
50250,1023,61779,68327,680,78654,80180,343,27560,39003
50249,512,51071,67214,330,67143,80640,182,35000,39875
50248,1825,71394,83301,1164,96667,104499,661,30452,44506
50247,947,69766,90638,665,81125,105218,282,35500,51245
50246,350,63214,74495,230,70114,89975,120,45625,42823
50244,775,77824,89797,583,98125,102253,192,44375,48912
50243,84,58333,64768,58,68636,76167,26,0,34950
50242,178,85250,84022,134,86875,93824,44,27500,38302
50240,1147,85547,104109,850,86406,116386,297,55655,60380
50239,31,50625,54187,13,97679,78500,18,31250,36628
50238,516,53214,62537,378,61667,72947,138,20735,30949
50237,1334,93690,104185,1005,109361,125687,329,0,36858
50236,729,70458,91406,496,94107,111171,233,58125,47136
50235,151,57596,55387,100,54583,58385,51,31875,40688
50234,238,60455,84525,180,77500,100152,58,30833,33236
50233,577,75592,75595,471,69938,78748,106,27000,31387
50232,239,62361,85973,136,98750,103974,103,41823,59695
50231,73,57344,63868,43,71250,79319,30,28750,35503
50230,426,68750,75504,300,74271,85925,126,46477,48866
50229,304,115083,134057,273,115375,129771,31,0,165245
50228,1023,68810,86522,811,73911,94199,212,41667,45519
50227,19,31354,39584,17,31563,41671,2,0,0
50226,2283,126708,136388,1874,134911,142401,409,62417,103885
50225,1367,59098,70090,925,70509,78699,442,50714,50727
50223,218,51304,51144,159,60250,57357,59,29375,33161
50222,180,83125,71074,161,95125,75835,19,0,30737
50220,3669,53118,66850,2255,59838,81732,1414,27150,41525
50219,5052,78182,101504,3641,90302,113962,1411,42583,66022
50218,125,54125,58351,84,74375,69924,41,38125,33683
50217,273,55066,74401,170,68333,89446,103,45625,48118
50216,1085,69583,98498,839,86750,112864,246,32434,47893
50214,274,86250,100532,215,132930,118599,59,40368,34693
50213,3041,54426,66629,1836,62813,74241,1205,31533,52559
50212,1221,69185,85171,809,92861,106839,412,27262,41361
50211,5338,84357,99576,3537,103264,120468,1801,44832,54543
50210,598,69125,81755,370,102596,100175,228,32500,49832
50208,7945,51428,64282,5299,59274,73438,2646,32040,41722
50207,943,65842,87900,636,84412,110883,307,33875,39087
50206,212,90357,87156,163,113125,100953,49,20208,34298
50201,3455,67050,94580,2207,86658,122031,1248,38185,44933
50174,501,55670,75524,347,72083,93888,154,33409,33747
50173,362,49375,62779,245,65859,81708,117,14097,21750
50171,1155,51915,70597,779,72596,86404,376,21184,35258
50170,1255,66997,74452,815,82757,86408,440,43393,48848
50169,940,68654,79339,615,87813,93382,325,30592,45019
50168,396,79583,88774,304,96667,97916,92,36667,58566
50167,314,65833,75209,252,74286,81998,62,51500,46903
50166,703,74669,89943,502,90185,102382,201,61392,58229
50165,66,34054,46144,21,88194,71429,45,33682,34344
50164,238,65536,68526,160,75833,75331,78,32500,44385
50163,385,48313,52927,256,51333,60219,129,27639,36806
50162,566,55000,79953,299,71635,99555,267,48301,57451
50161,819,80583,97710,607,97639,111525,212,45000,49589
50160,237,47083,54915,119,71250,68034,118,21042,39519
50158,11615,57298,68719,7479,71128,81170,4136,34417,43837
50157,397,50034,64202,248,63889,76792,149,26583,43071
50156,1993,75440,84348,1352,90238,98290,641,38315,48373
50155,97,43750,58788,62,51667,65769,35,23750,41600
50154,230,61600,65465,157,71875,73056,73,46250,48359
50153,356,61000,77788,228,86667,93447,128,23333,49136
50151,246,75463,87672,191,90625,98043,55,32250,37220
50150,398,69028,69584,256,75909,75762,142,50000,55110
50149,371,55438,72407,285,70703,81004,86,31250,43917
50148,222,68673,71527,169,69056,77921,53,41250,50842
50147,181,51250,63942,96,70833,73176,85,38542,52376
50146,213,59821,76624,145,61563,72577,68,0,85256
50144,1126,58967,62484,641,62917,74538,485,51607,43830
50143,265,78542,90175,178,94643,115025,87,53173,38687
50142,367,52279,70960,221,66518,81804,146,42500,45421
50141,171,61875,70712,122,79375,80163,49,38438,40943
50140,1119,41434,59817,671,65060,73224,448,19512,37884
50139,506,55833,62353,348,66875,69301,158,50357,45195
50138,5110,56984,73359,3292,71806,87200,1818,33726,46469
50136,184,53214,71920,137,57188,82290,47,31875,37330
50135,562,57500,76056,372,76406,84745,190,35625,58574
50134,350,80449,87426,255,76932,78318,95,140077,97833
50133,219,48750,57761,157,61719,63958,62,32368,35782
50132,141,54464,74418,114,62500,71273,27,36875,82970
50131,8884,89625,119510,6027,114397,142115,2857,58246,66682
50130,587,74453,93835,416,81500,109794,171,46750,50222
50129,2328,46868,65685,1349,69334,84465,979,34960,35678
50128,186,45000,58236,101,80250,74418,85,40859,39008
50127,0,0,0,0,0,0,0,0,0
50126,2783,51391,60796,1631,69604,78667,1152,25729,34068
50125,7622,71395,83826,5252,93556,101449,2370,29271,43014
50124,1525,109931,112776,1148,117443,132094,377,46063,53953
50123,350,47750,96319,235,67569,115156,115,25417,57016
50122,603,68750,78711,413,99013,96013,190,33036,38742
50120,196,106250,84636,152,118431,100247,44,0,29882
50119,108,47778,63838,74,63333,79049,34,25000,28459
50118,351,67969,82271,284,82500,91332,67,38250,37775
50117,56,40625,56398,46,50625,65928,10,0,0
50116,66,47143,49709,35,55417,63826,31,0,25216
50115,1164,55357,68169,728,76087,80903,436,24375,44000
50112,4838,54349,85808,2778,86484,116540,2060,35452,42739
50111,5944,100589,115676,3765,112113,132836,2179,60268,83881
50109,1244,112713,158432,920,124167,182833,324,52500,79738
50108,154,38750,58807,104,45357,66820,50,11750,40142
50107,411,45313,68056,283,56042,79687,128,26154,31299
50106,391,82257,82202,239,81563,91280,152,0,62407
50105,399,90781,94325,325,109625,103250,74,46563,53596
50104,38,45000,67218,19,0,96595,19,43194,37842
50103,143,48750,54305,91,52917,54775,52,27500,47342
50102,56,0,54038,38,70833,65013,18,0,0
50101,12,31250,39833,7,0,47200,5,0,0
50078,56,41875,48004,28,47000,59943,28,27500,27768
50076,679,47434,55308,427,52292,65385,252,26983,35413
50075,316,72500,83387,209,83125,104063,107,37083,40914
50074,150,67813,79887,121,73194,83522,29,55625,64721
50073,466,83542,107044,290,84375,93683,176,0,125110
50072,972,89896,105949,787,96976,117631,185,40625,51117
50071,428,42094,68451,223,63359,86657,205,40417,43747
50070,526,75000,96725,392,90417,109068,134,45526,57543
50069,422,76711,89067,311,93393,102435,111,41875,50021
50068,118,63571,80538,99,80313,88638,19,13125,18563
50067,111,52829,47381,79,53125,47872,32,49444,41781
50066,82,55882,62577,36,56250,60644,46,55556,60461
50065,315,41172,49107,238,45192,54218,77,26125,32683
50064,71,78045,67590,48,78718,79865,23,31442,41022
50063,975,85875,110198,646,102283,136005,329,50688,53532
50062,281,49250,53195,229,55402,55980,52,32885,31594
50061,858,162059,184076,748,163676,172095,110,0,265085
50060,1009,52083,62272,668,58250,70087,341,32169,44645
50058,805,56750,74464,510,80612,95635,295,31705,35543
50057,133,0,43916,79,68221,66419,54,0,0
50056,504,68929,87063,367,78750,92202,137,46635,70111
50055,341,67813,111146,275,92031,125633,66,46750,50073
50054,1067,77390,91969,803,84728,102861,264,47981,51725
50052,39,26875,46526,16,86250,82338,23,18594,21617
50051,139,50469,58352,107,50677,51479,32,0,75988
50050,294,50781,58911,167,63438,74683,127,33125,36337
50049,2803,52407,70997,1888,68505,82481,915,29583,44107
50048,336,55000,68286,252,62222,75318,84,36250,44139
50047,2322,86117,89618,1631,97993,98371,691,45536,61416
50046,692,76087,85348,478,92159,103215,214,26375,36604
50044,407,56806,59829,312,63793,66496,95,22212,26211
50042,111,53854,59799,68,58333,70419,43,34375,43002
50041,21,0,0,21,0,0,0,0,0
50039,158,92500,87815,125,59107,73557,33,53917,60424
50038,51,61484,70504,30,0,75640,21,0,0
50036,6715,66015,80703,4388,82072,97057,2327,34079,48803
50035,2769,97813,106073,2093,104596,112676,676,50735,71514
50034,164,66250,78870,126,73750,88910,38,27500,41305
50033,6,125000,137433,6,125000,137433,0,0,0
50032,240,30109,36103,169,0,32237,71,0,0
50029,245,47083,56889,145,58036,67034,100,30000,42179
50028,703,65708,76915,453,81083,90067,250,44118,50036
50027,157,45590,46737,128,46042,51132,29,22625,23138
50026,220,46786,55971,146,52500,66439,74,26250,33553
50025,1528,50242,63436,840,64881,75428,688,36703,46765
50023,14560,91974,105512,10062,104566,121765,4498,51510,61140
50022,3808,50907,71556,2219,74699,95966,1589,27563,35476
50021,11310,87938,109336,6899,103862,125991,4411,58187,79215
50020,534,55435,61731,326,77500,76336,208,30000,38494
50014,12770,47267,67278,4364,96944,118350,8406,32000,39969
50012,5,0,0,0,0,0,5,0,0
50011,0,0,0,0,0,0,0,0,0
50010,14239,57915,76964,7026,91601,111037,7213,31351,42427
50009,7327,80740,94989,5245,88296,105188,2082,47647,57842
50008,378,45833,55192,235,64375,67329,143,33688,32457
50007,186,137917,129520,167,141607,134799,19,91250,83126
50006,687,56528,67396,430,65625,78946,257,40982,45077
50005,380,56250,59130,309,60884,63226,71,33750,38620
50003,3075,88875,122915,2063,109221,152247,1012,39857,60772
50002,595,64531,84102,422,84167,94488,173,28250,57290
50001,266,89773,97570,230,93889,101561,36,40625,70342
49971,223,41583,50866,145,45375,54018,78,38026,39462
49970,123,50625,57367,93,55804,64447,30,0,34450
49969,589,39471,57432,309,58125,72464,280,25833,40453
49968,980,37500,64495,535,57750,77751,445,26213,46254
49967,204,41111,53694,114,54643,59050,90,33611,44804
49965,248,65221,84871,182,67250,101053,66,0,37429
49963,368,35318,65371,219,37475,86513,149,21964,28577
49962,107,46375,59702,80,65682,70375,27,17750,28081
49961,72,43333,45368,45,61250,57469,27,21875,25200
49960,79,31683,39635,54,31667,38076,25,0,41084
49959,169,33281,47198,89,57321,67008,80,24167,25150
49958,318,44643,52133,210,55769,64039,108,26250,28814
49955,124,67931,57502,79,65938,58590,45,0,48931
49953,1131,42330,50174,655,54531,60804,476,26223,33988
49952,46,52500,52152,39,63250,58664,7,17917,15871
49950,549,52708,75485,368,64423,84353,181,34271,52065
49948,235,46477,52854,155,53977,59543,80,32500,39894
49947,255,45673,59353,164,50000,70457,91,28036,39340
49946,1645,45052,61142,1024,56923,72755,621,30669,39941
49945,1146,45500,60682,715,64875,76802,431,24201,33196
49942,147,45819,57209,104,0,71586,43,0,22437
49938,3767,36994,55934,1908,54130,74970,1859,22008,34622
49935,2706,44009,55877,1622,59167,70712,1084,23269,30956
49934,343,43047,59754,176,72841,85316,167,29583,32813
49931,3359,28647,56421,1211,78813,106654,2148,18284,27923
49930,2656,47266,67170,1443,80223,87529,1213,26997,40147
49929,83,47750,49407,38,56923,58339,45,42679,37224
49927,176,56667,57195,133,63125,64346,43,37708,34091
49925,223,48295,56435,150,68125,72551,73,19792,22759
49922,288,45313,80890,171,61118,111416,117,26932,35507
49921,147,21779,38452,58,54083,53566,89,17344,28110
49920,1916,46667,56577,995,62868,70069,921,25767,40430
49919,89,44583,58454,61,48750,72287,28,26250,25886
49918,69,50313,75923,35,105417,119089,34,29583,31491
49917,80,38750,46948,60,49000,52063,20,16250,24780
49916,1203,70950,85034,847,95125,100749,356,41184,46874
49915,153,38977,43098,66,45682,55486,87,22981,31913
49913,2776,40350,53734,1657,52530,66893,1119,22799,31160
49912,467,42083,50448,293,58750,62754,174,30104,29469
49911,1182,47500,60933,771,65573,75957,411,22768,29924
49910,174,32250,45045,118,35313,49014,56,28750,36684
49908,989,47992,65126,670,56667,79569,319,22031,31600
49905,700,71591,78469,516,92935,88384,184,38125,42638
49903,43,37917,44265,16,57500,67644,27,31750,30411
49902,100,31458,38310,27,54531,69774,73,30156,26281
49901,139,49306,55928,88,63750,72110,51,22656,25047
49896,566,56900,75987,459,62361,82483,107,31932,39956
49895,247,39554,51461,172,45357,61019,75,28309,28903
49894,287,52788,75795,252,65750,84108,35,0,0
49893,612,61071,67858,394,76429,83956,218,31667,38322
49892,815,63542,68297,564,75000,77365,251,35104,45408
49891,301,51339,52343,166,59231,62832,135,42841,39374
49887,1177,47448,58117,754,49929,62780,423,30536,42617
49886,225,51250,67432,153,75417,74879,72,45357,51608
49885,728,60357,66898,485,75078,77722,243,33021,43630
49884,209,40568,49008,129,45179,63784,80,20968,22481
49883,60,42619,39950,45,43274,45124,15,19792,24427
49881,171,53882,72330,134,49667,71866,37,62875,63519
49880,502,56000,70978,313,63385,85781,189,41058,45228
49879,461,43958,52735,279,50644,57854,182,21667,44381
49878,1620,50380,60261,1021,64489,75114,599,27882,33017
49877,5,61250,68520,5,61250,68520,0,0,0
49876,532,80064,81522,435,81186,86483,97,29408,39404
49874,396,47500,58987,248,71250,67740,148,28125,41423
49873,38,50417,56187,24,59167,65450,14,39167,38107
49872,100,45966,52096,39,49375,71292,61,45804,39823
49871,200,49444,52377,139,50521,59117,61,0,32577
49870,1618,52717,69967,951,81484,89458,667,37287,41599
49868,1660,46958,61990,1056,63958,71200,604,26961,41742
49866,3286,61042,69352,2183,74116,81187,1103,31756,40170
49864,31,27750,24139,11,40625,32909,20,21667,19310
49863,76,36875,52091,44,0,62582,32,0,33788
49862,1506,43571,55958,848,68417,75058,658,23929,29787
49861,228,61875,76663,176,69000,82144,52,27500,55681
49858,5553,45103,60552,2932,59789,74909,2621,28255,43126
49855,13230,53759,69113,6971,73200,89926,6259,30654,43495
49854,2919,47182,59491,1772,62935,75194,1147,20813,34032
49853,628,54276,61463,451,71250,72648,177,28510,32480
49852,63,32250,66638,40,0,93653,23,0,19657
49849,5118,56667,68748,3203,69334,82708,1915,35765,42355
49848,52,36250,50483,17,76250,70618,35,29063,40703
49847,508,60431,69549,361,76964,83256,147,27917,27152
49841,2717,52466,64991,1851,63917,73982,866,38830,40328
49840,271,54688,74120,174,66429,91811,97,35893,38892
49839,174,38679,50960,117,39599,60469,57,22656,31442
49838,234,29792,46093,117,43250,52179,117,26151,38635
49837,3636,58038,74708,2623,69206,86774,1013,31432,37826
49836,420,57727,57170,317,67132,64568,103,16406,31630
49835,367,45795,60638,212,61458,75848,155,26823,39316
49834,97,48594,55898,57,86750,79951,40,25543,21620
49833,168,71706,80443,130,71382,78268,38,0,0
49831,293,73375,86960,195,78281,104867,98,37500,45916
49829,7982,39914,54378,4711,54101,67380,3271,21467,33301
49827,434,37000,56588,337,37096,57712,97,32788,42970
49826,31,0,45810,28,50278,47550,3,0,0
49825,113,36635,42858,64,35769,45970,49,0,38792
49822,81,30750,46014,45,51875,61829,36,19000,26244
49821,568,54868,67267,380,66667,81691,188,30227,36307
49820,132,48333,49416,55,63438,61105,77,40625,41066
49819,11,41875,47982,5,0,0,6,0,24317
49818,491,48792,69098,318,66563,85670,173,26797,37677
49817,246,54464,74135,196,71250,80962,50,52500,45956
49816,306,54375,62498,212,64500,70507,94,45500,43349
49815,119,52679,51854,90,59722,52204,29,48295,39431
49814,510,61000,65199,375,64507,75776,135,24135,35430
49812,360,50192,63947,234,62885,76099,126,30313,37892
49808,457,38768,44107,41,0,93029,416,38617,39215
49807,1528,55833,69202,1101,64728,79862,427,31991,39575
49806,275,63125,60013,210,70521,67258,65,21023,31111
49805,201,56250,68727,136,79250,85412,65,35642,33817
49802,2696,46534,57267,1599,51087,66019,1097,34253,43210
49801,5121,50158,70877,3376,69135,87940,1745,30485,36230
49799,849,39813,49187,603,42356,53986,246,27000,34596
49796,162,71250,91402,86,72344,117200,76,0,62212
49795,814,48824,59891,525,57969,68609,289,34417,42844
49793,79,32708,49239,60,44167,56665,19,24375,25784
49791,142,64286,88544,109,91023,106923,33,24792,27836
49788,1085,40221,47791,837,38036,48464,248,28618,34831
49783,8115,50152,63190,4413,62565,78138,3702,33550,43145
49782,285,62679,83925,195,70179,98410,90,34688,49338
49781,1823,50564,62294,1014,58357,74213,809,40089,45445
49780,646,61429,69880,454,74286,81084,192,34167,38087
49779,2013,47324,57836,1346,54462,67349,667,25568,37207
49777,885,74141,111495,662,85965,134512,223,31696,41830
49776,714,45294,51640,457,55655,61778,257,22750,32061
49775,36,57500,52997,25,60938,55028,11,50625,48382
49774,785,55644,77252,563,70347,92884,222,27000,35770
49770,7188,62264,90549,4719,76985,104596,2469,36147,51423
49769,642,51800,58529,451,56577,66736,191,28194,34309
49768,198,42500,50200,122,41875,53332,76,0,42957
49766,883,44219,70208,543,57981,88697,340,25761,39519
49765,1760,43971,56615,1171,54279,63628,589,25402,40541
49764,194,43767,38704,61,0,0,133,42723,33026
49762,309,48750,54209,225,52434,59120,84,33333,37638
49760,314,48750,70545,218,59342,89062,96,24583,27523
49759,727,48508,58837,464,56563,68143,263,33424,40955
49757,492,43125,63680,146,66250,107271,346,32326,44601
49756,1833,41697,56615,1167,50095,68665,666,30147,34032
49755,849,50260,60289,566,64091,73845,283,26875,31272
49753,876,56250,68494,604,65714,76958,272,38167,49526
49752,280,71667,407584,223,77991,501868,57,25000,38719
49751,872,57763,72933,626,68482,83212,246,39038,44690
49749,2064,56230,69276,1251,67917,84526,813,30824,43107
49748,93,38750,48370,62,49688,56444,31,19583,32219
49747,931,43828,61082,724,53426,65108,207,31736,41061
49746,1570,40848,51250,978,52632,61000,592,24432,31655
49745,444,47500,69584,323,59375,84002,121,21484,31098
49744,300,38611,56738,172,68750,76709,128,31944,29901
49743,352,42143,50489,232,47241,57705,120,33929,36243
49740,3176,65833,93526,2118,82394,113519,1058,33684,51698
49738,4354,49500,60390,2817,65881,71295,1537,28478,38242
49736,213,45938,57579,98,66833,82999,115,26964,35333
49735,8090,56270,67602,5380,70563,78838,2710,29290,40981
49733,772,51250,57760,484,62375,66276,288,35000,39597
49730,815,60417,64523,593,64704,73298,222,34100,38858
49729,678,64773,78082,447,75329,92427,231,41406,48576
49728,143,59886,58983,93,59432,57228,50,62917,58480
49727,2909,55406,73717,2089,68147,85517,820,26316,39252
49726,568,49000,59398,350,63636,73240,218,25417,36705
49725,287,46250,58116,172,59167,74319,115,38542,33883
49724,414,57188,67115,274,73977,77464,140,43333,40250
49722,78,0,30559,36,0,59317,42,25000,0
49721,6112,47137,59575,3913,58188,70228,2199,27668,38937
49720,4140,60132,82192,2635,76730,101996,1505,30174,44928
49719,650,58707,80803,414,70039,99919,236,38333,47267
49718,283,39922,52943,196,44545,56683,87,33750,42570
49717,65,0,45738,24,0,54013,41,0,40895
49716,326,61250,82402,277,66528,87380,49,53250,49559
49715,1396,55673,71340,952,69265,83704,444,26714,40174
49713,874,58214,65857,520,73625,78705,354,39375,45113
49712,3653,61211,84177,2401,75743,102258,1252,41152,47293
49710,187,51250,66232,127,50893,76528,60,25139,31133
49709,1724,42542,50308,1105,52695,57379,619,28068,35289
49707,10038,41941,56184,5843,55421,68638,4195,25427,35728
49706,2087,42417,54399,1342,53837,65393,745,22946,30463
49705,329,53750,62711,229,51806,62990,100,68929,60838
49701,390,41389,54458,182,74750,77897,208,20156,32338
49690,2750,82732,98562,2088,90231,110528,662,37955,54846
49689,636,59091,78353,442,73224,83903,194,34375,64914
49688,928,54929,65755,655,65677,76954,273,32125,36507
49686,14653,68609,88756,8967,86800,108034,5686,42892,55695
49684,16748,63197,82327,9983,80165,98826,6765,38185,53698
49683,823,42545,54922,496,58750,69014,327,29417,32178
49682,1871,69135,90359,1305,85885,105345,566,35000,49563
49680,676,48816,58494,438,53056,61435,238,41944,49651
49679,436,47262,62126,306,60250,71382,130,31500,37616
49677,2807,46769,59399,1890,59141,70404,917,23456,33228
49676,1537,57739,73624,1116,70047,83484,421,31898,45075
49675,419,46406,81132,241,82250,105752,178,21667,45694
49674,11,0,0,11,0,0,0,0,0
49670,946,68182,105621,603,75791,122659,343,39866,75091
49668,1268,45625,54198,836,53966,62364,432,25854,33893
49667,255,42578,49168,155,48125,63228,100,0,22771
49666,61,0,0,61,0,0,0,0,0
49665,1726,43712,55580,1198,55212,61430,528,25915,36073
49664,759,72788,83224,523,88625,100142,236,34091,44058
49663,2198,46184,56667,1632,50508,62651,566,21176,29393
49660,5630,52655,69249,3570,64755,83419,2060,30155,41816
49659,2847,46569,57038,1785,54136,66238,1062,28987,39582
49657,1358,53125,70112,973,65893,81613,385,28194,34757
49656,640,45571,51571,413,51289,60754,227,20781,33619
49655,1308,51025,63982,1002,58523,70291,306,21324,30484
49654,283,62824,76363,147,74688,94622,136,39833,52363
49653,756,72227,106403,547,83558,125900,209,45074,52275
49651,3335,46623,60852,2264,56081,68903,1071,26328,39960
49650,1267,82104,89308,903,95799,98665,364,54944,53881
49649,2228,65270,87629,1657,68554,79125,571,35750,103311
49648,1147,71845,88015,852,76740,101932,295,42232,45208
49646,3496,45443,57387,2237,56726,66475,1259,32975,38142
49645,664,41522,54609,390,49722,64975,274,29457,34074
49644,988,45357,54182,624,57157,68327,364,23190,28507
49643,2790,70449,82061,1880,84456,95849,910,37798,50554
49642,390,21667,33539,176,24500,40954,214,17708,27316
49640,566,56667,77327,404,61500,82356,162,41667,61195
49639,1005,50347,57148,748,49935,60182,257,35179,35457
49638,347,39453,47886,224,46250,54035,123,24271,36310
49637,1168,54741,77648,829,58563,81645,339,41676,49528
49636,212,88750,188420,119,74583,121490,93,0,274061
49635,1354,61500,82603,864,81071,99331,490,31184,52168
49634,23,0,62387,23,0,62387,0,0,0
49633,1534,59420,77241,1059,67321,90345,475,33828,44801
49632,482,42000,51061,275,53813,60687,207,32939,36634
49631,2557,42128,51262,1620,47425,58293,937,26058,36263
49630,696,64167,79606,470,80833,90937,226,49348,51969
49629,1043,66161,81754,713,83155,90798,330,25700,56918
49628,69,72614,68542,44,74167,78366,25,60625,51248
49627,76,46739,78501,56,0,64334,20,0,118170
49626,138,46250,48457,85,46908,51961,53,31719,38464
49625,493,40875,51401,276,53846,64933,217,23071,30707
49623,475,49688,56186,331,56193,64447,144,35385,36527
49622,1119,51273,62506,798,59020,72728,321,30580,35840
49621,1513,64663,82460,1077,75391,94508,436,35417,49546
49620,926,61184,66964,680,64537,73503,246,32083,42291
49619,364,46731,59438,258,52727,63160,106,30000,47034
49618,342,42167,54603,207,50250,63252,135,34145,39632
49617,1280,68884,79604,877,74735,92094,403,40991,51145
49616,876,36029,52615,542,51806,64901,334,23594,30868
49615,1647,63555,77419,1092,78833,88878,555,31902,50797
49614,1127,59417,72006,777,70045,82997,350,33036,43900
49613,281,55313,98887,183,71250,120031,98,36786,59404
49612,629,54083,78045,395,55875,90079,234,40833,55600
49611,148,67500,62484,125,69375,61240,23,0,37296
49601,9002,52348,71146,6171,62150,83750,2831,31193,39899
49548,11630,50763,57015,8086,53340,60582,3544,36409,42735
49546,12888,79581,124331,8285,106605,159471,4603,38566,59043
49544,4226,57372,75963,2425,84778,100610,1801,32775,40405
49534,9020,67074,81865,6063,81549,96291,2957,38771,46064
49525,11996,72632,107739,8696,90537,125114,3300,43076,57934
49519,10665,58188,72931,6539,68998,85054,4126,42662,51806
49512,8121,53305,76891,4163,84210,102559,3958,35453,49085
49509,10330,51463,58034,7003,60621,65143,3327,31161,37940
49508,14503,57515,70385,9715,70613,82241,4788,37132,41672
49507,12668,42426,54241,8462,46822,58802,4206,28671,39794
49506,12658,86004,119913,8491,109061,149589,4167,44774,58188
49505,13358,55440,67370,7840,68803,78365,5518,37851,48822
49504,16371,52460,65284,8517,67480,79109,7854,37649,47923
49503,15823,49717,67618,6805,62254,79396,9018,41425,56037
49464,10437,82534,98182,8215,91021,109210,2222,38583,52579
49461,3874,70389,85114,2524,76340,98652,1350,47818,57402
49460,3039,74742,103921,2448,80179,109315,591,52420,67597
49459,558,44286,50209,393,50089,54366,165,22083,35632
49458,64,50435,44538,32,50781,44225,32,44167,42153
49457,3831,63623,71314,2995,64925,76520,836,33958,47431
49456,8742,63734,87524,5879,81499,104141,2863,34599,50615
49455,1789,48750,65650,1306,56836,73466,483,31250,38031
49454,1816,49492,67612,1264,59107,78487,552,31724,36327
49453,1326,80926,100857,877,84904,106983,449,56250,83400
49452,776,48625,59743,545,56250,65281,231,35224,35408
49451,2222,61410,74032,1681,70905,83414,541,35560,40688
49450,1030,40681,55126,770,42106,62834,260,0,22089
49449,1192,63841,77821,913,69256,87260,279,31193,39759
49448,1491,69351,82795,1038,85534,97624,453,46625,45866
49446,875,62850,77873,647,76953,91492,228,24620,34660
49445,8365,68638,86376,6180,81691,98205,2185,34708,47709
49444,10157,42670,60839,7032,48639,66305,3125,24141,41291
49442,15397,41433,51796,9601,49901,59196,5796,25303,34936
49441,14531,55462,71456,9059,68860,84033,5472,35011,47459
49440,627,17049,26539,97,55875,57227,530,14952,20923
49437,2639,64776,75505,1919,68935,84806,720,37331,45841
49436,771,51326,56980,531,56534,64644,240,0,36218
49435,1319,80710,90285,1067,84355,100131,252,40714,45796
49434,0,0,0,0,0,0,0,0,0
49431,7589,52578,70258,4652,67574,84564,2937,27040,45038
49428,10348,76610,88208,7774,88889,100136,2574,36485,46869
49426,12545,90420,108522,10456,98633,119313,2089,42329,50780
49425,1383,51061,58020,998,52885,61309,385,44450,44883
49424,17553,70411,94792,12985,85281,108763,4568,41885,51647
49423,17117,62361,78771,10803,79169,95798,6314,33750,46161
49421,2202,45709,54435,1567,51537,61310,635,28792,34825
49420,2442,49309,63869,1622,58355,75349,820,23229,35740
49419,3024,75685,88503,2464,84052,94838,560,45962,55389
49418,11253,71031,90315,7894,88417,104350,3359,37054,48649
49417,12855,70417,87170,9003,85754,99278,3852,41178,55370
49415,2755,73153,99600,2096,79611,98232,659,41875,102490
49412,4481,53891,64058,3229,61582,73135,1252,26071,36702
49411,689,52361,59133,441,72039,71972,248,24119,35105
49410,756,40250,54107,498,50556,61121,258,28000,37093
49408,3908,60082,83950,2752,73474,88744,1156,27424,54605
49406,394,81667,103550,194,110000,120663,200,67083,86755
49405,590,53611,62606,424,64286,70640,166,34167,34758
49404,2969,72676,87755,2255,82996,93582,714,35000,61252
49403,980,69357,94881,764,83500,103935,216,42500,52253
49402,563,41065,57307,336,57917,70839,227,22981,36778
49401,7115,59271,68934,3749,82996,91174,3366,26964,37692
49349,3018,42270,59397,1973,53087,68191,1045,24212,40620
49348,4775,67489,77142,3438,72417,83136,1337,33795,51758
49347,603,69201,72665,471,80202,80811,132,40000,41082
49346,2048,61916,77987,1575,71017,85734,473,38224,49955
49345,5093,73478,89268,3858,77940,92881,1235,38250,62082
49344,1605,66719,78711,1181,74754,84720,424,50449,56774
49343,2139,64654,75759,1579,74692,83293,560,28286,46323
49342,604,57596,62499,398,57596,62732,206,33571,55354
49341,13840,99054,119164,11368,107159,128821,2472,45313,70303
49340,985,47422,57209,688,61842,66656,297,18859,31508
49339,814,59817,70313,646,65357,73724,168,42045,45692
49338,694,44875,62105,374,66250,75732,320,22333,45275
49337,5022,50338,67085,3254,58421,78668,1768,29451,43303
49336,1494,44980,59068,1040,55000,65003,454,31346,40509
49335,120,54783,67228,74,71188,76196,46,0,0
49333,4287,80291,92099,3261,89781,103401,1026,44178,49698
49332,1347,48207,57497,894,56207,66916,453,24297,35179
49331,6773,81973,92419,5183,88350,102307,1590,38000,54754
49330,1852,70787,77044,1530,71563,80951,322,39231,49235
49329,3284,61063,70144,2334,69470,78667,950,40000,45793
49328,1574,70042,73255,1036,78220,86357,538,42759,46688
49327,3321,57455,65440,2513,63845,72410,808,29351,37364
49326,1507,60352,89432,1212,62656,97971,295,38203,47812
49325,731,74836,77259,569,76250,78113,162,41563,58431
49323,3549,81037,85608,2828,83276,88886,721,49173,70646
49322,498,48333,55224,297,66964,76006,201,16125,22820
49321,6385,61293,74134,4117,76278,86205,2268,39034,47669
49320,14,50000,69829,0,0,0,14,50000,69829
49319,7194,66031,75710,4882,81599,89837,2312,30407,39807
49318,507,52117,73197,373,66250,83180,134,34048,43343
49316,8470,86067,105121,6755,95836,117066,1715,43083,54385
49315,8293,87113,113884,6260,98806,126007,2033,46755,73579
49312,128,40500,46066,76,45833,50317,52,0,36300
49310,1006,51875,61125,680,61389,70692,326,28750,35418
49309,740,34071,50952,391,49063,63356,349,23984,35844
49307,7655,41315,60435,4077,63716,81055,3578,26112,34133
49306,4163,85469,110319,3248,99632,128243,915,25048,45399
49305,1025,39926,54339,539,54219,63231,486,26587,43947
49304,1796,29674,43006,812,45463,54781,984,22895,32436
49303,321,62454,70636,227,68125,80742,94,21667,31720
49302,2948,96413,117570,2575,105417,125521,373,43750,60036
49301,6647,143221,201315,5895,153064,216787,752,55667,73480
49289,50,80357,59618,29,43661,45900,21,0,53281
49288,557,55521,56479,417,60594,61302,140,31375,37599
49287,897,63964,80927,693,73470,90782,204,34867,45729
49286,5770,66193,79909,4213,78163,89991,1557,37695,49125
49285,2540,61169,78068,1921,67188,85427,619,50156,52674
49284,1160,54648,63525,770,64744,73163,390,36912,41050
49283,1053,66815,72924,671,84028,92155,382,27109,35804
49282,176,0,99847,144,0,113782,32,0,37134
49279,340,59688,76513,233,84583,96113,107,26016,29521
49277,1406,66034,75539,958,75875,87665,448,44423,46544
49276,343,60729,70908,227,72386,82706,116,40577,47079
49274,1368,50132,61951,904,59545,73144,464,34737,37317
49272,1011,63651,87246,746,69444,98367,265,42321,52956
49271,810,45577,57257,559,58750,68547,251,28359,29647
49270,2025,74792,87616,1445,90434,102427,580,39318,45676
49269,2145,66262,80841,1591,69865,90814,554,43182,47327
49268,487,56964,69491,320,67917,81191,167,39018,42897
49267,1489,82639,95345,1215,83322,103217,274,49167,52959
49266,1283,55219,62349,870,71667,73255,413,25781,36537
49265,2218,69079,91261,1515,86910,108054,703,36395,51412
49264,626,72667,81217,480,82222,84416,146,46379,62441
49263,19,0,0,19,0,0,0,0,0
49262,522,40962,59716,335,51875,71127,187,26375,34938
49261,84,0,80506,84,0,80377,0,0,0
49259,1065,46739,59177,724,47429,62031,341,32232,51350
49256,1546,46100,61005,1034,53263,65427,512,29079,46229
49255,718,44444,54573,549,58580,59922,169,23281,34166
49254,1682,61741,86235,840,100572,94016,842,33295,77816
49253,1265,71146,92682,895,80899,110219,370,31512,47190
49252,1066,44385,53232,638,50167,57360,428,35000,42443
49251,2360,74545,80149,1842,82100,88033,518,33190,46180
49250,2404,51545,64140,1665,60972,72271,739,28463,42037
49249,1404,68043,84144,1037,71058,94586,367,53958,53647
49248,337,61250,68210,217,63250,74432,120,48333,55559
49247,2351,51393,65022,1478,62661,76789,873,34201,42833
49246,1133,63363,77944,855,76705,89852,278,34423,40249
49245,1693,52808,66662,1243,57188,74675,450,35114,39790
49242,5689,48511,62354,3315,62670,76362,2374,29871,40738
49241,1122,75147,83064,822,90833,95549,300,28929,43329
49240,3812,85278,93035,2852,91560,102111,960,51513,60041
49238,690,68611,80521,549,77083,89328,141,29583,41251
49237,1085,59803,72788,824,65300,80608,261,34792,42331
49236,1835,69632,84248,1275,83438,93262,560,42292,57224
49235,831,50216,67599,523,68393,82319,308,31875,40744
49234,1100,82250,105757,832,89286,107917,268,44712,86503
49233,1131,67176,84778,839,83897,97910,292,29457,45578
49232,969,48681,58140,741,53594,63971,228,31364,37514
49230,4472,69589,98003,3016,87785,122551,1456,34449,42440
49229,1170,82500,93203,899,95724,101962,271,40750,60083
49228,2110,61130,72424,1562,65714,79782,548,37083,45248
49227,453,49676,62437,258,61250,75948,195,34531,41300
49224,4805,45387,58434,3238,48346,64595,1567,33301,41568
49221,15238,48447,64404,9411,60466,77091,5827,29676,38953
49220,1035,50994,60294,713,67726,67127,322,31170,35358
49203,15694,47056,61382,9695,57904,74125,5999,29789,37556
49202,9041,37032,52565,4492,47923,57922,4549,27348,45228
49201,15397,62370,75460,10151,70273,86834,5246,33028,49918
49130,528,67949,103257,400,72500,121920,128,34712,41547
49129,294,89924,129078,163,102917,151040,131,89107,101750
49128,1423,65931,84725,956,76447,83796,467,36719,82628
49127,4377,78604,98928,3147,91484,115643,1230,41284,51808
49126,483,42340,60956,345,56964,66227,138,37738,46971
49125,986,67031,82954,688,77018,102215,298,24840,31157
49120,14611,52998,73667,9515,66458,85876,5096,31622,46987
49119,28,65357,57761,21,0,55295,7,0,0
49117,1852,55147,97638,1084,85455,133250,768,36190,47006
49116,88,115357,248845,63,92031,194189,25,0,380520
49115,183,54659,104477,105,0,147729,78,52803,46254
49113,797,50625,64326,504,56750,74835,293,40625,45163
49112,4235,65139,83844,2962,78125,91162,1273,37923,60888
49111,1317,59494,67851,921,65977,78808,396,32222,39649
49107,4086,55139,64643,2704,59409,74505,1382,34211,43427
49106,1983,72180,79835,1417,90809,93480,566,29250,42185
49104,0,0,0,0,0,0,0,0,0
49103,3823,51489,71397,2545,66142,87995,1278,25488,36754
49102,752,57188,70452,621,78144,79983,131,22917,22365
49101,1247,56395,81190,820,78077,96181,427,36932,48427
49099,2505,50135,62466,1554,65100,73934,951,29889,41920
49098,2338,49105,60185,1659,58168,66149,679,31005,39808
49097,4579,67219,89398,3441,85401,103659,1138,36897,44955
49096,1204,62917,77382,890,70167,76607,314,32941,74825
49095,911,76510,104286,730,84375,114605,181,42917,54703
49094,1465,49850,69756,1045,54855,75350,420,32750,51482
49093,7567,53243,69989,4992,59745,80745,2575,30916,43040
49092,754,57188,67303,552,66204,74936,202,27212,41267
49091,7874,51167,64822,5230,59350,73669,2644,32091,41718
49090,6163,48732,80047,3796,70077,102033,2367,30795,44053
49089,691,49735,60505,480,59355,63474,211,32067,43878
49088,1446,88786,93622,1094,98083,105950,352,36250,49934
49087,2250,88947,104051,1789,104479,114586,461,37250,61206
49085,9983,80012,101267,6441,100508,120731,3542,38996,63530
49084,0,0,0,0,0,0,0,0,0
49083,3121,93872,114046,2479,100444,126525,642,43043,64666
49082,2457,55757,66380,1648,66075,75612,809,40885,43718
49080,6225,67832,80268,4475,78670,93071,1750,30304,43856
49079,5068,66521,78054,3806,75850,86788,1262,31300,44236
49078,3689,57797,72252,2708,68500,81866,981,32268,39088
49076,1435,58958,73909,986,73269,88772,449,32933,38146
49075,75,57841,63652,37,0,60032,38,59091,66792
49074,62,0,23153,11,0,0,51,16771,21953
49073,2098,41528,54473,1288,58000,70078,810,20275,26302
49072,1113,56629,67088,750,69211,76452,363,38813,41915
49071,3904,89301,103052,3313,97309,110827,591,41250,53680
49070,952,60278,77490,676,66750,88932,276,41667,46155
49068,6556,66086,85078,4140,84912,106620,2416,37480,43797
49067,1684,57807,71876,1182,61944,80391,502,36071,45275
49066,206,51136,56590,122,65000,73893,84,30625,31460
49065,2628,61694,72800,1802,74118,83727,826,43143,43097
49064,1365,67656,73647,997,78319,83949,368,35156,43493
49061,648,64828,75423,493,64267,73088,155,65156,68875
49060,989,113068,327215,747,0,400739,242,44375,100262
49058,7706,59183,77911,5058,74048,92980,2648,36506,46772
49057,2357,40243,56438,1731,50625,63642,626,24261,33241
49056,1220,45511,60447,853,52067,70663,367,28309,33863
49055,2439,59583,70425,1801,72382,80765,638,29167,38032
49053,2754,64420,90982,2035,82326,103218,719,35331,45172
49052,362,51000,65647,266,66667,72663,96,29375,39507
49051,949,84525,104746,723,114844,119561,226,0,52962
49050,590,65357,78243,444,72417,86817,146,32414,52107
49048,9537,48799,65886,5789,56387,69562,3748,34086,46715
49047,6370,48395,68536,3882,56339,74439,2488,32156,54593
49046,3145,75870,86540,2205,85480,100957,940,33750,48866
49045,2413,48318,68981,1565,55809,78665,848,28554,48525
49043,933,27165,38391,625,27039,39510,308,26892,31921
49042,1936,60126,67538,1388,64865,75316,548,36071,39748
49040,1212,52692,77418,808,70667,94018,404,25641,41393
49038,3432,57174,74993,2361,63207,81831,1071,48413,56382
49037,9048,34525,47000,4497,49542,56192,4551,22556,33872
49036,9274,51132,65507,5796,60520,78046,3478,31627,41587
49034,998,61278,77380,727,65298,87263,271,41625,47807
49033,670,77500,88128,497,82159,96627,173,49735,58514
49032,1128,58750,70376,811,64693,84020,317,25605,31466
49031,3308,56530,83663,2368,76538,99991,940,28962,34974
49030,911,56650,58672,658,62098,67461,253,31181,33521
49029,566,60375,73743,410,67407,84255,156,38125,45777
49028,2360,54709,63566,1625,63542,72002,735,34010,40635
49027,97,44375,57231,72,0,63467,25,23958,28156
49026,856,44875,55364,519,62462,66985,337,23819,34414
49024,12113,69124,92684,8012,90034,110368,4101,40632,54741
49022,13360,32299,47673,7776,40471,56852,5584,21464,32600
49021,2293,65196,76448,1681,76582,89894,612,26458,35740
49017,8918,47868,64349,5182,65354,79738,3736,30860,40291
49015,10996,56164,75564,6918,74806,90634,4078,32326,45363
49014,8546,54105,66120,5511,64960,78283,3035,30156,41159
49013,1933,53092,61438,1386,65333,69422,547,27697,36568
49012,1285,72861,86724,909,86701,96572,376,39000,52235
49011,866,50795,61865,633,57958,70389,233,26313,34066
49010,6465,56158,68398,4636,64586,74926,1829,32940,45677
49009,18548,73278,101065,12183,99685,126108,6365,34345,50024
49008,6558,56204,83079,3323,79486,117530,3235,39989,46657
49007,4269,34033,46209,1653,34732,48043,2616,25170,41022
49006,10443,39240,60008,3255,61918,77257,7188,29382,50610
49004,6830,59595,72050,4441,71056,80731,2389,43594,51851
49002,8359,63177,82771,4782,86827,105407,3577,41307,50232
49001,9090,46124,58739,5085,55662,67244,4005,34861,41837
48933,1570,31131,42286,247,34464,53247,1323,29551,39985
48921,0,0,0,0,0,0,0,0,0
48917,15219,63942,77381,8407,80502,97674,6812,43996,50624
48915,4069,43237,51219,2414,57893,57354,1655,32787,40009
48912,7926,46443,58784,3135,56399,69959,4791,40034,48805
48911,16362,47225,58062,9342,57548,67958,7020,39751,43252
48910,15476,43498,54273,7286,56603,64978,8190,35312,42928
48906,10813,49310,62363,6183,57560,70175,4630,37589,47865
48897,603,69583,85514,464,80875,100205,139,24408,34080
48896,97,30938,59538,72,0,69919,25,16875,18580
48895,4572,105302,125620,3113,129085,147436,1459,49250,76741
48894,633,80208,89047,488,97083,100964,145,45298,47212
48893,1988,60060,71760,1421,63838,79213,567,36424,48850
48892,1795,72554,95797,1384,80862,109961,411,29609,42120
48891,1187,52841,61802,789,60781,73014,398,27969,38010
48890,762,58426,63336,583,65781,68848,179,30893,38327
48889,598,50156,74268,387,65938,98310,211,23750,27469
48888,2590,49683,60561,1692,54848,66947,898,34038,47061
48886,759,54441,63784,503,69375,72253,256,30735,45133
48885,390,57500,68729,287,58646,73068,103,54861,56640
48884,1789,54089,75824,1371,61298,78487,418,28125,62388
48883,2748,57663,67079,1962,66111,73309,786,30875,45620
48881,2086,66441,74921,1423,79317,83616,663,35144,51095
48880,2508,47864,65718,1789,56497,79214,719,24566,30566
48879,6696,72274,82508,4787,83942,95163,1909,36042,44765
48878,692,45156,55581,457,50733,63651,235,32443,39550
48877,821,48009,85124,624,59605,100240,197,24861,29743
48876,1639,63151,71848,1105,77420,86394,534,32222,37787
48875,4117,74885,85378,3094,85471,94653,1023,43594,49500
48874,63,61736,58995,23,0,0,40,60139,53850
48873,480,78516,92785,359,93229,111569,121,31016,34427
48872,2526,72665,81128,1809,85777,90964,717,42470,51067
48871,767,72724,98346,607,78036,110450,160,34750,39804
48870,90,29881,40726,84,29821,40132,6,0,41017
48867,11478,46916,64104,6959,63171,80608,4519,27606,35779
48866,1747,62220,70056,1201,67769,77835,546,39489,50310
48865,736,52571,74370,522,69000,79999,214,28125,56332
48864,9366,86282,121615,5902,118238,154301,3464,45950,63267
48861,695,77639,95913,558,89667,107090,137,35938,41262
48860,633,57589,66518,425,68750,75222,208,38226,44800
48858,17476,42102,62296,8759,62310,83452,8717,25680,39196
48857,1191,71503,77238,893,74375,82618,298,40625,59942
48856,345,48672,62627,224,64500,75987,121,41875,37744
48855,5669,82515,93760,4123,94819,108340,1546,40385,53316
48854,7251,73591,90764,5116,82130,102143,2135,48976,59649
48853,241,43942,52368,179,51250,57304,62,31765,37045
48852,63,30625,35173,35,35625,41540,28,19375,23754
48851,870,56250,66671,553,60670,78910,317,32271,43313
48850,1622,52394,64092,1199,55264,70628,423,26161,35956
48849,2257,65413,74136,1611,74566,83736,646,30804,43675
48848,2867,78086,104544,2237,84159,108189,630,51250,81653
48847,2282,53609,67463,1546,62245,80036,736,27477,38912
48846,6689,52983,61632,4108,61134,69721,2581,35795,45193
48845,293,49896,68796,193,62188,82495,100,38750,39885
48843,17412,78923,94393,11710,100287,113344,5702,41679,51691
48842,9227,68776,82034,5294,90610,103303,3933,42132,50299
48841,305,66875,77837,226,70000,81576,79,63750,60501
48840,5989,65809,89909,3173,101721,120230,2816,40420,52577
48838,7245,52861,66508,4622,61649,77284,2623,31353,44114
48837,8490,78898,102894,5626,89589,119727,2864,49848,65724
48836,4910,69909,80603,3689,75883,86138,1221,39688,56449
48835,1117,68839,83201,872,88889,94613,245,32614,37148
48834,736,52105,58525,509,54821,63171,227,33542,46183
48832,533,58672,70978,395,61042,71930,138,55000,60715
48831,1407,51215,64640,879,63450,76843,528,43300,42055
48829,1256,44146,54669,793,54677,61265,463,30193,31312
48827,6217,65287,77572,4290,80341,91089,1927,40348,45339
48825,0,0,0,0,0,0,0,0,0
48823,19555,46993,85100,7953,106643,142424,11602,26470,44347
48822,934,79107,94396,699,90446,105696,235,47031,52674
48821,2581,80101,91112,1693,96250,110166,888,35345,51826
48820,6537,88325,109738,5011,104147,124584,1526,42798,55491
48819,909,74792,78398,723,80134,85251,186,43333,46789
48818,1037,48450,57909,639,65301,75356,398,16090,28474
48817,2453,54496,66181,1514,70700,83211,939,27471,37190
48816,189,41357,45814,16,0,75044,173,0,0
48815,859,71065,89479,659,77188,94581,200,41875,70742
48813,7838,66510,80566,5583,76384,90450,2255,40038,50199
48811,1229,47337,68582,785,65069,87281,444,24091,34233
48809,4108,57276,68832,3111,67448,76100,997,33750,43225
48808,3108,65351,96132,1897,89979,120370,1211,45120,49797
48807,374,51713,69526,291,53438,76661,83,31406,43301
48806,675,45240,57500,476,56136,66710,199,27708,32561
48801,5331,43400,58226,3094,55633,72584,2237,29759,35408
48770,697,41875,52449,445,53068,63210,252,21833,31281
48768,3742,50793,59564,2617,58862,68599,1125,25216,31822
48767,970,62024,71005,679,67218,81459,291,32813,42508
48766,552,43333,52024,378,49167,53277,174,39722,47490
48765,321,40625,47658,181,50625,57049,140,30000,34226
48763,1984,54153,67531,1353,64073,78292,631,35288,41517
48762,497,44875,59688,323,55375,63540,174,20417,51268
48761,451,37301,46108,302,50417,54002,149,24063,26528
48760,624,49545,60417,385,61523,72486,239,34330,40545
48759,1458,51250,61260,881,64201,71928,577,31185,39613
48757,1609,63942,88550,1124,79667,108647,485,38110,41390
48756,1964,34331,42402,1163,46436,51251,801,22204,27337
48755,1283,52583,69861,816,66574,83689,467,33618,44164
48754,381,62250,73065,265,66250,82982,116,0,43680
48750,4243,41152,47530,2347,45451,55598,1896,26538,34957
48749,471,47396,64714,279,63047,79526,192,39722,42321
48748,728,38854,49083,456,47917,54001,272,30909,38734
48747,522,68871,85449,397,81458,99672,125,31042,39476
48746,3325,56462,65471,2452,67625,74907,873,32868,35808
48745,599,38563,51892,387,58977,64409,212,18929,28456
48744,1850,45000,62919,1042,58333,76993,808,40772,43150
48743,30,25000,19913,10,0,0,20,0,0
48742,777,45281,55943,474,50357,62137,303,37917,44683
48741,788,49773,57024,595,54125,60809,193,35446,40947
48740,1202,45985,58887,775,56875,69407,427,25184,36831
48739,1976,40672,50429,1233,54152,60543,743,24991,32248
48738,569,48672,53851,333,60817,63728,236,35625,39736
48737,593,36319,43563,349,42917,50759,244,25893,31475
48735,447,53050,66566,276,62857,80537,171,36302,40399
48734,3442,79130,101599,2045,107425,136287,1397,38413,49946
48733,676,45543,58623,421,57679,74724,255,27604,29489
48732,5069,44036,65353,2815,63692,85329,2254,24710,38256
48731,670,44688,57099,413,59750,71133,257,22946,32618
48730,2387,42062,56398,1277,54176,67577,1110,33197,40434
48729,589,48542,62251,397,61477,72499,192,28750,41061
48728,158,41071,57187,86,60000,78997,72,26250,31138
48727,392,49375,64090,256,58864,73030,136,30500,37671
48726,2212,51742,64884,1465,63920,76863,747,29089,39128
48725,1089,48750,62192,590,65192,78496,499,27989,42080
48724,360,26222,40018,330,25000,21058,30,0,0
48723,4967,49118,63820,2873,66779,80432,2094,27740,39711
48722,1248,54777,71914,785,66492,89173,463,34671,40088
48721,224,48281,49951,122,42308,53516,102,38750,42034
48720,439,40114,56702,284,60417,71928,155,23068,28101
48710,0,0,0,0,0,0,0,0,0
48708,11166,40456,55189,6306,52723,65619,4860,26690,38014
48706,16830,48169,64946,10693,61904,77240,6137,31532,39189
48705,222,37083,45702,110,53750,55958,112,29250,34708
48703,1472,45541,60403,866,61061,75943,606,32396,37682
48701,517,47132,68948,292,58333,88028,225,28438,39045
48667,0,0,0,0,0,0,0,0,0
48662,632,58125,75614,482,66429,71883,150,50000,86022
48661,4573,46621,61977,3016,56816,74302,1557,27022,33704
48659,1039,51477,56835,756,58250,63283,283,25208,37854
48658,2059,39223,56552,1185,60673,73682,874,24734,30496
48657,3326,60181,74241,2376,75891,86557,950,27052,40534
48656,1860,36117,42912,1067,40785,45898,793,31294,35090
48655,2321,59306,72046,1661,68365,80936,660,35893,47552
48654,1028,40313,50637,617,49219,60417,411,24049,33773
48653,4785,51292,66408,2975,62057,80009,1810,32738,41087
48652,695,61080,76361,538,72857,85103,157,37917,39093
48651,2244,35764,57502,1265,43153,62081,979,31023,50283
48650,2970,55174,62819,2030,66734,71992,940,33043,39346
48649,462,54375,66594,353,60221,71081,109,29583,36960
48647,1775,43313,57564,1084,51840,65676,691,24639,41149
48642,13898,68508,95272,8996,90823,118101,4902,36087,51395
48640,13007,65451,87902,8853,77756,103308,4154,34433,50731
48638,5607,52651,72529,3020,75300,95550,2587,36832,44336
48637,1287,55938,73507,910,65400,86121,377,29922,39326
48636,468,47917,50840,336,57969,58785,132,23125,25288
48635,739,42218,55793,464,57679,69978,275,23902,29761
48634,1876,65750,77558,1344,79342,85863,532,40588,51657
48633,48,0,76463,26,105769,103569,22,0,44427
48632,2151,38594,52915,1344,45816,60677,807,25858,36614
48631,1798,56864,70730,1246,70375,83060,552,29786,40775
48630,21,0,0,21,0,0,0,0,0
48629,3693,43470,50310,2209,54583,57566,1484,27314,37913
48628,898,65526,82640,665,76066,93365,233,38565,45641
48627,37,41250,43122,21,68125,54329,16,20938,26769
48626,2262,66940,83497,1618,89286,98314,644,35417,44534
48625,5380,35233,47343,3410,44625,53106,1970,19753,33915
48624,6819,45776,59301,4430,54530,68165,2389,28033,40007
48623,4799,74756,96100,3413,98887,116499,1386,41009,44256
48622,2365,52399,58795,1661,57036,65820,704,30917,39823
48621,490,49808,55690,283,62875,72078,207,26681,31316
48619,262,39662,50709,162,51333,61265,100,37778,33577
48618,2147,49784,60057,1378,57949,67289,769,27480,42879
48617,3335,50615,70922,2320,68799,83893,1015,29116,39207
48616,2918,51612,66252,1991,59637,74754,927,38438,42029
48615,1109,55052,65657,759,69306,76529,350,31328,38732
48614,502,44118,55785,364,53125,63047,138,23250,29433
48613,393,39554,53551,248,49048,61484,145,33262,36841
48612,3887,45233,59160,2420,53704,69284,1467,25150,40760
48611,2637,64242,71669,1721,71663,83883,916,35500,46250
48610,1355,44406,54881,830,50357,62859,525,29044,38744
48609,5318,70314,89227,3672,87417,109127,1646,33125,42125
48607,700,34650,45629,179,58958,76553,521,26023,35004
48604,4251,45488,57196,2559,63792,70174,1692,34297,36404
48603,11911,56118,88783,7416,76667,111481,4495,34703,48225
48602,12262,36643,49724,6718,45615,57186,5544,25282,37258
48601,14133,31391,40508,8562,39474,47223,5571,21849,28310
48554,0,0,0,0,0,0,0,0,0
48553,0,0,0,0,0,0,0,0,0
48551,0,0,0,0,0,0,0,0,0
48532,8563,42516,58368,5311,45157,65223,3252,33066,43092
48529,3813,31089,44723,2171,34830,48503,1642,19720,35407
48519,3150,47857,61455,1818,61038,74201,1332,26364,39869
48509,4006,58849,68370,2490,70952,80593,1516,35898,45456
48507,13675,38231,48326,8140,49862,54426,5535,29191,34945
48506,11454,37635,46577,7345,44177,52215,4109,26168,33404
48505,8276,27071,34401,4611,28512,37133,3665,18948,28964
48504,11190,35728,45201,6358,43387,54926,4832,24180,30158
48503,11481,30346,45566,6180,37934,55712,5301,23831,31308
48502,128,0,41138,24,0,43446,104,0,40604
48476,145,57679,71152,114,57857,74398,31,32083,44381
48475,1089,54375,64120,731,68875,74777,358,33750,40206
48473,9204,65945,80523,6401,73408,89982,2803,41315,54320
48472,692,51042,71309,488,65500,86251,204,35000,32114
48471,2510,48933,70669,1582,66458,85186,928,25417,41347
48470,302,48750,56972,195,63281,70401,107,23125,31455
48469,623,45541,72357,326,71346,102932,297,33882,37492
48468,568,48500,59840,362,68667,70647,206,28750,39598
48467,1235,50550,66033,630,76029,87821,605,28844,41767
48466,647,49485,59936,425,57011,67446,222,42917,43844
48465,258,47500,53526,178,55625,58566,80,33000,35946
48464,888,55286,61273,669,64063,68535,219,31380,37085
48463,1819,61106,69739,1415,68517,76074,404,36000,39024
48462,5068,89203,106194,3868,98136,114309,1200,56094,76756
48461,3128,65786,84511,2376,67377,95491,752,41213,46366
48460,1008,73269,84016,709,79280,97651,299,32454,47279
48458,7930,40483,54082,5093,44495,62606,2837,26013,32926
48457,3324,53888,64253,2389,58624,71308,935,35491,43072
48456,317,56161,62045,215,62125,66237,102,45625,50928
48455,3182,83333,107858,2356,98446,120710,826,39688,66082
48454,482,49808,60261,341,56838,67058,141,37917,39558
48453,2161,43475,61232,1438,52348,70215,723,25922,41534
48451,5270,86385,101477,4154,101752,112429,1116,34412,48942
48450,2393,46836,59395,1304,61776,69124,1089,32060,41512
48449,1046,51971,66103,787,56620,70097,259,40313,41265
48446,12092,57311,72980,8116,72594,85454,3976,28449,42883
48445,472,44583,54888,336,57500,61653,136,26250,37693
48444,3753,60245,72939,2551,71696,82304,1202,28404,48843
48442,9079,68099,85689,5647,86495,107674,3432,36440,45214
48441,1681,49901,65526,1094,63636,81886,587,27426,34114
48440,58,0,391162,35,0,637917,23,0,0
48439,20339,78089,107182,13816,94310,122982,6523,42855,52157
48438,2523,96198,107561,2035,102104,112151,488,66591,79011
48437,264,28750,41165,164,39324,51548,100,23750,24137
48436,1465,81750,91749,1201,86677,99760,264,42083,44644
48435,727,61708,68922,575,75859,73608,152,46071,47024
48434,65,34250,45365,43,0,40563,22,40313,54750
48433,10131,68025,86763,7098,80259,99906,3033,41509,51446
48432,280,55278,67394,155,66250,82682,125,43594,46768
48430,14553,81278,107148,10143,98750,126490,4410,43945,57268
48429,3755,57459,71247,2712,68902,79766,1043,24576,43842
48428,2064,76514,94710,1607,77368,98943,457,48194,76242
48427,1144,52000,61415,801,57946,67296,343,31125,45391
48426,444,56667,70759,280,69722,79872,164,37083,52540
48423,14068,53871,71367,8437,71733,87352,5631,33750,45343
48422,2667,52293,62396,1803,66938,73490,864,29618,35712
48421,2437,58347,67433,1865,60947,73135,572,35125,43207
48420,8663,56082,73276,5819,70235,83884,2844,36561,45994
48419,986,52586,60971,693,60375,69345,293,32813,37451
48418,1515,72379,87843,1206,81071,92766,309,62083,62360
48417,1152,55962,74447,718,67917,95204,434,27039,36305
48416,1836,53229,68323,1316,58681,71045,520,29125,53521
48415,3624,64986,83207,2607,74715,97464,1017,27493,43776
48414,1131,65208,79602,758,86563,97682,373,26161,41232
48413,3062,48052,59425,1856,54342,71165,1206,32932,38451
48412,1988,68272,96879,1589,69583,96626,399,49073,90452
48411,28,0,0,0,0,0,28,0,0
48401,614,51667,63552,367,53417,65019,247,40417,59302
48397,0,0,0,0,0,0,0,0,0
48393,7345,57665,80406,4165,89770,106478,3180,33269,44428
48390,10536,75634,93536,6160,100250,112224,4376,49712,66098
48386,7398,79489,99457,5289,93855,113812,2109,39464,59363
48383,4622,84793,98376,3504,103000,111599,1118,45556,52544
48382,8299,113615,134172,6784,121833,143984,1515,54006,86411
48381,5487,87796,116537,3643,118750,144322,1844,42692,59180
48380,2771,115945,148913,2149,123520,167632,622,58750,79841
48377,8095,69701,93378,4118,88134,117413,3977,49803,67354
48375,9015,96316,126301,5862,113333,143227,3153,67067,92978
48374,5240,143517,186617,4526,161100,203204,714,55227,75282
48371,9256,95734,108620,6994,112019,121523,2262,42453,65189
48370,599,95074,137031,542,98804,147102,57,0,40682
48367,1642,91461,113690,1172,113182,136252,470,43750,55034
48363,2069,136317,174124,1728,147969,189812,341,37311,90498
48362,5996,95236,111998,4117,107454,132962,1879,50790,64903
48360,4570,113011,129165,3387,133164,147689,1183,60781,71818
48359,4167,83390,107952,2710,124038,135059,1457,37021,55524
48357,3000,81739,110190,2188,90921,126442,812,42500,60583
48356,3250,89182,102222,2375,96558,114795,875,49491,63574
48353,2750,77245,99426,1777,85325,111412,973,54792,75045
48350,2805,88970,104967,2186,96150,111770,619,52161,76242
48348,8680,112549,138773,6791,131601,155420,1889,46437,72416
48346,9225,82790,102960,6120,89722,116793,3105,49726,71496
48342,6359,31168,41150,3403,37119,50836,2956,19430,28420
48341,7217,34484,49077,3311,57726,64730,3906,26987,34553
48340,9989,39162,51562,5452,48687,59423,4537,27153,38894
48336,10890,66913,87739,6203,93887,110687,4687,39570,56261
48335,10865,82973,101345,6112,101415,123739,4753,55842,71972
48334,7848,81638,104918,4650,109118,126850,3198,46711,72522
48331,8953,102571,133076,5818,130965,166406,3135,51929,68387
48329,9818,75206,88853,6299,89768,105511,3519,43058,54659
48328,11694,56888,82290,6919,70870,101977,4775,38994,49534
48327,9365,60089,75490,5363,82020,94151,4002,39868,48388
48326,10146,69649,84282,5127,85428,103204,5019,50432,63077
48324,6516,122558,167077,5098,134141,184009,1418,56770,103355
48323,6051,115457,177400,4522,141189,202316,1529,62083,102099
48322,12564,95012,127732,8547,117360,150176,4017,53869,78970
48320,2359,66380,96794,1325,87599,125234,1034,35463,56019
48317,12107,65382,79739,7197,77842,96690,4910,41170,53257
48316,11397,87741,109610,8167,107950,128963,3230,44808,56298
48315,10899,88931,110536,7921,112719,131632,2978,33333,50266
48314,8619,65778,83340,4967,85466,103773,3652,44787,54718
48313,13587,72407,85092,9193,89975,101164,4394,39100,48380
48312,13624,63874,79462,8992,73007,90625,4632,40946,53185
48310,14686,64606,77012,11304,70303,82131,3382,45631,56498
48309,11184,103219,128727,7829,124109,156005,3355,44844,61647
48307,18039,85768,111260,11750,107727,137138,6289,49432,61147
48306,9522,155764,194530,8133,169016,210709,1389,65150,96585
48304,6309,129007,193877,4343,161896,236323,1966,62885,99363
48302,6014,134167,209294,4423,174929,253964,1591,56823,83044
48301,5617,147585,213167,4251,182547,257842,1366,49474,71833
48243,0,0,0,0,0,0,0,0,0
48242,0,0,0,0,0,0,0,0,0
48240,6708,56345,66928,4356,69683,74914,2352,38488,48901
48239,13620,60347,69600,8442,70852,79213,5178,41423,49765
48238,10368,27733,40738,5421,36436,49280,4947,19046,30258
48237,11884,54453,68125,6673,66781,80049,5211,39462,51228
48236,11576,118125,154826,8832,138245,180033,2744,49038,72813
48235,19559,35433,45633,10931,47543,56338,8628,23951,29969
48234,13325,31046,41349,7771,38709,47857,5554,19308,29884
48233,0,0,0,0,0,0,0,0,0
48230,6520,120948,170376,4684,152333,206784,1836,53587,72399
48229,3762,34278,46070,2050,45116,56716,1712,19280,31077
48228,21041,27833,40223,12593,32180,42675,8448,19566,32863
48227,15888,28769,39371,8493,38120,47073,7395,18487,27902
48226,4382,70812,90790,717,119306,164845,3665,59697,76303
48225,5281,50207,59888,3332,53969,67896,1949,36332,43161
48224,14333,35966,48405,9175,41671,53999,5158,27593,33229
48223,10088,36612,49825,5920,46621,57438,4168,30252,36547
48221,16279,43833,61717,9560,54457,73429,6719,30053,39637
48220,11313,73479,81658,4400,93012,100738,6913,54202,68302
48219,18766,38107,49255,10480,46781,57007,8286,25545,36434
48218,3231,22664,34961,1561,29732,41348,1670,18283,26588
48217,2855,37583,46344,1701,48420,55973,1154,20271,31463
48216,2548,36244,45256,930,44697,52449,1618,32262,39606
48215,4880,27903,50196,2265,43750,67360,2615,20042,34171
48214,10575,30859,50395,3784,49913,69480,6791,22464,38796
48213,8061,27726,38948,4750,30107,43900,3311,21811,29340
48212,10977,29224,39584,7696,31357,42182,3281,23158,32078
48211,1946,22971,31497,1011,23569,34404,935,20777,27053
48210,8966,33930,42659,5768,37970,46790,3198,26190,31144
48209,10078,32367,42124,6285,39383,47287,3793,18006,28243
48208,4525,20185,45193,1574,26923,45622,2951,17062,43869
48207,11739,33754,51704,3713,44205,67233,8026,31080,44136
48206,6648,30139,46137,3386,41398,59259,3262,14949,30789
48205,13663,37756,46212,7173,34264,46112,6490,32146,38460
48204,9642,24554,35881,5048,30294,40992,4594,19038,26123
48203,10049,26744,43975,4438,34444,55606,5611,17809,33616
48202,7855,28768,48513,2275,52813,80164,5580,23341,34421
48201,8719,20050,43017,2212,26747,51730,6507,17399,39697
48198,15791,51825,71426,8706,65090,87854,7085,38382,48658
48197,25615,62138,79696,13351,87719,101608,12264,41248,52837
48195,12454,59975,72575,7393,74133,86400,5061,37572,49864
48193,6464,60463,79834,4206,77981,95937,2258,31779,45744
48192,10799,54419,68487,6238,72054,80768,4561,34328,47054
48191,1565,82868,103785,1197,92663,118288,368,51875,54985
48190,61,0,0,61,0,0,0,0,0
48189,6127,70590,95473,3992,86100,102099,2135,41523,79393
48188,15723,103009,123153,11955,120515,138079,3768,55000,69688
48187,18962,95133,112364,13779,112507,130315,5183,45690,61097
48186,13352,56341,69158,8609,65119,76914,4743,39017,51630
48185,21601,49745,62545,11313,70820,79036,10288,31828,41705
48184,6796,47823,62459,4315,53777,70560,2481,36189,41291
48183,17837,68431,85397,11217,86255,102491,6620,35857,53409
48182,8787,74310,89271,6095,91099,103855,2692,36741,53613
48180,25005,52872,63348,15964,61398,71653,9041,36651,44582
48179,1468,86773,119760,1018,92206,130600,450,60200,90130
48178,12933,108693,135976,9695,137917,161688,3238,41324,56587
48177,61,71750,67851,41,71450,70698,20,0,0
48176,8460,101218,125425,6347,124720,145382,2113,47552,63472
48174,11808,56359,67381,7839,67288,76804,3969,32375,46094
48173,4881,80487,88964,3507,91588,99263,1374,44250,56842
48170,17282,89850,119613,11199,117934,145909,6083,50285,70094
48169,8413,86534,100803,6071,96943,112900,2342,49798,65921
48168,8486,144143,183828,6632,174720,212835,1854,50846,65942
48167,9391,104079,163135,5592,128929,175089,3799,66815,142718
48166,4411,62868,85279,3005,76027,97920,1406,40849,53418
48165,2917,79990,103513,2237,93713,113843,680,60167,66376
48164,3133,97688,120575,2392,113433,134410,741,44926,71966
48162,11506,60651,73829,7210,76058,87352,4296,32287,47019
48161,11372,53982,68124,7122,70718,84158,4250,31816,39820
48160,4998,79830,93780,3403,88023,107544,1595,50979,60750
48159,921,64083,77640,688,73810,89539,233,32305,38811
48158,3209,80981,95213,2238,97778,112580,971,33885,53914
48157,584,37031,54460,260,57500,62506,324,28750,47009
48154,14671,87853,103589,10456,100599,116008,4215,51817,70510
48152,12612,76138,93981,8082,99309,115498,4530,41538,54346
48150,10367,81011,90829,7240,94214,102502,3127,51334,61499
48146,14734,47094,58511,8330,57220,70073,6404,32278,40765
48145,1353,71543,86925,925,77450,103215,428,33250,47448
48144,3785,80343,97800,2775,98838,108716,1010,51750,67301
48143,12,0,0,12,0,0,0,0,0
48141,8953,32109,47081,5554,41344,53873,3399,23076,32796
48140,1307,83201,94726,995,87625,98481,312,68333,66552
48139,69,47396,51503,44,51250,52884,25,0,0
48138,4103,112159,144382,3180,133158,160869,923,56995,84266
48137,1940,66207,75311,1473,76820,86892,467,26995,35509
48135,11007,57011,66942,7035,68815,77305,3972,36385,45310
48134,8431,77933,88425,6167,88818,97374,2264,41123,57824
48133,2093,51767,64513,1450,61898,75800,643,31318,34002
48131,3054,71474,83636,1963,91740,99706,1091,50576,50921
48130,5949,116349,139537,4520,137639,161102,1429,66590,70554
48128,4031,86198,95939,2799,94086,105747,1232,57853,66124
48127,12614,51928,72443,8461,60757,83513,4153,35270,47495
48126,13492,40262,55925,9672,44184,62481,3820,27653,37511
48125,7600,50031,62561,5047,54639,70060,2553,34548,42279
48124,11888,72806,87758,6911,89120,105391,4977,52285,61795
48122,3923,37438,54354,2132,51250,68354,1791,19700,34742
48120,2386,46500,82877,1426,58125,90870,960,34688,69460
48118,5403,82529,112398,3480,114432,139547,1923,45162,61766
48117,4291,68287,84610,2774,77600,92483,1517,55739,67862
48116,11152,88825,114617,7741,110380,135512,3411,49179,65354
48114,7982,98648,127152,6084,111104,141214,1898,42756,74833
48111,17187,61628,81240,10488,75732,96618,6699,42192,53824
48109,5,0,0,0,0,0,5,0,0
48108,11668,68160,97435,6548,98735,126421,5120,48085,59686
48105,14698,80437,121381,7376,131583,175880,7322,48269,66028
48104,16711,55597,101891,5803,135299,182094,10908,34930,56996
48103,23383,101141,133740,14032,132061,166633,9351,65719,82173
48101,11368,69331,85617,7336,86644,101955,4032,41843,50493
48098,7050,142446,175282,5781,158125,193948,1269,51218,86519
48097,2253,48854,61782,1473,59183,68948,780,32653,43856
48096,1761,92366,100311,1113,116048,119437,648,51727,67452
48095,2076,109000,127642,1655,124629,141143,421,36086,73486
48094,7875,87357,110707,5737,106417,125927,2138,50795,67700
48093,10000,56288,74309,6000,75329,87387,4000,36503,52677
48092,10058,58697,73174,6874,69831,82033,3184,42302,52504
48091,11126,43894,55791,6881,50044,59364,4245,29686,47359
48089,12250,41388,53877,7506,46162,57645,4744,29960,43954
48088,8994,68802,78548,6070,82663,86559,2924,40773,54821
48085,8747,118363,133558,7056,129915,146933,1691,49491,74032
48084,6494,98218,119584,4243,119481,140699,2251,68463,79703
48083,9364,79035,95226,5556,99833,117413,3808,42351,61292
48082,7209,64527,84917,4347,79820,104047,2862,39167,52366
48081,8967,64733,81221,5613,81665,97193,3354,36722,52212
48080,10850,60892,71991,5511,82188,89853,5339,41647,51297
48079,4803,82790,100147,3589,90903,115920,1214,34623,47728
48076,9403,72290,91398,5973,91323,109945,3430,46589,56239
48075,9126,58276,71377,5114,74443,87497,4012,39388,48871
48074,3618,56012,70505,2561,64957,73741,1057,35799,56883
48073,16365,78279,93683,7919,106498,120071,8446,58976,67676
48072,6960,93038,104642,3863,106671,124732,3097,74434,77896
48071,13824,54668,68804,6931,64563,81110,6893,43434,53554
48070,2339,150114,179658,1832,158750,195833,507,85469,118431
48069,1105,123155,160051,655,170341,198890,450,84063,103518
48067,12617,89538,116142,5177,121748,152731,7440,71165,90010
48066,20622,49434,60818,11950,60881,71159,8672,32321,42601
48065,4792,70588,100684,3081,100321,122464,1711,26484,59385
48064,1490,71087,90620,1124,81328,99398,366,31538,59146
48063,1564,87784,90335,1086,97353,104783,478,42083,51422
48062,3386,64620,82154,2365,86509,94610,1021,36055,48388
48060,16462,42535,58507,10008,52949,66535,6454,27160,41598
48059,6054,67230,89775,4093,77845,104640,1961,35509,52647
48054,3016,59761,85044,2189,75444,100592,827,30850,38472
48051,6183,79335,95673,4713,90944,102998,1470,40298,62532
48050,540,84318,100504,403,98523,106152,137,56806,79147
48049,2219,72961,93571,1567,88583,105459,652,44572,59598
48048,2840,58333,67829,1975,62286,72763,865,48220,50433
48047,16505,78270,91764,11274,96055,106997,5231,38081,52647
48045,11846,67225,85059,6715,88139,107200,5131,42216,54646
48044,19500,99925,115018,15485,110689,125875,4015,57879,68794
48043,6805,47528,62143,3678,63500,73310,3127,29242,45903
48042,11240,109364,115115,8626,128119,130209,2614,53155,62646
48041,1666,81591,94060,1232,97045,107649,434,34722,52301
48040,4378,52906,69914,2781,73051,85529,1597,28794,36249
48039,3406,53414,67015,2106,64781,73955,1300,39974,53635
48038,20346,65833,80876,11306,83599,101472,9040,40516,52607
48036,8887,54783,69816,5294,70361,85252,3593,37813,44980
48035,14844,57061,73978,9437,62626,85282,5407,38084,47525
48034,7268,50672,70976,2980,73135,88461,4288,41303,58029
48033,7624,51951,68415,3993,69594,84685,3631,41123,47169
48032,756,73750,85509,557,85673,94944,199,51875,56550
48030,7147,43725,52483,3703,55634,61522,3444,27904,40370
48028,556,68553,98629,343,73897,94302,213,48558,104704
48027,1229,70764,87419,953,86139,98364,276,33333,47025
48026,6260,57345,70566,3834,71855,80582,2426,36186,49389
48025,5679,140170,189586,4184,163380,215030,1495,76344,113084
48023,1998,77892,105679,1324,100820,128523,674,53438,55107
48022,1124,79074,81494,686,83214,92047,438,0,64693
48021,12833,49788,59484,7959,57222,66314,4874,39655,44310
48017,5971,71938,85681,2954,93670,107176,3017,46889,62196
48015,3457,45210,54410,1966,56977,66566,1491,28448,35038
48014,1668,56646,71398,1154,66016,82108,514,31875,44338
48009,9099,126646,206818,5518,185568,271631,3581,79291,105634
48006,1454,65333,81344,1114,77000,90783,340,35000,44648
48005,1910,89327,101784,1482,98281,112253,428,49063,57073
48003,2196,80270,92188,1698,92875,103455,498,35756,48245
48002,1265,77011,87372,923,78702,94375,342,41688,51012
48001,5236,56178,73852,3281,72882,90132,1955,33096,43823
47997,62,76563,71989,45,83438,79802,17,34063,45176
47995,661,66583,71180,496,72800,76283,165,35781,49372
47994,163,63906,68106,89,87813,87102,74,50000,44657
47993,1421,56274,68512,1016,65761,75854,405,40250,47449
47992,474,91375,93619,343,91938,99467,131,68506,65539
47991,459,84196,87750,363,98359,97444,96,23750,47698
47990,646,51944,63085,481,60795,70968,165,40515,36878
47989,447,87715,75524,349,88952,89058,98,21500,26890
47987,1745,50684,63242,1196,59457,74987,549,27266,35912
47983,43,57125,53379,43,57125,53379,0,0,0
47982,62,51667,54418,45,63750,59880,17,32750,37641
47981,309,81964,98431,269,91050,94836,40,48750,68008
47980,418,61667,84792,315,76528,93222,103,47841,53687
47978,4206,55599,64944,2715,72571,78084,1491,28848,37096
47977,997,63460,79770,737,65313,87098,260,40417,52533
47975,275,74306,102589,190,81667,123538,85,43281,54191
47974,485,79426,88532,267,91654,98660,218,56667,75052
47971,724,48462,63314,476,56458,72221,248,32500,45567
47970,818,54271,92607,567,60673,114724,251,38068,40231
47969,46,50833,62748,27,79375,88689,19,21477,25242
47968,432,68077,75933,343,72813,84546,89,36250,35896
47967,310,55625,74545,224,67763,88896,86,0,36845
47966,141,47279,54226,93,60625,65337,48,28000,31577
47965,258,58088,63701,177,67813,75204,81,30156,35086
47964,41,45625,52722,37,42083,52495,4,25000,0
47963,908,61944,64414,681,66661,68911,227,40625,47968
47960,6359,50232,66438,4127,63217,74974,2232,30083,48225
47959,942,47278,54750,633,50826,59402,309,26648,31155
47958,64,41250,52577,48,46875,62775,16,16667,17144
47957,781,47666,49836,521,49060,55964,260,24118,32455
47955,399,51771,58004,243,75750,75916,156,24030,29291
47954,936,69211,75250,689,80625,84288,247,37054,44866
47952,1268,40574,50959,861,44107,59195,407,19696,27185
47951,1123,53750,60354,764,65486,70261,359,36313,38215
47950,298,61786,67437,237,61205,72004,61,67939,49695
47949,420,63561,73440,323,65865,69151,97,36250,75348
47948,576,49143,60915,313,62212,78440,263,27042,36586
47946,781,64023,68080,568,72386,75545,213,41875,40939
47944,1470,48578,63864,939,55530,76356,531,31473,38392
47943,366,53279,47539,358,53443,43587,8,0,0
47942,285,55987,81544,180,48750,68031,105,57019,102370
47941,510,63611,77821,349,66713,85535,161,46979,57419
47940,579,63631,74157,450,68816,81074,129,32417,39871
47933,11554,54734,71236,7147,70651,89715,4407,30474,39359
47932,2220,59079,70274,1547,69952,79970,673,38884,45889
47930,511,50920,70830,346,58393,91043,165,25527,27208
47929,287,65893,69032,178,68000,76760,109,42813,48418
47928,767,52344,59936,623,56343,65101,144,21429,34263
47926,522,52857,67232,368,59444,74688,154,24167,31985
47925,60,135081,105405,60,135081,105405,0,0,0
47924,156,77073,68178,72,76280,71549,84,80591,65289
47923,1375,64946,76479,959,79975,92139,416,27879,37304
47922,579,46083,55695,375,46442,62996,204,33750,39405
47921,449,62813,82239,269,55417,62720,180,0,102483
47920,925,97530,88600,725,100853,97449,200,38542,47608
47918,2417,57632,67728,1540,75599,82632,877,31563,39109
47917,159,64375,81791,144,72692,86175,15,0,39700
47916,17,45417,46706,13,0,43577,4,0,0
47909,16714,62559,76452,11034,75576,89742,5680,35667,46175
47907,0,0,0,0,0,0,0,0,0
47906,25531,46264,71548,12168,87684,111843,13363,20815,33565
47905,17158,57534,74413,10681,68589,85954,6477,40879,50873
47904,6992,36816,50320,3625,44101,60805,3367,26575,36000
47901,2302,39275,60635,803,75893,76006,1499,26533,50089
47885,3442,51472,74652,2407,63076,76645,1035,25750,64849
47884,112,48333,48712,78,46667,46660,34,48500,46982
47882,3363,47400,60466,2189,66437,75055,1174,23878,30859
47881,157,65625,62376,125,77854,64632,32,54286,50903
47880,38,0,41897,18,0,0,20,0,0
47879,1504,45046,54653,936,43929,57181,568,41071,42245
47876,0,0,0,0,0,0,0,0,0
47874,1349,54884,72968,937,71657,85082,412,29348,43415
47872,2572,56970,69819,2000,59453,76238,572,31314,44835
47871,171,42188,48558,103,48092,46228,68,27500,40775
47869,82,66684,77418,25,0,0,57,0,0
47868,1331,40279,51298,879,57578,61029,452,22955,31478
47866,173,0,100002,161,100521,94451,12,0,0
47865,30,43088,41827,30,43088,41827,0,0,0
47863,111,68454,69212,111,68454,69212,0,0,0
47862,605,45625,58827,414,56643,61867,191,32083,40177
47861,223,60417,73422,170,93421,83869,53,39063,36628
47860,219,31953,41863,126,36250,47722,93,26094,28851
47859,401,0,60566,236,64643,67999,165,26503,48273
47858,427,41912,86307,359,25000,66950,68,64265,72107
47857,122,58000,59743,85,69688,71202,37,26477,31086
47855,277,34375,41562,235,34548,42118,42,23000,22369
47854,232,82105,77863,195,95125,86958,37,32639,29924
47853,54,59375,62143,48,59375,61285,6,0,0
47850,926,53696,65779,745,59928,74111,181,21875,29258
47849,183,72344,91709,112,77222,105230,71,48036,67254
47848,609,50929,69589,448,65875,82716,161,31250,31510
47847,459,51141,62803,317,52768,66673,142,41000,52239
47846,192,76900,97719,164,70000,97756,28,66389,67732
47842,4192,49935,61584,2962,62284,71657,1230,25962,32051
47841,1084,51207,56387,781,60442,66062,303,24750,29148
47840,751,70964,74847,612,78421,84356,139,20368,32324
47838,676,65161,70717,514,76607,79721,162,33824,37542
47837,352,65648,63583,294,68333,69968,58,28125,29329
47836,0,0,0,0,0,0,0,0,0
47834,7555,57474,70362,5337,69517,80382,2218,35591,43384
47833,309,54375,69587,240,68182,78728,69,31146,37793
47832,507,81920,82707,406,88676,94237,101,24323,32405
47809,0,0,0,0,0,0,0,0,0
47807,5286,23450,34229,2324,35700,45995,2962,16535,22928
47805,5541,59367,70251,3356,79821,87292,2185,38132,41930
47804,4601,35345,48158,2833,44982,53650,1768,24167,35771
47803,9141,53257,72994,4969,71199,90549,4172,36145,50153
47802,13175,49831,67325,7796,67328,83226,5379,28918,40494
47725,6939,89692,113761,5266,97417,129335,1673,50422,62049
47720,6987,61571,82284,4951,74555,96414,2036,33571,44785
47715,12910,48938,71243,6466,71506,98905,6444,32243,40858
47714,14073,45429,57200,8063,54740,67012,6010,32940,41412
47713,4646,31171,41878,2320,35344,46687,2326,25658,35682
47712,10055,55307,73704,5846,77500,92737,4209,32894,44337
47711,13420,55833,72319,9111,66864,84959,4309,32458,39772
47710,8021,36602,51818,4478,47188,64973,3543,23691,32248
47708,234,0,148018,52,194583,210927,182,0,130043
47683,71,64792,63608,48,67500,70229,23,0,49357
47670,5056,49765,66020,3347,66145,78292,1709,25625,39987
47666,608,49914,58749,460,66458,67143,148,31094,32457
47665,1481,55344,76080,1097,70417,88681,384,29583,36905
47660,1999,46120,62998,1366,54324,74557,633,33299,37503
47654,34,61333,62471,26,61667,72646,8,26250,29388
47649,699,65924,65198,486,75057,74736,213,35688,42438
47648,1795,69160,73672,1203,82807,83317,592,49063,49117
47640,377,48607,64411,261,58750,75290,116,29444,39934
47639,1584,76250,91897,1191,90750,104474,393,45417,52658
47638,1472,73590,86457,1131,77973,88845,341,35313,76361
47637,547,54297,67682,403,62639,76612,144,34063,34156
47635,2359,47762,64007,1425,74495,81699,934,25647,35629
47634,1000,54038,64260,741,74144,71936,259,32201,36452
47633,1058,50380,60303,645,54792,68007,413,37371,46440
47631,871,62250,75993,661,75250,86869,210,37083,40446
47630,14380,86381,117032,10593,103129,139508,3787,37314,51273
47620,5365,62018,78306,3624,83487,93457,1741,34343,42657
47619,791,59115,81421,575,85313,94697,216,40750,42373
47616,105,0,70033,96,0,73375,9,17083,20044
47615,862,51528,65962,592,57344,70961,270,36667,53215
47613,1083,90701,108181,930,98724,119676,153,25865,35103
47612,272,48571,59394,195,68533,65946,77,33750,36681
47611,483,56650,79899,370,66250,90864,113,0,39992
47610,2082,58664,63078,1510,63922,67669,572,36389,44561
47601,5536,66733,83685,3888,82581,100375,1648,35272,39568
47598,1346,56389,62647,809,62064,69729,537,41705,49427
47597,335,62604,67565,244,82841,81864,91,25893,28986
47596,19,0,0,13,0,0,6,0,0
47591,10324,46526,66379,6591,58336,73903,3733,32641,50946
47590,181,32813,42014,77,52969,64678,104,22065,25235
47588,336,48385,55397,196,49318,62949,140,41395,41954
47586,4865,50513,62204,2952,70708,76216,1913,30319,36327
47585,311,46488,53987,185,72798,61823,126,37109,38285
47584,67,51250,57601,29,60313,64769,38,48929,50074
47581,1541,51589,62084,895,65579,73929,646,33864,44115
47580,138,0,83294,138,55833,79591,0,0,0
47579,921,86307,98842,739,98393,113298,182,32000,35415
47578,294,62917,74251,212,71667,84530,82,42981,43178
47577,467,81917,82351,305,96106,107500,162,0,35004
47576,196,74500,80910,188,57179,69842,8,0,0
47575,335,90369,96111,257,91733,103594,78,68438,71456
47574,41,54625,60659,19,0,0,22,0,0
47568,223,60893,62473,164,74000,73866,59,18750,30802
47567,2591,58429,69425,1651,76683,85224,940,31917,38583
47564,543,57344,72829,384,76346,86343,159,38750,38190
47562,1594,56786,82510,1127,77880,103516,467,25440,30955
47561,693,42260,55065,394,75250,68103,299,32750,37501
47558,1195,63002,81072,1153,63345,82763,42,28750,31855
47557,692,61618,69907,460,71389,72720,232,34830,59028
47553,2958,57845,68873,2027,71913,79996,931,35686,41803
47552,80,0,642713,80,0,642713,0,0,0
47551,268,90625,102497,234,90625,107029,34,0,61556
47550,254,64375,76268,156,94750,91302,98,44444,52336
47546,8705,58961,80884,5380,75638,101448,3325,33829,45305
47542,3941,57896,70253,2369,71434,79265,1572,32635,50431
47541,433,71875,74322,339,74740,81091,94,35000,47019
47537,389,42543,61623,240,61250,75145,149,38708,38676
47536,0,0,0,0,0,0,0,0,0
47535,269,32625,49013,174,49405,65791,95,18631,18282
47532,1654,70804,77592,1141,86298,92043,513,36650,44322
47531,374,53750,67708,295,72375,79506,79,14549,22204
47529,389,56058,69377,283,70234,80470,106,45750,38770
47528,214,44000,49768,111,73566,68723,103,23641,26749
47527,835,74141,72183,660,76074,83120,175,0,30935
47525,164,42656,61319,116,39318,63866,48,43611,55165
47524,264,43333,84638,121,108125,150225,143,0,27852
47523,1319,71875,69689,963,83098,78763,356,32195,43125
47522,169,65462,64536,107,59044,68818,62,65893,57147
47521,245,91827,94650,182,124063,113052,63,44539,41489
47520,1273,49306,55020,777,71188,72304,496,18643,27230
47519,167,118125,111082,145,139659,123190,22,23500,27945
47516,481,70125,89707,359,83224,96294,122,60833,65398
47515,343,45250,63519,176,75606,87698,167,24508,38037
47514,46,57917,63224,32,78000,85969,14,0,0
47513,725,54696,56705,423,69554,69676,302,33906,37002
47512,1678,47384,62769,1153,63964,77831,525,26458,27007
47501,7034,48848,60467,4279,63497,76303,2755,21260,31328
47471,1221,46151,55263,812,57000,64987,409,22234,33472
47470,675,51484,81205,469,60341,85247,206,43415,57192
47469,668,58633,61101,388,78417,78952,280,24219,33743
47468,708,55833,72632,436,67917,89069,272,44846,44341
47467,52,0,0,32,0,0,20,0,0
47465,175,45048,51365,144,45673,53243,31,0,42213
47464,146,51250,58186,54,56250,62120,92,0,47658
47462,1764,71786,84922,1443,74375,91081,321,0,45509
47460,4770,55022,62236,3023,65754,73443,1747,29036,39968
47459,1462,59800,72148,1105,68740,80506,357,33828,43740
47458,17,0,0,17,0,0,0,0,0
47457,44,56071,60595,37,54861,61516,7,0,0
47456,565,57910,66102,425,59306,71613,140,0,44465
47455,22,0,0,11,0,0,11,0,0
47454,3019,47587,71830,2069,68595,90700,950,20571,26336
47453,254,63750,63837,210,66548,70799,44,28646,30605
47452,2018,58092,68378,1547,63040,74528,471,27112,44646
47451,519,50795,65671,349,64306,75275,170,31000,43888
47449,120,45789,49357,71,48603,57575,49,33472,37449
47448,3243,54984,79958,2354,68000,85176,889,28135,53228
47446,4050,50833,57469,2723,65460,67912,1327,28803,34562
47443,497,52604,73516,362,61250,85020,135,28317,32050
47441,3993,46128,56512,2465,56198,64272,1528,26378,42133
47438,1685,50202,59154,1140,63333,70179,545,29107,34566
47437,122,0,129248,81,"250,000+",178277,41,0,0
47436,519,55292,66663,414,57803,72513,105,0,28203
47434,0,0,0,0,0,0,0,0,0
47433,1552,55283,62949,999,68116,75777,553,35417,38882
47432,1868,51250,60868,1249,64236,67448,619,34141,40606
47431,565,55184,78513,380,56838,80070,185,34479,72938
47429,3468,66413,86885,2566,81976,100674,902,41851,43369
47427,325,77798,77042,243,78433,75407,82,0,81888
47424,3528,58817,67401,2414,63263,77732,1114,27287,40859
47421,11701,58575,69427,7484,72833,83890,4217,31163,40863
47420,127,0,49392,113,78038,54416,14,0,0
47408,8705,42525,62909,3469,76902,99670,5236,23392,37579
47406,0,0,0,0,0,0,0,0,0
47405,0,0,0,0,0,0,0,0,0
47404,10476,43663,57818,5121,69517,79026,5355,26550,35890
47403,14267,57803,68219,8514,70104,81065,5753,40507,47045
47401,18127,54055,85793,9124,98346,124631,9003,32847,44479
47396,2883,65107,90666,2260,68236,101601,623,32991,40760
47394,3255,55938,68273,2084,69886,77022,1171,34349,50422
47393,569,72286,79298,490,71020,76482,79,0,77323
47390,2303,48026,54829,1375,56995,68500,928,21218,29860
47388,193,37813,48260,151,36458,50017,42,38750,37262
47387,284,49896,64523,256,50000,65666,28,38750,38786
47386,532,66425,108878,375,75114,129687,157,65291,53724
47385,740,72222,71267,499,90938,84401,241,25846,43544
47384,774,61750,66379,561,70586,72849,213,32583,45792
47383,1080,62750,74763,829,65917,80026,251,40568,55342
47382,91,43036,43608,48,51875,54396,43,0,30821
47381,57,46094,52081,30,46563,54570,27,43125,49311
47380,589,47750,64581,375,70703,80541,214,35385,34680
47374,19157,44725,61606,11644,59854,77396,7513,26204,34113
47373,981,45504,53708,641,54327,61897,340,24239,27736
47371,4759,46769,63910,2985,64397,78687,1774,30763,34357
47369,791,43789,50946,452,47045,60949,339,32526,35448
47368,934,60652,71435,667,74438,84198,267,37917,36223
47367,58,50625,41117,25,0,0,33,0,29512
47362,10658,47218,58480,6584,55370,68510,4074,30299,38821
47361,86,57206,66626,69,80096,69732,17,30625,31606
47360,516,46585,67333,428,45833,70300,88,45571,39788
47359,1408,51333,67805,985,63750,75640,423,26298,43291
47358,395,48558,76714,285,68750,93192,110,26786,28810
47357,308,55208,64963,168,77500,87743,140,21667,37435
47356,2382,58264,75499,1569,70931,82792,813,32898,59470
47355,1340,53400,61072,895,64028,75331,445,23194,31371
47354,536,49706,60436,323,62656,69642,213,42679,43833
47353,2137,55508,72343,1488,74278,83550,649,36927,42929
47352,310,47222,57348,250,54750,62832,60,31071,32752
47351,189,56477,58791,145,54464,57961,44,55278,54027
47348,3811,42832,57298,2445,54148,71735,1366,23400,29674
47346,1477,49507,63301,974,58450,72443,503,36719,40835
47345,565,68894,77007,429,81250,86468,136,48021,46170
47344,66,38333,52247,34,65625,70191,32,29038,30409
47342,971,46438,61638,750,57188,70260,221,26250,31326
47341,1012,70000,94786,793,79531,108124,219,31063,41607
47340,1232,55204,69400,932,60000,78875,300,33500,39276
47339,208,72667,71544,147,74125,81757,61,0,44959
47338,1146,56184,62230,758,70322,71963,388,27000,40352
47337,66,49286,50082,45,42212,47389,21,22083,32057
47336,1339,43438,54604,873,61222,65416,466,26200,31172
47335,390,48981,54322,253,58354,66044,137,25179,29011
47334,1378,60775,77502,991,69464,91375,387,34861,36810
47331,9457,47226,56719,6380,56140,65753,3077,26990,35639
47330,2028,54490,66762,1558,66538,74717,470,29634,33565
47327,1862,42095,54287,1197,50170,62099,665,27205,32065
47326,633,50888,69528,556,52105,73484,77,24141,33503
47325,239,68482,72210,207,73393,80175,32,0,20684
47324,64,34583,38222,53,38958,43004,11,0,15182
47320,1721,51774,65525,1220,60500,77635,501,28792,33666
47306,5,0,0,5,0,0,0,0,0
47305,1735,26813,50905,565,32238,91302,1170,23421,31166
47304,13878,57737,70233,7787,76391,87836,6091,31526,45728
47303,10567,33602,49467,5007,51615,68315,5560,21788,30834
47302,10872,37916,48920,6813,47772,57040,4059,23902,30375
47283,1273,59659,79438,963,69336,91419,310,23750,36058
47282,93,26875,48232,47,50625,59200,46,18611,20022
47281,473,54702,74010,336,69868,92031,137,19750,29814
47280,264,48750,60751,146,72069,80699,118,40192,33562
47274,12086,55426,69624,8167,66637,79387,3919,33823,44193
47273,857,80417,85223,672,87209,96137,185,36477,37669
47272,774,61471,66813,512,60536,68517,262,41667,54669
47270,179,61853,63561,99,78021,84887,80,33854,37170
47265,8040,57406,70967,5607,67390,81378,2433,36376,40920
47264,508,57917,77861,427,67083,83070,81,36006,37673
47263,97,49531,54096,64,48750,52464,33,35893,47433
47260,812,44864,52638,608,60038,58708,204,25333,31883
47250,9421,49462,67868,5521,62415,81600,3900,27730,37898
47247,71,82891,72310,53,82734,67260,18,0,52189
47246,1421,72614,81327,1058,77050,88022,363,50163,58105
47244,219,58229,66171,164,63750,74398,55,41875,41644
47243,1890,55514,70277,1339,63713,74326,551,39313,51964
47240,8540,61931,71206,5404,70906,82650,3136,43028,48312
47235,604,75041,65253,500,75760,73310,104,18304,26520
47234,621,70430,83066,496,74397,92756,125,42455,44613
47232,1101,60525,63018,934,65795,66917,167,31298,31799
47231,253,77813,73504,209,90625,78589,44,50000,41541
47230,619,54432,58443,389,53843,66393,230,62903,44998
47229,1066,49375,64449,785,60625,75410,281,24688,31946
47227,830,64712,64230,639,68047,70613,191,33109,37924
47226,62,64500,131160,33,83750,154191,29,63875,73503
47224,218,46310,53159,165,47188,55229,53,20673,46713
47223,410,67797,83182,247,110313,115157,163,0,28283
47220,2098,53009,68445,1567,58184,79059,531,29583,34952
47203,10394,65412,85273,6999,83431,101429,3395,33668,47703
47201,17959,67837,82562,11387,78198,95129,6572,41271,57838
47177,544,68276,75151,447,58352,71505,97,81827,75936
47175,385,47614,68925,302,33264,62916,83,84625,83648
47172,6102,75438,95832,4617,91285,112218,1485,33546,40811
47170,5756,48782,64454,3691,62282,74752,2065,31042,41514
47167,5693,48985,59177,3731,57289,70076,1962,24856,32025
47166,423,62031,63827,307,74083,76403,116,28333,30544
47165,2431,56615,67182,1783,77335,77420,648,29263,30638
47164,1789,53125,63932,942,69125,86778,847,29517,37066
47163,478,50333,65650,325,70568,81542,153,24875,30520
47162,322,42500,61419,214,61591,76169,108,26750,28581
47161,1176,68352,77173,805,81442,91162,371,42264,45910
47160,30,56000,53227,22,60625,58664,8,0,0
47150,18828,56337,72153,11240,72227,87757,7588,35014,45414
47147,324,41667,57519,275,48424,63626,49,0,23243
47145,845,43942,56361,627,55221,61389,218,22500,37171
47143,1197,94626,103160,1041,100694,112654,156,31250,39252
47142,395,55281,59307,300,57063,67445,95,30046,33611
47141,583,65272,94608,408,71071,115389,175,0,45118
47140,1080,41146,46593,648,62500,58208,432,24615,28559
47138,1768,58042,66752,1180,73108,77102,588,35625,45722
47137,570,46000,55059,392,50833,60145,178,23750,30254
47136,1452,88444,96893,1091,94313,111364,361,40234,49704
47135,317,69766,86020,244,69688,85904,73,0,80525
47130,18581,55840,66726,11994,62007,75478,6587,40912,46555
47129,8541,45417,57718,4125,58025,73504,4416,31102,40917
47126,1555,78067,93846,1198,89348,107638,357,39531,44668
47125,662,37222,54027,378,61250,73840,284,25000,26185
47124,1768,87875,98815,1512,93500,104625,256,50119,58567
47123,46,46429,42322,30,0,40330,16,0,0
47122,3737,86988,103339,2877,92120,116275,860,43529,54486
47120,352,59211,59955,311,61510,65111,41,0,0
47119,4204,96600,130557,3272,108015,147328,932,40274,70427
47118,1238,36300,63471,792,58730,85892,446,19427,21898
47117,1707,68018,73246,1151,77358,80168,556,36944,55213
47116,249,48523,48125,184,53167,55288,65,22026,27849
47115,1196,48064,63642,736,77703,83653,460,18358,30407
47114,176,70000,70583,146,73529,76846,30,0,37740
47112,5965,57135,75827,4050,78199,92175,1915,34111,39082
47111,6204,71853,81277,4547,86627,93483,1657,32471,42141
47110,104,66477,65714,104,66477,57499,0,0,0
47108,1018,48804,60388,715,54590,68224,303,30750,41711
47106,1704,65068,86328,1265,78208,97994,439,39844,52100
47104,0,0,0,0,0,0,0,0,0
47102,2689,34063,47626,1822,49792,56709,867,20813,26486
47060,2339,72119,92079,1686,96250,109311,653,26750,44000
47043,2340,50611,68852,1408,65833,83926,932,31731,41289
47042,1762,59911,70956,1111,86089,89175,651,26917,34141
47041,2485,61648,79574,1747,78110,91913,738,38762,46507
47040,2270,60187,70337,1498,66607,83334,772,25298,37761
47038,706,56250,51397,462,40000,49558,244,60172,41995
47037,1756,62656,65079,1298,65880,76210,458,24583,30252
47036,320,74808,116324,232,96795,144259,88,38500,41711
47035,100,0,34044,81,0,23799,19,0,0
47034,59,0,42858,35,60750,52211,24,22000,25458
47032,1073,69760,98601,811,75786,94539,262,60897,57018
47031,1974,59032,97656,1416,75047,113850,558,35147,38314
47030,743,66925,97202,614,67000,108469,129,13665,27302
47025,8764,73462,81843,6336,87518,96402,2428,22773,38995
47024,1321,50607,60061,879,62099,68544,442,29219,40717
47023,698,63750,72203,552,69125,81449,146,37656,33872
47022,1128,95577,108972,886,113214,116081,242,59107,79284
47020,558,53333,67001,408,86250,76433,150,36970,36156
47018,1697,68180,73223,1179,76306,81426,518,30568,39973
47017,235,63698,66132,143,68264,76841,92,32232,42199
47016,324,55000,64173,203,72813,80639,121,31225,36260
47012,4136,67467,73523,2773,73527,83944,1363,32756,45514
47011,348,0,74290,160,0,103628,188,29231,49322
47010,27,0,0,22,0,0,5,0,0
47006,4590,72235,89314,3452,87455,97984,1138,26597,61345
47003,481,51458,57072,348,63333,67400,133,21397,26983
47001,4239,59056,69496,2951,77837,80332,1288,27849,41771
46998,96,46389,52291,62,62813,62027,34,26771,30821
46996,2533,49398,63005,1508,63770,81963,1025,23153,31945
46994,962,54917,69936,727,74145,79291,235,26964,39871
46992,6899,54708,66540,4466,64815,76135,2433,34487,46857
46991,836,44750,54323,490,51375,56075,346,36958,48740
46990,229,70313,80721,157,49125,87714,72,81413,65264
46989,1418,66250,77945,993,80313,93734,425,32188,38461
46988,336,46731,51141,217,45673,58635,119,41823,36382
46987,349,56750,66146,267,64063,73361,82,33125,35452
46986,691,57330,67529,483,64338,74639,208,32153,49926
46985,629,45257,52776,355,55903,69770,274,28808,30757
46984,50,0,41590,9,0,0,41,0,36812
46982,1075,53266,59044,755,62586,67578,320,18986,32493
46979,1839,77479,94535,1467,85660,103811,372,39167,54856
46978,887,57431,65351,561,67159,79571,326,27500,36241
46975,5655,51306,67143,3658,69397,78331,1997,28216,45326
46974,703,53438,62009,594,61957,68377,109,20602,22576
46970,8922,47811,59492,5633,60531,70816,3289,31513,37663
46968,45,0,75844,29,0,0,16,0,0
46967,56,50192,49604,48,50962,54144,8,0,20788
46962,3398,59867,64593,2275,77193,74972,1123,33977,41546
46961,63,75048,68595,63,75048,68595,0,0,0
46960,599,37062,63865,390,60511,59070,209,30853,68544
46959,349,0,46822,206,0,58299,143,0,30288
46958,277,72706,60410,91,51488,57910,186,73083,61633
46957,210,40833,46671,131,50625,54425,79,22829,29487
46953,8641,37589,53223,5259,46185,61961,3382,27735,37642
46952,8491,49205,63567,5477,66995,74508,3014,29219,35946
46951,767,48386,60714,561,55093,65987,206,32396,44978
46950,260,33333,44742,166,44722,54236,94,23923,27974
46947,10829,47774,60355,6738,62721,72505,4091,23045,35303
46946,41,45694,37507,23,0,0,18,0,0
46943,73,50268,59779,73,50268,59779,0,0,0
46941,484,70873,72352,393,71379,75750,91,28068,49042
46940,1200,56944,67207,874,64265,72136,326,48281,52439
46939,783,41328,52146,445,46597,59860,338,32391,40042
46938,1303,43309,55246,845,49792,60128,458,35520,34821
46936,2161,67377,88516,1630,87432,101539,531,29050,41352
46933,2468,54175,58474,1758,59984,67504,710,22068,29241
46932,1448,59139,66691,965,67837,78011,483,44023,42548
46931,80,32188,37580,44,37083,53361,36,12188,17947
46930,42,37188,50571,34,43125,53665,8,0,26325
46929,1283,46854,59854,909,57396,65003,374,34722,42945
46928,1826,55080,62197,1214,65278,66095,612,36436,46144
46926,524,58684,70028,368,67333,75391,156,42841,45892
46923,3094,53462,75919,2003,66913,92241,1091,29922,42885
46922,0,0,0,0,0,0,0,0,0
46920,432,59766,79733,326,90313,93010,106,43269,35822
46919,983,58125,66952,659,73942,80312,324,25833,33649
46917,781,47438,65781,445,66250,84599,336,19179,38370
46915,352,50357,60467,210,61667,72072,142,34750,39456
46914,836,54000,66157,545,66688,75747,291,33393,47465
46913,480,64375,87412,372,73816,97001,108,41389,49842
46911,600,82500,89002,491,95234,97695,109,42813,48617
46910,1126,59167,68593,729,64471,78901,397,31094,41872
46902,15491,54443,68825,9565,70992,82544,5926,34889,44672
46901,16243,52693,64761,10200,64211,74959,6043,32574,43788
46845,8471,98630,130359,6736,106094,128945,1735,59477,131445
46835,14347,61493,75441,8767,76635,92684,5580,37734,45314
46825,12779,59598,71460,7003,75700,86967,5776,43638,49213
46819,4432,52103,62018,2632,61593,71407,1800,38860,46196
46818,7684,68333,78671,5631,76481,85474,2053,42706,51833
46816,7296,40386,48694,4493,47139,56373,2803,27141,34949
46815,10745,56838,69776,7122,72625,83348,3623,31035,39629
46814,4224,120921,171096,3537,127806,187730,687,50651,66771
46809,4106,46694,55841,2451,55014,67625,1655,28572,34584
46808,8447,45499,56825,4402,59045,69579,4045,33305,39068
46807,6327,51695,59058,3869,57490,64771,2458,35133,46508
46806,8892,32368,41996,5648,39981,45726,3244,24859,32643
46805,9594,45446,61789,4549,61781,73556,5045,27843,48490
46804,12288,76125,94635,8146,89894,111945,4142,44384,56335
46803,3755,23094,35308,2135,27458,40959,1620,20236,24980
46802,4883,36337,52492,2118,37330,49836,2765,33807,52410
46799,72,41667,48099,52,36875,47352,20,46786,49150
46798,544,63606,71232,414,63990,77172,130,51023,48198
46797,1319,73162,84010,1039,78542,91109,280,51471,54615
46795,2390,71596,83690,1824,76953,91971,566,46667,55533
46794,698,52875,80036,512,65625,93918,186,30417,41210
46793,1814,61346,79998,1367,75175,87997,447,35511,40470
46792,1511,69676,79699,1067,75929,85244,444,38750,64894
46791,445,100139,103261,406,112674,107597,39,28750,53377
46788,1091,83701,116128,850,84265,126567,241,0,63687
46787,1500,62027,79938,1095,75945,90495,405,36023,46923
46786,20,0,0,8,0,0,12,0,0
46785,478,62411,75270,355,67344,81745,123,0,52604
46784,948,59811,83362,662,66442,92486,286,44231,60245
46783,2537,90040,109960,1978,100417,119921,559,47083,71137
46781,267,70938,71001,182,86250,76737,85,0,52580
46779,873,72202,69734,627,81563,83074,246,24141,35094
46777,2557,54347,71849,1723,76328,88891,834,31875,35783
46776,808,50445,57214,575,50236,61833,233,36319,36150
46774,6515,56126,67841,4286,68556,80060,2229,31180,40385
46773,1351,56985,70030,918,71719,83051,433,30268,39307
46772,717,53393,69318,609,53510,71794,108,39375,51392
46771,19,0,0,19,0,0,0,0,0
46770,1164,65156,68574,854,69619,78147,310,30521,36217
46767,2723,61730,70331,2155,65608,76348,568,33220,37466
46766,381,67264,86119,336,88182,89967,45,46750,44360
46765,1895,85075,109288,1603,92829,118543,292,55441,52041
46764,498,79853,79949,439,85787,83232,59,59375,50280
46763,664,54063,71107,442,62426,83392,222,31875,42787
46761,4128,60377,70239,3200,68107,77649,928,34513,40412
46760,500,57734,61519,337,66181,68696,163,33490,41231
46759,170,48667,51075,137,49375,54966,33,0,34921
46755,6043,53246,63869,3733,64745,77922,2310,26231,35926
46750,10682,50753,62002,6830,65056,74723,3852,29114,36002
46748,1570,82946,102983,1235,92446,112612,335,47875,56572
46747,913,56902,72973,677,72250,82627,236,36310,42112
46746,1620,64299,65896,1125,66006,71824,495,37014,44552
46745,781,60221,75951,540,70625,90604,241,30721,39550
46743,817,64297,84786,588,72619,100124,229,46719,41129
46742,1379,61296,78276,879,88482,96684,500,50171,44813
46741,1590,70727,89887,1281,81860,96285,309,48194,58683
46740,1192,51842,58450,976,55992,62900,216,31563,35916
46738,3392,49783,63772,2256,56606,71884,1136,35640,43443
46737,3278,60571,75958,2123,72159,88873,1155,40429,50399
46733,7897,54084,64052,5254,69932,75764,2643,33243,37430
46732,1056,55948,65828,749,66094,72176,307,36793,38373
46731,235,49964,99003,196,68056,112812,39,0,25136
46730,353,71469,87794,301,80341,97184,52,29167,32940
46725,9676,63809,75120,6642,72477,86414,3034,38929,46673
46723,3202,70039,82869,2311,80322,96078,891,38594,46241
46721,1898,68500,73974,1458,70568,78531,440,50313,52160
46714,5828,52649,66043,3776,70250,81201,2052,29549,35553
46711,2577,49053,64767,1890,64597,76813,687,25571,30219
46710,1784,72095,89869,1291,78613,92185,493,48307,79565
46706,7708,61833,73486,5252,78699,85199,2456,32614,41474
46705,771,52109,72875,512,66250,70019,259,34453,76056
46704,10,0,0,10,0,0,0,0,0
46703,7537,58475,75993,4770,72088,88524,2767,37992,50914
46702,932,62326,67429,668,69412,74682,264,42500,47916
46701,3244,63468,70438,2275,73798,79929,969,33074,46216
46637,7097,62774,79899,3812,87040,97658,3285,38290,56900
46635,2552,63094,67706,1526,77128,84214,1026,24688,39451
46628,10280,46593,65513,6685,62016,74979,3595,27190,42936
46619,7496,39490,56020,4890,47315,62436,2606,21777,39125
46617,4136,67167,127896,2119,84528,117032,2017,52421,138167
46616,2266,38986,56412,1174,55063,69075,1092,32288,41618
46615,6161,43805,57442,3291,58614,70815,2870,35640,40117
46614,12535,56283,72998,7546,71113,90668,4989,32358,42359
46613,3793,40602,49793,2375,39834,51237,1418,33778,40371
46601,2141,24950,37035,802,48125,55703,1339,17041,25325
46595,32,106429,89041,26,113750,102858,6,0,0
46590,1691,70778,122282,1183,91801,150087,508,36406,43374
46582,5582,63030,72875,3396,78106,88683,2186,32727,43467
46580,8189,60072,74640,5581,70873,86046,2608,32089,43187
46574,3554,62254,73325,2598,77443,85536,956,33182,38813
46573,1299,69570,86255,982,84688,101623,317,35288,35891
46571,1474,69022,77871,1284,72828,83352,190,29100,37538
46570,383,48355,63189,299,59837,72965,84,35326,28393
46567,3894,65024,82717,2651,79738,95707,1243,31793,42876
46565,2363,80045,95758,2042,81536,101490,321,34594,53749
46563,9014,52283,67693,6271,63061,76769,2743,34320,45232
46562,1978,56750,71322,1376,63010,75317,602,39848,52985
46561,4809,73467,81244,3616,86157,92219,1193,29614,37509
46556,209,28819,35203,53,40057,39581,156,26750,33715
46555,1264,54200,66702,711,67721,83873,553,38523,44414
46554,1925,63627,71201,1296,72095,84861,629,30179,42814
46553,1062,71458,75129,941,81151,81038,121,19453,23729
46552,2576,62591,70460,1863,74506,80778,713,32232,39656
46550,4378,64918,74155,3323,73288,84508,1055,29745,38216
46545,11903,46222,60849,6113,62393,80639,5790,29453,37341
46544,12697,50756,65659,7418,64979,78750,5279,29396,43028
46543,914,85985,109136,776,86557,115288,138,49000,62975
46542,1542,70000,69147,1159,73694,72301,383,37321,51523
46540,4045,87910,106042,3366,88722,115387,679,35625,54630
46539,1137,52364,65108,740,69936,74755,397,32436,46418
46538,1588,73864,100581,1192,96250,119706,396,36316,40850
46537,211,63197,54928,169,64063,58791,42,41000,35717
46536,1145,64519,78954,856,71810,91595,289,39519,37249
46534,3882,50470,62450,2749,54732,68710,1133,33512,42112
46532,551,58854,76407,397,62974,86357,154,48750,49364
46531,622,56324,60041,355,72159,72567,267,0,38279
46530,10819,103082,134146,8519,116318,150074,2300,50691,72568
46528,7870,70322,89529,6185,77473,98859,1685,33395,45195
46526,11799,58286,72476,7869,72743,87050,3930,30607,39321
46524,841,63304,67566,630,72500,78250,211,31042,34152
46517,9016,49372,61151,6155,57822,70481,2861,30536,36349
46516,12046,48462,60645,7458,62873,72526,4588,29844,38440
46514,16467,54196,68409,10654,65399,77412,5813,37260,48523
46511,1725,50020,68796,1138,54932,78086,587,32418,47850
46510,1517,67083,76235,1163,82068,86868,354,29953,37764
46508,98,40294,47389,58,0,65098,40,13571,21708
46507,3396,70833,89372,2463,79797,101730,933,41918,48658
46506,3685,56568,66856,2473,74824,81348,1212,28792,32948
46504,1226,75031,73659,845,80596,84752,381,30982,46686
46502,44,0,0,44,0,0,0,0,0
46501,1255,51943,62180,905,61250,70426,350,32833,37702
46410,15832,61000,70450,9211,74602,82780,6621,38937,49759
46409,2779,33120,40415,1655,40308,47152,1124,23185,26837
46408,6730,39956,47328,3479,45397,58222,3251,32429,32971
46407,4912,22387,32397,2515,31798,39998,2397,16891,23719
46406,3449,30569,47099,2197,32258,47722,1252,25176,41116
46405,3774,46824,57106,2455,57061,66234,1319,22545,35795
46404,7051,33030,47900,4539,41203,50434,2512,22458,41488
46403,5534,37927,54597,3294,41159,61085,2240,28348,40494
46402,2648,23630,36266,1373,30383,42981,1275,14309,27512
46394,5114,51898,63660,2698,70625,80049,2416,32309,43313
46393,101,0,51615,61,61908,70451,40,0,0
46392,2841,74053,86366,2073,78859,98402,768,40833,51917
46391,1978,77304,90774,1245,100664,107479,733,38924,55872
46390,1323,74296,83298,916,89000,98358,407,36625,45358
46385,14926,86623,114007,11048,99538,129612,3878,45170,66481
46383,16411,63220,80098,9528,86988,99675,6883,37612,50546
46382,787,91349,95279,526,91974,101523,261,85125,82695
46381,88,28542,34375,60,0,38058,28,0,20246
46379,79,0,71214,31,0,0,48,0,0
46377,132,56181,51440,107,57049,58718,25,0,0
46376,63,68750,66638,47,56875,63830,16,75625,61738
46375,9184,81439,109276,6268,101695,128419,2916,50086,65084
46374,279,78958,136682,197,76458,158124,82,71250,78501
46373,6299,98261,127332,5258,101786,136105,1041,60980,80554
46371,1174,80802,92323,912,81880,106597,262,0,41485
46368,15178,60106,71996,10052,72417,82368,5126,34754,47463
46366,2166,46449,58017,1445,62181,66290,721,28456,38959
46365,270,77241,86998,214,97333,102178,56,0,28991
46360,17615,50075,64598,10499,63296,75842,7116,31244,44513
46356,6426,76194,88442,4799,93388,101092,1627,39875,50506
46350,17710,59641,74245,11835,72566,86244,5875,32093,44663
46349,1167,73710,89360,844,89900,102428,323,35464,45779
46348,453,46369,61580,313,48295,67238,140,33542,45903
46347,1813,73843,82381,1395,87944,90952,418,40192,53544
46346,500,48596,53711,382,48724,54793,118,21944,29408
46345,78,42500,50369,47,0,49562,31,0,49203
46342,11982,64279,74029,7774,78094,83050,4208,37040,54725
46341,3830,75741,84857,2862,92118,96478,968,36618,47515
46340,425,48750,56666,206,60833,71266,219,48270,42839
46327,3912,45083,51733,2668,46491,54485,1244,33067,38754
46324,8489,49420,60297,5499,56324,68206,2990,36180,41761
46323,7884,53150,65718,5410,61457,74868,2474,32786,40135
46322,9524,66079,79130,6154,83017,91495,3370,39299,54682
46321,8535,88010,116723,5884,110667,131573,2651,49816,81805
46320,5112,30786,48108,2584,44527,59403,2528,22339,33351
46319,7300,61526,76504,4782,80242,88344,2518,45129,49239
46312,10645,35396,48442,6387,41363,57552,4258,23680,31165
46311,8312,94592,112797,6447,107641,124174,1865,54544,68669
46310,5269,63457,72310,3561,72922,84305,1708,28296,40525
46307,22967,87543,98009,17440,96224,106292,5527,48603,66691
46304,9890,79358,101597,6746,95000,107601,3144,52543,83993
46303,5452,69732,89476,3911,75179,93916,1541,47060,70140
46301,340,97823,168369,239,103194,204889,101,28375,81724
46290,92,0,253020,17,0,0,75,"250,000+",290192
46280,3606,69790,85058,2083,82618,101429,1523,51194,62157
46278,3427,131430,151217,2338,126429,160689,1089,115313,120815
46268,10741,52458,65237,4932,71089,84847,5809,40931,47679
46260,14220,59522,86618,7769,73281,107162,6451,39030,57009
46259,3869,111773,127039,3245,116758,135877,624,62500,77181
46256,10354,71268,101939,5928,99208,130611,4426,45811,63093
46254,15672,46693,66661,8721,57092,84041,6951,37178,43289
46250,9034,57053,80231,3985,92764,108535,5049,46370,57142
46241,10655,42342,54996,7326,47490,52609,3329,30798,55526
46240,10165,56744,97368,4144,93904,147020,6021,41094,62408
46239,10310,76456,87429,7912,85847,93398,2398,41939,62732
46237,15314,69839,82557,9189,82075,92488,6125,48750,65561
46236,10633,99712,122942,7612,117759,140286,3021,48875,73685
46235,12101,41083,51888,7178,53333,62843,4923,22578,33202
46234,9788,76461,95583,6875,85479,107769,2913,44127,61448
46231,3563,58913,94528,2575,60168,108022,988,51584,54924
46229,11683,55407,72085,7257,65754,84049,4426,37351,46639
46228,5590,72928,97191,3584,81477,112272,2006,49891,66718
46227,22360,44873,59720,12170,59509,73389,10190,31184,40592
46226,19017,36688,49220,10062,43873,62256,8955,25845,32492
46225,2163,35694,47294,1022,45603,50628,1141,26720,42729
46224,13754,40965,51014,7996,44251,56585,5758,34197,39679
46222,12409,38110,45238,7089,42054,49867,5320,29013,35970
46221,9805,49399,61248,6342,62318,68642,3463,35620,42333
46220,16879,77377,109485,8489,111141,139392,8390,51831,78022
46219,15857,42749,56740,7902,58614,70594,7955,31291,41177
46218,12563,26615,41968,5722,35942,47375,6841,18765,35603
46217,12797,68063,85292,8824,85500,98616,3973,43464,52942
46216,1225,51612,85237,507,100639,126212,718,33629,56212
46214,9786,49789,64755,5093,57400,75322,4693,38637,51092
46208,8535,40707,68693,3899,55780,92109,4636,31806,47886
46205,11857,52068,79951,5614,74823,110589,6243,35995,50958
46204,4582,73281,100517,583,170852,188015,3999,67271,87761
46203,14085,41321,58332,7951,48027,65669,6134,32478,44656
46202,9714,50216,79733,2601,98490,132760,7113,37716,60031
46201,13112,31651,42992,5488,42628,54770,7624,23387,32466
46186,681,72625,78604,521,91750,88768,160,39107,45369
46184,5177,72546,78514,3456,77210,89202,1721,39967,54428
46183,0,0,0,0,0,0,0,0,0
46182,641,60096,68639,438,76750,82558,203,28207,37578
46181,1941,80370,104268,1549,90966,120107,392,32083,41390
46180,448,57250,69244,313,83438,80248,135,42361,40481
46176,11499,55616,67780,7084,70731,82636,4415,30285,40142
46175,224,47262,52296,152,51875,51484,72,46310,52714
46173,4134,55211,63097,2692,60488,71283,1442,34712,44766
46172,972,77885,79885,778,78333,82179,194,51964,62135
46171,740,51951,71280,613,56683,76507,127,28424,37514
46168,13703,70719,90647,9412,87308,104838,4291,41664,53956
46167,2617,98380,112208,2055,105986,122540,562,51934,74428
46166,864,74737,76829,615,71830,73091,249,81004,82824
46165,699,75396,89979,532,76208,93042,167,63194,80170
46164,1561,81680,102831,1237,90982,111388,324,38261,50223
46163,4781,95987,115974,3762,112278,131633,1019,42896,50618
46162,140,75455,67029,63,0,86641,77,0,0
46161,866,65417,77680,599,85048,94325,267,25750,38302
46160,2634,59872,76115,2046,69375,82486,588,36603,49501
46158,9017,71269,85331,6670,82415,97314,2347,33933,46592
46157,1329,82083,94963,1060,76771,99231,269,32750,53563
46156,466,68636,90849,392,71250,98163,74,20917,21745
46155,62,58750,56948,53,0,0,9,0,0
46151,11585,65680,80848,8450,75805,91612,3135,35660,46289
46150,395,54271,68269,237,80859,75820,158,48162,53787
46149,747,82227,82813,583,91433,94646,164,32292,37857
46148,2089,63850,73289,1504,78654,81451,585,34023,50922
46147,1253,65104,83077,887,77271,91969,366,34659,55377
46146,68,79896,87640,68,79896,87737,0,0,0
46144,55,52614,52193,46,53636,56893,9,0,0
46143,20886,73959,94901,15033,91267,110543,5853,40556,48613
46142,12431,77155,94444,8776,90857,106116,3655,46496,62749
46140,16272,66595,83236,11269,80918,95604,5003,38890,52092
46135,6717,54777,66011,4287,68322,76013,2430,34924,46691
46133,330,67647,65811,244,95000,76296,86,27222,32769
46131,12011,67980,80167,8398,82041,92925,3613,35148,45382
46130,961,79264,86815,747,92938,98755,214,43049,42522
46128,938,79235,78286,680,93083,89977,258,51875,47420
46127,148,0,68710,110,0,81501,38,20833,25534
46126,1837,68699,78649,1277,75521,92107,560,31705,45053
46125,17,0,0,17,0,0,0,0,0
46124,3213,61728,69829,2091,72340,81361,1122,32273,41384
46123,13379,92811,114677,10684,102823,122950,2695,49605,71960
46122,5816,83606,94396,4432,93901,108811,1384,35865,46204
46121,1885,68288,84403,1530,77438,86111,355,45804,59710
46120,2531,57175,65858,1718,73567,79549,813,22393,34438
46118,1997,70804,85907,1253,74827,90334,744,51442,74574
46117,231,89180,85090,195,89336,84827,36,0,0
46115,722,60278,63735,496,82661,72292,226,15625,43426
46113,5732,74935,83899,4102,84128,93762,1630,38986,57116
46112,13502,91131,107476,10333,102235,120611,3169,47642,60338
46111,89,48472,53497,56,49167,51295,33,38750,52276
46110,259,55968,66446,185,57271,75063,74,51087,44905
46107,4975,52527,64504,3021,63065,75068,1954,35136,45014
46106,2752,75833,139677,2087,95521,172857,665,17124,31856
46105,658,74512,79372,521,82596,88863,137,0,35885
46104,362,69038,72415,264,68558,74556,98,0,66648
46103,35,76250,74663,33,0,72661,2,0,0
46077,10829,140092,187445,9136,160333,201618,1693,62132,110309
46076,669,54018,69794,508,80833,78995,161,27438,39599
46075,2414,96563,118540,1908,99864,128083,506,78906,77774
46074,13199,100249,122801,10698,106390,133212,2501,56888,74549
46072,3652,65205,74222,2511,77158,86932,1141,36587,45032
46071,1290,78269,96207,833,82872,105644,457,39821,76253
46070,809,64095,73569,668,72115,80100,141,24531,36862
46069,2804,60433,83384,2026,78443,96907,778,33583,41226
46068,1183,84375,86472,920,94107,93404,263,42292,55391
46065,1183,65265,70555,840,76438,81701,343,31875,37606
46064,5327,75238,90111,4002,90255,103989,1325,32566,45385
46063,177,50850,57760,121,51750,59661,56,46667,49959
46062,12934,89907,118054,9421,112095,140538,3513,45493,55192
46060,15428,76758,95355,11322,91608,108228,4106,39935,56288
46058,866,73986,80450,539,86188,96396,327,42321,50813
46057,474,80476,77792,297,83977,90253,177,40625,48472
46056,752,72262,82756,615,75139,88424,137,52656,52279
46055,4532,96721,142195,3641,108762,157356,891,66331,74495
46052,9749,59655,84480,6150,85114,107821,3599,35593,41996
46051,1186,61702,76202,803,81193,89593,383,37917,45686
46050,792,61583,68564,602,72727,76278,190,35625,37441
46049,443,65139,80917,330,63750,88669,113,65139,57516
46048,822,54268,57635,560,56786,63352,262,40000,44090
46047,18,0,0,18,0,0,0,0,0
46045,42,48854,53057,42,48854,53057,0,0,0
46044,1135,58080,68176,857,71761,78465,278,22188,30769
46041,8520,49638,60475,5345,59951,72638,3175,29753,38123
46040,5311,102475,134417,3960,121250,151127,1351,44795,80792
46039,225,72375,67234,163,77850,83996,62,19688,21198
46038,17373,92853,112425,11940,110040,128018,5433,59742,72163
46037,14661,115018,139179,11574,126321,156441,3087,51533,68209
46036,4570,51909,66695,3107,62088,77019,1463,28310,38487
46035,423,62438,76166,304,74423,87531,119,32708,44662
46034,2747,70318,89802,2105,73791,93557,642,21020,74399
46033,14301,135423,164203,12003,152403,178393,2298,73140,88743
46032,20119,105720,159203,13832,141296,196352,6287,59968,75519
46031,802,69333,83142,582,71917,94147,220,34688,47423
46030,1129,63750,87531,905,88284,101199,224,25268,28900
46017,2351,61057,65679,1634,63190,70698,717,38586,48637
46016,6983,29632,37650,4185,35290,41785,2798,22414,27166
46013,7808,43854,58789,4071,59858,65203,3737,30186,50674
46012,8453,47615,59509,5100,60052,71138,3353,27797,37900
46011,6870,61254,75488,4713,71560,85860,2157,34126,50253
46001,3983,60637,73578,2778,73897,81305,1205,40529,46105
45899,82,55000,62460,51,71458,82759,31,13958,25313
45898,395,41458,56879,230,68929,76971,165,24279,27254
45897,24,0,0,24,0,0,0,0,0
45896,756,55000,78510,474,70781,94249,282,47143,47489
45895,7605,62507,72778,5264,76682,85623,2341,30732,39014
45894,350,70811,80942,231,73618,96774,119,0,50210
45891,6065,53798,66777,4220,66707,78841,1845,25323,34209
45890,282,73125,82584,224,100682,92289,58,40000,41119
45889,563,102188,90642,494,104583,96153,69,41016,49103
45888,165,70148,67393,75,41734,64961,90,70763,65889
45887,1737,51327,60825,1157,64229,73518,580,25125,33939
45886,225,81563,78832,131,78750,78208,94,86250,75134
45885,5313,65635,72593,3519,81327,84942,1794,37350,43093
45884,18,49643,213772,18,49643,213772,0,0,0
45883,1275,85139,109887,1022,97083,124101,253,40250,46426
45882,1060,56042,79359,783,83424,92964,277,28821,32002
45881,608,64783,75711,432,81087,86026,176,0,40296
45880,1011,72750,77504,781,77298,85412,230,37857,40493
45879,2661,50507,70909,1870,67230,83602,791,29556,39238
45877,877,61875,79714,637,70313,85458,240,42440,60530
45876,357,63958,82976,212,78214,105510,145,36964,47277
45875,4239,69629,85020,3134,96083,101851,1105,24440,34424
45874,909,57483,73138,615,72313,83300,294,36750,41924
45873,723,48750,54223,440,60000,65703,283,28594,36164
45872,1952,55962,59789,1082,60307,68752,870,31597,40970
45871,783,71033,78457,582,77368,89802,201,33625,42796
45870,112,133179,121963,112,133179,121963,0,0,0
45869,1842,85238,103558,1230,102407,118139,612,51520,71439
45868,222,83958,86547,195,90114,87777,27,42125,50419
45867,467,79757,86866,280,79779,82058,187,0,92076
45866,61,42917,51252,30,73750,68697,31,36094,34371
45865,1837,85804,92870,1369,97083,102342,468,44821,53151
45864,86,41250,55621,52,71071,70540,34,33971,32803
45863,571,56339,61974,458,55000,63654,113,36115,42696
45862,663,41181,72152,357,65184,106564,306,20757,31953
45861,133,55938,53560,84,59118,59446,49,24583,30590
45860,969,89193,99159,620,113409,127055,349,42127,49601
45859,243,40163,42286,144,52500,56303,99,0,19502
45858,1038,57568,71527,725,66518,79526,313,32083,50247
45856,1992,65256,76455,1406,77333,89192,586,43789,44925
45855,61,58125,69367,42,71667,85369,19,33375,32500
45854,153,46563,59388,108,46250,58014,45,36838,52769
45853,652,72292,109335,491,104727,130489,161,43125,44820
45851,253,64813,68966,233,69271,71257,20,0,24195
45850,1163,68389,76808,944,75625,83220,219,41307,41244
45849,348,57500,66138,274,66591,75663,74,27857,29039
45846,1609,71862,82874,1192,87917,95381,417,45351,45575
45845,1094,65000,87604,794,83214,103643,300,35417,43986
45844,1180,76700,87337,917,84115,98725,263,37574,44779
45843,1458,54819,60465,1084,61364,65731,374,29700,40590
45841,366,69189,73980,247,77375,84870,119,45489,50458
45840,23903,54479,77722,13416,75659,100603,10487,33273,46382
45838,51,73125,59702,42,73500,66186,9,0,29444
45836,592,50625,58556,409,56250,60665,183,31528,52804
45835,219,59375,74889,173,77917,75708,46,37778,66450
45833,4346,58750,70601,3067,73442,82561,1279,28502,36216
45832,1254,65640,76920,1047,73274,82737,207,33906,44259
45831,1404,55952,67520,1068,66333,76047,336,27059,36964
45830,2134,61827,70168,1468,74271,79069,666,44537,46385
45828,2304,71900,78147,1734,86826,85804,570,40742,54853
45827,838,82969,101402,656,95179,115004,182,38269,48187
45826,161,64688,73095,100,86250,94544,61,37292,37933
45822,7892,59535,75017,5078,70629,84846,2814,39138,52580
45821,416,52232,66674,295,64028,79369,121,30774,32685
45820,234,58056,70535,177,72583,73310,57,36354,56175
45819,114,50417,61111,80,52778,60094,34,32500,54576
45817,2629,72736,81482,1745,84233,97663,884,24660,48933
45816,142,65250,65147,76,68182,83943,66,33750,39539
45814,1114,69000,75703,855,77426,85694,259,22917,31981
45813,1431,59922,81344,974,78359,100768,457,27104,37297
45812,716,38558,51404,493,39625,54615,223,33750,38996
45810,2535,51847,61948,1545,69795,78672,990,35137,35164
45809,40,81071,87410,32,97500,102559,8,0,0
45808,157,62361,62369,110,75857,68225,47,47019,48230
45807,4881,64221,81736,3250,79870,94918,1631,36058,53724
45806,4339,70267,91603,3019,83931,103661,1320,37476,56358
45805,9511,52018,66483,5498,65402,80596,4013,31924,43250
45804,6368,34210,46006,3484,41835,51637,2884,30043,34909
45801,8792,40062,51835,5363,53243,62596,3429,23028,31204
45789,34,0,0,29,0,0,5,0,0
45788,351,66504,78497,263,89250,90188,88,36694,42986
45787,23,0,0,5,0,0,18,0,0
45786,1214,70357,69782,839,77165,82232,375,24528,41927
45784,1439,62250,70505,953,78826,87348,486,19667,31498
45782,171,32250,35289,141,37902,36738,30,18750,22257
45780,1587,48419,65533,581,62593,92861,1006,45781,49749
45779,299,62250,75308,215,69375,91797,84,0,32423
45778,293,37457,43725,237,35313,37255,56,46786,49279
45776,309,37474,58641,186,56346,71901,123,35740,38588
45775,406,47803,95883,294,59583,118507,112,32778,36496
45773,0,0,0,0,0,0,0,0,0
45772,698,43531,59801,444,54091,67885,254,18289,42092
45771,1407,44097,72686,940,48491,69275,467,28004,78076
45770,305,0,56665,161,115169,87763,144,9821,21896
45769,2551,44610,55320,1651,60701,69192,900,18864,26960
45768,714,65726,60257,521,71369,70462,193,19020,30654
45767,1085,49234,52504,767,57827,61538,318,22625,27190
45766,526,43152,47554,291,56875,64802,235,17303,23828
45764,3043,44159,54466,1743,60804,66584,1300,22829,32931
45761,877,35578,54808,453,59519,77787,424,21951,29179
45760,1550,37958,53844,932,55750,65367,618,21563,34749
45750,11078,48469,72856,7049,62264,89622,4029,28599,40426
45746,132,39688,45779,72,39167,49336,60,0,36448
45745,528,47000,60458,429,49362,66589,99,0,31313
45744,1037,50339,61477,759,54417,68633,278,37971,35871
45743,573,49327,63029,386,62917,69758,187,30139,46199
45742,1083,78828,103674,778,98542,127908,305,33242,34384
45741,335,14402,20750,110,17167,31752,225,0,15371
45740,166,40500,66341,94,42000,70179,72,24231,54950
45735,671,53542,92846,393,90938,131683,278,25132,34149
45734,212,26284,34435,121,25000,36899,91,27298,30816
45732,1697,40689,46807,1062,50963,56802,635,20660,28728
45729,584,65893,72734,332,91429,95380,252,39423,41058
45727,161,36573,44029,102,36613,44233,59,32396,43678
45724,1072,54662,58150,643,48010,58125,429,70046,56541
45723,1552,56552,69325,1028,71830,82067,524,30238,44118
45721,18,0,0,18,0,0,0,0,0
45719,352,30571,47755,208,35156,58717,144,24833,30135
45716,157,35938,53549,90,41250,68016,67,29063,34116
45715,946,40147,71028,536,63571,71221,410,25219,69422
45714,4133,50953,68907,2533,59482,83734,1600,33750,42081
45711,370,50972,60036,243,69464,71098,127,38224,38049
45710,2224,51429,60872,1431,60651,70834,793,34213,40832
45701,10666,42733,61156,4882,80345,92657,5784,20417,33115
45698,217,50083,53198,162,66563,65157,55,9432,17975
45697,1829,69496,77086,1383,79078,91071,446,19019,30747
45696,589,30202,35231,203,31205,45499,386,25543,29832
45695,261,36542,39187,155,42070,51252,106,21136,21546
45694,4705,58216,70744,3320,70241,83221,1385,25173,39615
45693,3334,40345,68903,2229,57675,84686,1105,20637,30029
45692,3529,45885,54520,2360,54464,64443,1169,23454,32393
45690,6141,50344,72761,4284,62333,86461,1857,29502,38263
45688,201,35375,40764,130,48750,50372,71,14327,19785
45686,1249,47909,57827,915,55766,68393,334,15125,26839
45685,435,67865,84257,361,73039,91408,74,29712,36628
45684,671,45673,57980,442,53782,74106,229,26165,26397
45682,1018,27065,45403,561,52212,67752,457,10839,17214
45681,622,53958,102334,524,62727,112037,98,0,47755
45680,4962,44141,61583,3076,56731,74685,1886,28088,38210
45679,1007,39425,56027,754,58214,62139,253,17228,31120
45678,329,45286,46330,236,47756,49356,93,0,31096
45674,77,47917,61448,53,72917,69511,24,0,36233
45673,192,0,49211,181,0,51015,11,0,0
45672,476,65548,72451,338,65585,74481,138,0,63290
45671,99,0,39534,85,0,42505,14,22500,21493
45669,3874,56484,67074,2767,71729,78036,1107,31053,36582
45663,2560,44188,52597,1738,60435,66015,822,14016,23858
45662,12417,34604,50988,7135,44557,61654,5282,21502,32666
45661,2625,43559,61987,1865,55729,68972,760,19000,37610
45660,2996,36436,56673,2174,40882,65538,822,24440,28190
45659,897,35573,47956,698,41477,55839,199,0,17973
45658,994,52857,55353,734,59510,64946,260,0,28272
45657,755,41691,43414,443,53708,53840,312,23393,27920
45656,2629,48306,59291,1865,51875,68805,764,22250,29805
45654,491,55429,60075,373,55689,65351,118,29702,36736
45653,1450,65539,87442,1131,79199,95245,319,30139,55545
45652,1353,37939,59790,990,49593,71392,363,14664,23254
45651,2056,51397,57458,1460,62318,66966,596,22500,29275
45650,124,64688,75478,75,93229,80968,49,0,67076
45648,4041,46155,61962,2890,55267,68151,1151,30208,41859
45647,1323,59710,70038,1098,71711,74365,225,41935,47850
45646,183,36391,51352,127,0,66199,56,0,17682
45645,1203,51191,54284,1040,52074,55362,163,48672,47407
45644,1987,59612,71682,1304,77454,93784,683,0,24529
45642,0,0,0,0,0,0,0,0,0
45640,6385,51396,65212,4621,58653,77064,1764,24849,29693
45638,8163,41481,54266,5204,54015,63098,2959,23730,31993
45636,36,0,124131,28,0,148911,8,0,0
45634,680,34145,42966,379,47969,55337,301,0,26795
45631,6092,46519,66053,3725,63231,81128,2367,28595,40213
45630,53,36541,39383,0,0,0,53,36541,39383
45629,947,50299,61735,728,60625,71420,219,19727,27614
45628,2131,64872,71452,1473,81615,83608,658,28512,41677
45624,29,0,0,0,0,0,29,0,0
45623,1164,53125,64209,834,58750,74610,330,34545,35501
45622,41,0,55949,10,0,0,31,0,0
45621,144,38654,45797,61,65625,63003,83,38005,28876
45620,371,75225,67202,302,75701,72065,69,20156,40117
45619,2969,63895,81732,2232,72318,71993,737,31847,110189
45618,0,0,0,0,0,0,0,0,0
45617,107,0,0,107,0,0,0,0,0
45616,790,33854,53571,501,54792,67651,289,24955,24934
45614,1575,53285,70827,1101,64095,78440,474,31786,50768
45613,1043,41484,58471,741,66012,69759,302,13487,18306
45612,1732,39924,51512,1178,50259,60175,554,25417,32095
45601,20864,49391,65601,13117,62794,78407,7747,29775,40491
45506,5545,41398,54555,3440,48545,62290,2105,26908,37798
45505,8139,36220,47751,4793,44132,54311,3346,25940,31881
45504,6221,55493,72735,4061,64212,84093,2160,34936,45513
45503,14065,47274,61746,8400,60852,73310,5665,32927,40727
45502,6278,73902,86225,4487,92004,101369,1791,36003,43828
45459,12369,73031,100379,7286,100523,127465,5083,42974,59722
45458,13033,92059,118293,9038,122412,144912,3995,45142,55504
45449,8471,47072,58244,4374,64375,76427,4097,31799,36399
45440,8883,74262,96526,5606,91950,115117,3277,44232,61086
45439,4057,44663,54145,2404,59412,62864,1653,26798,37281
45434,4473,118705,134566,3633,135629,150395,840,47500,62131
45433,612,61919,92467,476,62364,103606,136,47727,49749
45432,6963,60758,75428,4400,76830,90013,2563,36860,47702
45431,12187,65879,82868,7250,77078,93794,4937,48982,62810
45430,2923,88094,102490,2204,98417,112560,719,50368,67241
45429,11687,66757,96166,6876,86626,122937,4811,37618,51645
45428,0,0,0,0,0,0,0,0,0
45426,7209,37594,50688,3761,45768,60751,3448,29188,37327
45424,20179,69452,83099,14530,80551,92533,5649,42466,55022
45420,12026,45704,56832,5714,64101,72038,6312,35950,41552
45419,6555,82395,116467,3991,104191,153227,2564,42921,55580
45418,626,67143,70386,516,75714,74980,110,36500,41245
45417,11883,29343,40741,6838,35393,47463,5045,22413,30569
45416,2002,54156,61949,1249,66654,69156,753,31581,41931
45415,5644,62772,74595,3271,75030,96052,2373,29281,44024
45414,9474,43839,64266,5260,64566,81290,4214,29290,40088
45410,7302,36006,48813,3745,37223,51241,3557,30295,43258
45409,2886,68816,100198,1570,91862,140466,1316,40900,51292
45406,9513,32271,48777,4906,40504,56133,4607,21405,36210
45405,8806,32650,41031,4062,35952,45412,4744,23918,33072
45404,4219,30308,39039,2410,34542,44972,1809,22177,28523
45403,6101,31053,40242,3230,37844,44914,2871,19986,29865
45402,4588,30487,51136,1888,40720,68465,2700,18632,36796
45390,1237,42176,52870,807,55208,62689,430,21667,29849
45389,188,53750,57243,123,66042,64322,65,32344,38971
45388,221,99063,106800,184,100000,116245,37,23281,54111
45387,2641,69006,85758,1430,94318,114049,1211,36332,48501
45385,15768,58084,81202,10348,76261,100460,5420,30265,42588
45384,156,83571,93050,115,90781,103952,41,0,0
45383,2966,52897,60120,1846,63413,70203,1120,33692,41270
45382,414,65625,84528,328,66875,88795,86,64583,61834
45381,2200,66462,76903,1709,68712,82727,491,43872,46100
45380,2120,73254,91909,1491,84645,110052,629,31307,45778
45378,183,66875,68621,129,80625,81371,54,34000,36950
45377,6574,65916,82441,3918,84583,99633,2656,48977,53261
45373,13412,67467,81948,8803,86492,98248,4609,34383,46417
45372,136,48409,61831,91,63125,76318,45,26563,30664
45371,8356,71702,90684,5636,90812,106093,2720,41867,57282
45370,950,114375,130721,710,145395,155709,240,33500,52910
45369,1494,65662,83007,1122,91250,96698,372,28843,39742
45368,1946,59773,71891,1228,71488,86385,718,31053,42596
45365,11836,61792,73727,7660,76646,84854,4176,35408,46658
45363,564,86250,109750,438,92083,116392,126,48750,85749
45362,504,58000,71297,396,66167,77434,108,50000,45528
45361,115,48393,50965,80,57500,55216,35,33958,34094
45360,182,35357,60203,97,64688,85887,85,17019,30232
45359,674,60441,66808,472,65000,76340,202,31429,42240
45358,95,59750,68101,74,62500,69623,21,36875,52590
45356,10072,50435,61571,6070,69617,75802,4002,31745,38159
45354,261,50938,60897,192,55625,65513,69,33750,44806
45353,72,55714,49992,38,0,60461,34,0,38291
45352,103,44583,62864,46,58750,78913,57,0,49581
45351,90,80833,80664,59,90625,96139,31,46250,51213
45350,19,108750,110047,19,108750,110047,0,0,0
45349,135,67981,67910,85,74875,81294,50,26667,35066
45348,258,88571,89007,221,91066,94909,37,58750,53759
45347,1805,51595,59815,1160,72813,72790,645,25885,34352
45346,894,67143,74905,719,71750,81209,175,36726,43668
45345,2475,60236,63211,1822,67957,70630,653,30579,40852
45344,6669,56706,78574,4835,70726,82390,1834,32514,63320
45342,14406,68389,82836,9229,81806,96444,5177,42105,55240
45341,1535,45347,56816,1046,55833,59412,489,26620,44725
45340,209,73750,75782,166,81667,85922,43,26917,36635
45339,507,62325,84896,348,91321,103171,159,51150,44201
45338,1983,58633,69577,1330,71724,80438,653,39356,45286
45337,564,72841,77539,407,81250,84682,157,61369,55389
45336,52,58500,82485,44,65833,92852,8,0,25463
45335,2753,68810,79277,2063,81509,90843,690,33167,40064
45334,861,61544,78950,551,71534,94791,310,30769,42626
45333,415,77989,75947,365,87887,79662,50,40333,37552
45332,278,48833,82738,194,43158,88847,84,82692,65451
45331,9847,46852,62831,5935,63750,76751,3912,26768,39114
45330,321,57361,59762,247,70301,65685,74,30313,34201
45328,221,46250,50733,149,53125,60121,72,22857,27161
45327,3463,76917,80711,2734,85947,89509,729,42825,42719
45326,352,73700,77970,258,80000,87479,94,48750,50414
45325,1043,73688,83443,728,77454,91319,315,0,63748
45324,17495,51379,64509,9490,65708,77356,8005,36363,46966
45323,2122,63367,81418,1403,81771,90204,719,32023,63395
45322,9418,64731,78955,6114,78694,94042,3304,39346,48712
45321,385,56781,59475,271,60219,64252,114,39875,47852
45320,6338,61719,74425,3960,78423,89873,2378,29900,44777
45319,135,59821,73345,78,78750,87927,57,39306,49989
45318,2216,53387,67079,1540,69243,80580,676,28585,34648
45317,408,90000,85457,386,95625,87909,22,0,42445
45316,41,67750,74937,26,88750,76754,15,62344,71780
45315,1546,85318,90903,1046,96364,103648,500,47037,54719
45314,1189,75202,96653,852,98750,118603,337,29479,36133
45312,378,70000,87984,274,80536,89551,104,47222,83171
45311,2307,59484,76692,1837,68646,83151,470,26583,34344
45310,98,74375,91504,79,79375,99992,19,63750,56211
45309,5342,64022,79876,3514,77616,97663,1828,41311,44137
45308,1707,59098,70692,1378,66188,76059,329,32171,44087
45307,147,38646,45757,120,37708,44528,27,41250,43030
45306,833,62868,77456,572,78611,85686,261,42375,54822
45305,4423,102319,121934,3276,124375,141602,1147,64628,64233
45304,2757,61046,76966,2115,76400,83674,642,33529,49171
45303,847,60324,68409,636,71286,77889,211,36023,36432
45302,1554,75761,90074,1294,87308,97166,260,51667,51290
45301,86,96080,84433,62,0,0,24,0,0
45255,9110,69028,99464,5837,101905,128499,3273,34129,45837
45252,2085,95694,115264,1580,122500,133341,505,46691,51080
45251,8497,62111,77016,5915,67881,82014,2582,39769,57766
45249,5518,86726,128229,3825,121503,159650,1693,52083,57161
45248,9730,75625,98270,6537,92347,114998,3193,44425,58790
45247,9084,87786,102325,6643,101677,118322,2441,45732,54037
45246,6025,59141,81731,3273,72220,90221,2752,38824,70532
45245,8708,66197,91393,5806,85370,106125,2902,44853,57230
45244,10969,97353,151248,8483,128202,179161,2486,34056,51075
45243,5633,143004,207970,4547,161679,240066,1086,54432,71346
45242,8852,100911,139693,6134,121880,164782,2718,53630,78406
45241,10063,86658,121204,6280,110116,136884,3783,64067,92708
45240,10090,61035,73923,6766,70235,81626,3324,39908,55273
45239,12333,50863,61991,7362,66478,72970,4971,35335,44165
45238,19387,53777,67514,11696,69208,81865,7691,30821,41431
45237,10071,38542,53165,4992,51453,67975,5079,26608,36139
45236,11653,66042,83381,6055,93720,109230,5598,42703,54477
45233,5966,86010,103868,4491,102904,121375,1475,32209,48754
45232,3066,21877,33052,1961,23766,34530,1105,20006,27175
45231,16397,56774,69816,10886,65741,79002,5511,37050,47693
45230,11671,74548,98082,7302,95670,118392,4369,42789,61265
45229,6503,28454,57814,2660,54144,95302,3843,14812,30146
45227,8796,56661,78029,4427,69008,100352,4369,42160,53484
45226,2712,90195,133934,1270,145395,183722,1442,56684,86811
45225,4007,16672,25685,2392,16963,26133,1615,15259,23541
45224,9590,48647,60747,5215,65443,73938,4375,32577,44036
45223,5373,44865,61908,2399,53750,72985,2974,35913,51624
45220,6541,40296,72910,2239,96815,124347,4302,27029,45455
45219,6630,31177,42307,1239,39653,62542,5391,30269,36948
45218,1572,68108,69734,939,77192,83572,633,45602,45298
45217,2862,54811,74925,1791,76354,93525,1071,33901,42869
45216,3544,37125,49825,2053,43969,55324,1491,30179,40123
45215,12690,55990,86917,7514,75503,109786,5176,36412,51620
45214,3687,20931,36808,1518,26224,42086,2169,15245,32541
45213,5204,62289,79694,3042,86957,96282,2162,38375,54361
45212,10252,45919,65081,4311,65148,83696,5941,36528,48406
45211,15452,45419,60204,8279,55893,71584,7173,34461,44026
45209,6049,73206,95141,1997,123166,146741,4052,54833,69331
45208,8575,116338,166533,4316,167500,228203,4259,69543,100694
45207,2287,35713,79891,1040,37361,130202,1247,32917,36913
45206,6112,40162,70054,1892,81630,114488,4220,37043,49744
45205,7353,29612,41369,4458,31122,44837,2895,21169,32961
45204,2760,39383,67044,1312,42072,96592,1448,29937,38160
45203,1271,21169,50775,413,19889,51858,858,25172,49535
45202,8131,77927,112726,2358,112000,172181,5773,66703,87762
45177,9111,52120,68000,5470,67477,83762,3641,35593,42319
45176,3842,56798,80378,2806,68469,95022,1036,25061,37205
45174,724,176042,250819,621,183068,268468,103,82750,142329
45172,95,90642,71593,71,91047,83023,24,29583,28392
45171,2355,57047,74764,1648,58955,73958,707,47139,70893
45169,1784,53783,65223,1230,64762,76424,554,29028,36778
45168,718,56481,61741,536,54583,63221,182,0,49225
45167,1510,53917,70161,1044,54615,77319,466,30645,45849
45166,38,0,0,15,0,0,23,0,0
45164,110,47500,48455,76,56000,57164,34,0,26456
45162,908,77833,87981,761,89875,94457,147,36691,39318
45160,408,16413,35451,251,0,42908,157,14097,21817
45159,1381,63363,71139,1031,68272,77838,350,43558,48371
45158,143,53250,66173,105,56750,66389,38,29500,47047
45157,3734,74842,90880,2799,91144,101677,935,31649,52235
45156,21,51250,88405,15,46875,98440,6,0,51883
45155,138,59500,62104,103,59250,65150,35,0,39860
45154,3308,70750,75011,2285,82111,88262,1023,35313,41563
45153,672,61591,80543,468,87903,95656,204,45547,43741
45152,3864,85690,102834,3219,91615,109740,645,50568,59320
45150,13277,77989,96286,8976,97426,116814,4301,36285,50564
45148,560,48452,58412,444,56304,66231,116,0,26781
45147,76,51607,66283,46,0,88374,30,0,32410
45146,510,63278,79707,354,65000,90083,156,40500,53850
45145,10,0,0,10,0,0,0,0,0
45144,1592,33622,53600,1091,42313,66158,501,18519,24642
45142,1426,54741,66280,1049,58811,74472,377,0,35394
45140,20853,94321,118619,15405,117609,136288,5448,51892,64210
45135,2054,70378,73178,1477,75239,83058,577,39250,44675
45133,9359,43153,58041,6495,55774,68529,2864,22563,30258
45132,131,38854,41392,71,59792,48631,60,25938,28640
45131,109,36023,48622,61,36932,46797,48,0,50025
45130,1566,63716,66696,1092,75083,77346,474,24885,37138
45123,3411,53691,61911,2329,68750,72969,1082,24948,34362
45122,4295,65153,75110,3289,70239,81273,1006,35764,46507
45121,3511,44744,55948,2234,61667,70199,1277,15475,27320
45120,1180,54565,67472,715,67901,77235,465,47255,49774
45118,1450,73523,82483,1113,83137,85538,337,32750,69542
45115,46,0,0,9,0,0,37,0,0
45113,1753,81235,115191,1379,88925,131531,374,40909,48896
45112,25,0,98288,17,112917,88265,8,0,112463
45111,143,81406,87634,94,80000,89597,49,87250,83867
45107,3689,56348,66041,2703,69393,76375,986,25407,34155
45106,5012,58452,67542,3658,70156,75204,1354,33333,42447
45103,12564,68729,88325,8508,84386,101975,4056,41121,56954
45102,8584,65013,75915,5495,75489,83565,3089,40811,57065
45101,958,33727,45191,625,48257,53327,333,15991,27070
45070,53,53125,53004,27,69583,69433,26,31250,35535
45069,19561,102424,124848,14404,118933,141764,5157,62764,73938
45068,4411,84347,111237,3417,99271,128003,994,36625,50458
45067,4846,79478,84831,3869,87275,92910,977,36528,41119
45066,8568,112431,131423,7183,123279,139180,1385,56060,83270
45065,1994,112083,135978,1630,125682,144974,364,0,91579
45064,1210,81667,96783,1008,91000,104966,202,43333,49403
45062,227,60469,72468,175,57344,75606,52,44833,47017
45056,8565,49811,68465,4054,95248,106160,4511,21195,33494
45054,1097,100411,138287,822,104688,160792,275,46890,56882
45053,1276,97226,110389,1060,106121,114281,216,34333,80333
45052,1604,84518,99527,1233,105054,115893,371,33918,40446
45051,0,0,0,0,0,0,0,0,0
45050,3331,89080,98160,2400,99451,109152,931,46458,61939
45044,19737,59742,82306,13633,80120,97299,6104,32048,44980
45042,11414,56515,74739,7319,74838,90479,4095,32973,43143
45041,106,0,0,0,0,0,106,0,0
45040,20480,110934,152895,15879,128691,174417,4601,57852,74369
45039,9796,95870,124703,7831,104210,136813,1965,57953,70501
45036,12613,77471,122543,9103,95938,121906,3510,47780,119521
45034,406,66027,90125,206,121250,119830,200,58750,57167
45033,87,28750,42837,41,84063,60961,46,27700,26683
45032,207,43661,51265,101,53304,57422,106,34000,45398
45030,7830,74843,86260,5492,88460,100635,2338,31756,49011
45015,4776,43673,52232,3048,50127,56107,1728,36469,41191
45014,17807,63228,78992,11592,76567,93038,6215,37978,47615
45013,20658,62108,75492,13914,72416,86899,6744,34107,46072
45011,25435,74815,91863,18720,88287,103390,6715,33731,53619
45005,12685,61200,75823,8886,75429,86961,3799,38702,46204
45003,191,45987,56848,121,54464,67401,70,35833,36823
45002,4913,80694,104288,3463,98517,117616,1450,41481,69068
45001,211,44028,64402,141,41161,68463,70,41250,41639
44907,7039,38321,50407,3448,47951,62311,3591,33970,36905
44906,7341,42156,57646,3984,60605,73687,3357,31308,36837
44905,4804,47456,56524,2851,55379,63532,1953,35504,44822
44904,5819,64355,75935,3817,82192,93728,2002,30400,40915
44903,9571,54117,68480,6365,65721,78119,3206,28476,42127
44902,1989,25026,38650,1065,33224,46731,924,16938,25260
44901,0,0,0,0,0,0,0,0,0
44890,4039,58655,69310,2707,68689,76625,1332,38750,47587
44889,2782,65833,77268,2030,77813,86025,752,46667,50458
44887,323,67227,100473,236,75455,120942,87,50781,44455
44883,11454,50446,65423,6891,62254,79279,4563,32405,40619
44882,1119,66797,81235,772,74808,97268,347,30341,42461
44881,15,0,0,15,0,0,0,0,0
44880,1009,63852,72989,834,73512,79310,175,44375,42862
44878,915,65859,77224,790,70833,80498,125,49028,54251
44875,5856,53380,60288,3681,72361,72987,2175,26011,36244
44874,117,61406,60123,72,66667,74244,45,28958,35940
44870,16987,47989,63453,9965,62431,74459,7022,30456,44262
44867,990,67292,77432,815,67697,79390,175,57813,63444
44866,814,53952,68046,539,66289,73338,275,0,57479
44865,1072,62750,71643,801,68713,76811,271,39297,46683
44864,1432,49464,60784,1051,56544,66591,381,34926,39053
44861,19,0,0,10,0,0,9,0,0
44859,828,81794,81639,647,80162,81951,181,38147,42204
44857,9939,51912,66350,5876,70172,81709,4063,35179,42329
44856,128,30625,32916,65,35938,37689,63,21657,26078
44855,453,53250,61485,395,54267,62205,58,21694,28833
44854,664,49688,67189,390,59451,83454,274,41341,42247
44853,551,73438,75299,408,75000,81211,143,35536,52103
44851,1894,50812,60701,1299,64050,68421,595,30806,40145
44850,13,0,0,7,0,0,6,0,0
44849,918,60144,73619,626,65833,86598,292,32500,44141
44847,1451,67568,74257,989,77519,84221,462,41304,51499
44846,1130,80441,99158,941,81292,105432,189,44952,53575
44844,235,62361,105509,167,80568,134216,68,27708,33646
44843,952,69804,74055,679,70188,80757,273,0,53922
44842,2099,51083,70213,1425,70542,78167,674,30975,49260
44841,272,75929,77304,190,80500,77571,82,75286,65901
44840,995,70375,88772,736,85192,97654,259,57277,55531
44839,5420,66554,100837,3663,83477,122618,1757,39880,50644
44838,74,65833,74574,51,65208,84859,23,0,40804
44837,1531,50259,60056,1129,57074,66071,402,19839,38919
44836,1000,64611,73150,642,72083,81543,358,44338,52488
44833,7052,45692,59037,4434,56984,73062,2618,25648,34236
44830,7484,47106,60880,4625,61338,70549,2859,31853,39514
44828,65,23988,30537,30,0,0,35,0,34171
44827,2945,47939,62552,2072,60550,73686,873,29089,33177
44826,560,65938,68197,403,73523,74353,157,46583,50494
44825,37,45893,44941,34,45714,44129,3,0,0
44824,1461,53516,74100,1006,72813,79271,455,31729,49484
44822,1183,52204,64531,869,55750,70245,314,26711,38278
44820,7519,47357,63891,4727,59970,75736,2792,32550,40546
44818,933,54821,68720,711,62772,75982,222,34474,41985
44817,592,72750,80174,461,83750,91505,131,25893,30720
44816,15,0,0,0,0,0,15,0,0
44815,288,51250,61717,153,77578,83290,135,40509,35535
44814,947,67336,82461,672,92625,100871,275,25391,35825
44813,3227,65460,71497,2438,72675,78693,789,34934,47114
44811,5027,58491,76158,3344,69874,90458,1683,32161,42687
44809,104,41944,46767,70,41806,52076,34,47639,35838
44807,957,57768,66164,550,69773,78510,407,40781,40295
44805,12686,53258,69484,8188,68019,82384,4498,30866,43779
44804,474,77917,80953,327,84375,89089,147,65750,59275
44802,394,64167,76688,273,68988,85906,121,41063,49967
44730,2548,53316,68050,1768,61425,75107,780,40375,47293
44721,5597,80888,93160,4068,86460,103657,1529,44645,58077
44720,16313,69641,97453,10089,93020,114662,6224,42225,67511
44718,5619,73125,108088,3585,99191,135265,2034,41176,58442
44714,4110,50567,59274,2339,63259,72208,1771,29982,38833
44710,3436,43932,51906,1978,49307,57182,1458,29932,41461
44709,8312,41721,56445,4202,59940,72852,4110,30161,38073
44708,10848,52962,70904,6678,69928,84831,4170,30502,45883
44707,3560,29310,42400,2158,38281,48966,1402,20618,30127
44706,7255,49041,59520,4555,59603,70477,2700,33021,38872
44705,7422,32874,47485,4579,41796,51463,2843,25271,36665
44704,1393,23477,39231,617,30388,37668,776,18258,39035
44703,3779,30037,42575,2045,34906,47740,1734,22838,34267
44702,505,10514,15784,43,19479,32412,462,10083,14237
44699,318,48750,59490,212,51563,71097,106,33750,36277
44697,93,0,73963,75,0,83387,18,23750,34456
44695,639,48994,54708,446,56786,63757,193,26161,32103
44693,8,0,44113,1,0,0,7,0,0
44691,18705,59149,72216,11397,69648,88061,7308,31812,42855
44690,71,0,74918,44,98250,94627,27,0,0
44689,227,54196,63965,173,66250,75520,54,19231,25637
44688,1291,49945,81030,904,64167,97019,387,28450,36422
44687,22,0,25568,2,0,0,20,0,0
44685,10505,86349,102265,8073,97882,114502,2432,42448,57476
44683,3087,46670,52605,1955,57375,61971,1132,25735,32591
44682,358,69038,67311,288,72188,71066,70,31429,41581
44681,2577,66926,84775,2187,74313,92465,390,30500,38085
44680,1744,60833,76835,1190,72900,90948,554,30491,45103
44678,82,98106,73068,82,98106,73068,0,0,0
44677,950,53333,69766,652,62917,77036,298,36048,50257
44676,1745,65181,76068,1273,76890,89586,472,26806,37888
44675,889,70911,82591,532,71810,71330,357,0,99372
44672,2110,39132,55189,1204,52197,69155,906,27813,33815
44671,54,76111,69667,36,0,0,18,0,0
44670,51,54063,51949,42,60938,60790,9,0,0
44669,579,66094,73124,354,64643,76016,225,65885,65256
44667,5052,60014,76090,3587,69854,86747,1465,42177,48319
44666,1131,72550,83658,780,91327,97195,351,40979,48534
44663,10988,49503,60842,6785,59175,72389,4203,29438,38978
44662,3819,61949,73442,2670,79289,85160,1149,38229,42854
44661,90,37244,48593,66,46250,52829,24,36094,32917
44659,47,48750,48777,31,58750,60568,16,28750,25938
44657,3971,60992,72951,2733,68700,79769,1238,39583,51958
44656,978,71563,80802,692,75179,90223,286,41328,56191
44654,5797,64845,81288,4648,70518,90687,1149,29774,41698
44653,247,46550,49181,176,46522,46738,71,43375,45352
44652,0,0,0,0,0,0,0,0,0
44651,336,46630,58183,179,72102,78150,157,0,34092
44647,8056,53430,64608,5193,66782,75569,2863,31858,41226
44646,19448,57106,75493,12828,67803,86984,6620,33169,49409
44645,1030,72197,83226,787,74635,85347,243,57417,68074
44644,2403,47843,66467,1330,68492,84996,1073,29583,39738
44643,1575,50889,61055,1188,51944,62637,387,36790,48801
44641,8016,67914,75700,5612,79505,90332,2404,29474,39026
44640,73,51875,64696,58,60000,66666,15,35313,30353
44638,412,56000,77868,316,73125,70526,96,15625,102036
44637,921,49261,59212,674,64344,70955,247,17583,24112
44634,966,52500,65003,653,59877,79232,313,19727,34550
44633,673,63399,85884,550,73182,91912,123,32188,33592
44632,3754,68507,80573,2736,85469,92573,1018,39278,44041
44629,1181,70987,73607,968,77201,81191,213,24492,31011
44628,362,52632,74870,252,58864,96131,110,23387,24942
44627,1679,67478,97966,1543,72134,103967,136,22667,24738
44626,1202,69038,73581,768,91935,91002,434,26300,39181
44625,510,77738,74600,462,79167,78675,48,0,35375
44624,1634,84635,97261,1515,87270,100797,119,0,32903
44622,7159,60398,78177,4514,76964,91744,2645,35813,51420
44621,1646,49619,59702,1077,55969,65711,569,40848,45037
44620,713,52448,77891,486,58929,90596,227,34375,47278
44618,2456,63798,75322,1927,72760,84916,529,27250,36960
44615,3908,53645,68952,2834,63864,80170,1074,33622,37047
44614,5378,71792,81661,3747,86871,96351,1631,32055,42446
44613,791,45711,56795,582,58750,63301,209,29861,32388
44612,2025,70521,75070,1302,82778,88425,723,40911,49343
44611,834,44083,61715,598,54527,73577,236,32708,28779
44610,55,61688,50847,41,0,0,14,0,0
44609,1512,47000,63982,974,64100,80878,538,23354,31925
44608,640,48816,62311,451,62723,70239,189,31875,35208
44607,41,0,48705,16,0,0,25,0,22556
44606,2266,63125,78183,1832,72831,85875,434,27365,36529
44601,14177,48754,61360,8634,60283,73877,5543,27373,38777
44515,12503,46373,59142,7168,61460,71431,5335,32308,40633
44514,9330,68031,84667,6231,85336,101069,3099,35439,48690
44512,14343,55901,70924,8029,78136,88765,6314,35591,45839
44511,9244,43992,57124,5132,60881,72904,4112,27120,34222
44510,959,17666,25214,661,18478,25711,298,14709,22498
44509,5589,29438,43818,2901,40218,51118,2688,26113,34150
44507,1999,22453,31823,1099,31536,38710,900,13750,20365
44506,1147,32957,37908,703,34135,38385,444,18816,33183
44505,7273,27971,45679,3959,33605,58541,3314,20101,27303
44504,2271,39284,58457,1028,58197,74287,1243,30313,45294
44503,563,9015,13254,12,0,0,551,9114,13494
44502,3643,30993,37791,1933,32048,42320,1710,23466,28981
44493,28,0,0,28,0,0,0,0,0
44491,992,56170,67871,778,61250,72616,214,43333,46336
44490,324,42115,48394,235,41518,51217,89,35938,34155
44485,7038,25474,40698,3468,39870,52360,3570,16909,27950
44484,9155,55254,71549,5719,62695,81134,3436,31545,51059
44483,11279,38028,50051,6348,48519,60153,4931,25497,33704
44481,3779,50104,63234,2454,66117,77114,1325,30334,34887
44473,1584,58229,75660,1012,77841,90279,572,38256,47687
44471,4503,40686,55823,2816,49022,64336,1687,26826,39978
44470,1598,61026,70701,1188,68438,79154,410,25900,37909
44460,10380,48926,66518,6234,70047,79531,4146,30087,43302
44455,864,80592,71323,692,84552,77927,172,50261,42938
44454,445,50159,56432,362,50636,55545,83,38125,46811
44452,1414,67426,78263,961,71984,93502,453,0,43288
44451,1184,63056,80762,799,76964,88086,385,32946,62508
44450,765,50060,58354,588,56818,64577,177,29205,33512
44449,576,53654,66733,342,87619,92088,234,25625,29083
44446,9146,44034,58469,4978,59529,75421,4168,26846,35211
44445,1191,49880,68758,828,70833,80543,363,25527,37205
44444,4452,49691,63084,2449,66010,81826,2003,28401,36592
44443,633,64931,69460,447,68875,80364,186,0,43254
44442,1676,52679,89468,1144,64762,109024,532,33125,44056
44441,685,71146,76156,480,58393,70125,205,0,79055
44440,1961,60231,68859,1279,81241,82829,682,36037,41571
44439,67,0,45412,9,0,0,58,0,50267
44438,2144,32632,43678,1018,42500,58643,1126,24177,29209
44437,1745,54136,63386,1225,63693,71086,520,33043,43241
44436,1547,60673,75316,1050,73068,80056,497,26185,61329
44432,4159,49278,64999,2790,61896,71331,1369,26520,45905
44431,1888,60342,74136,1297,68894,83810,591,31969,49284
44430,1566,46310,52965,1185,41683,54086,381,37422,47819
44429,1178,57273,74690,794,68750,92032,384,33864,36505
44428,1294,48777,65713,872,60208,77890,422,32000,37732
44427,488,26776,52761,197,0,83231,291,24001,28496
44425,5965,53395,70826,3931,68770,84844,2034,32098,41061
44423,1047,69830,74383,855,71630,78895,192,22500,35022
44420,6376,45601,67369,4046,58135,79879,2330,32742,44117
44418,503,76767,92670,374,85278,97083,129,55865,79876
44417,611,43612,54441,511,43005,56201,100,25833,34633
44413,2864,48885,59542,1719,57477,73508,1145,30788,35194
44412,1029,70406,83693,707,100179,99506,322,30750,46098
44411,697,70903,76144,512,79695,89514,185,37750,38761
44410,7657,61556,80256,5084,77649,92319,2573,42039,54213
44408,4352,54936,74285,2582,78716,93114,1770,26327,46244
44406,8582,84544,108202,6190,98367,124657,2392,52732,63066
44405,3213,31017,52032,2066,39189,56078,1147,18188,40433
44404,607,69602,68086,500,69625,68486,107,0,60817
44403,1813,50245,70269,1017,70301,95704,796,22378,36551
44402,1235,70134,82563,949,78523,93118,286,39875,45082
44401,1108,60446,73915,821,65724,82100,287,41728,46810
44333,7643,79982,146299,4962,107537,186791,2681,51727,69213
44321,6190,94737,113757,4098,108963,138923,2092,50056,63836
44320,8819,34375,48898,4885,42261,60516,3934,22439,34069
44319,9728,66395,80176,6236,81480,93071,3492,43568,53709
44314,8191,38881,50815,4541,46545,61601,3650,28161,33660
44313,12510,60073,83634,6571,76225,105444,5939,41762,57068
44312,13692,53594,67035,8486,71004,82376,5206,31030,40145
44311,3056,20291,32958,1217,28606,43049,1839,17512,25554
44310,10630,33708,46493,5559,42489,54259,5071,26897,35981
44308,286,13160,39222,12,0,0,274,12917,28889
44307,2878,23994,32352,1469,31028,38954,1409,17684,24186
44306,9015,36236,41892,5271,40551,46795,3744,22351,30842
44305,9249,44811,50168,5459,48819,55749,3790,31142,37342
44304,1382,21609,41772,333,17721,61101,1049,22128,35625
44303,3883,64679,88286,1654,84768,125527,2229,42424,58714
44302,2557,31273,43312,922,49674,58413,1635,24554,34581
44301,6218,45226,52948,3449,43220,55574,2769,38229,44957
44288,1280,47273,57287,902,60357,63916,378,33889,37613
44287,2818,73750,74627,2174,80531,84499,644,25227,36923
44286,2473,100216,160397,1696,133810,203876,777,42212,61101
44285,11,0,0,11,0,0,0,0,0
44281,13086,73204,92440,8701,92867,113283,4385,41299,48528
44280,1882,93203,107856,1403,108358,125136,479,41569,57004
44278,7076,76027,85509,4869,86015,96648,2207,45023,58754
44276,656,82500,133369,554,96591,147360,102,38625,42184
44275,1231,85274,93251,972,78958,95773,259,50750,57102
44274,70,0,0,70,0,0,0,0,0
44273,2899,69904,87009,2077,81285,98016,822,43421,53470
44272,2050,67212,77533,1468,83620,86961,582,33269,48941
44270,3401,52230,66947,2366,62147,76008,1035,30727,43839
44266,13832,53061,65574,8710,66256,78131,5122,29136,39264
44265,0,0,0,0,0,0,0,0,0
44264,1203,79736,114943,768,103929,142784,435,61991,64584
44262,2105,58906,79082,1306,77083,99175,799,35457,43765
44260,5176,60586,77618,3706,74138,85815,1470,39137,52112
44256,24611,86435,106809,18343,102375,122690,6268,41796,56117
44255,2984,60898,72686,2025,62438,80704,959,36157,46426
44254,1993,53784,64621,1200,67262,82311,793,29171,34624
44253,1195,90346,94508,886,99700,106218,309,31676,53389
44251,382,111071,132052,280,114833,138474,102,43125,105932
44250,469,47708,66593,309,51005,57295,160,36780,76365
44243,0,0,0,0,0,0,0,0,0
44241,6900,65032,75690,4270,76486,87443,2630,47568,53464
44240,16666,51398,70447,8753,81928,98740,7913,24307,35820
44236,9182,131726,166037,7587,147617,185698,1595,47147,71299
44235,583,66696,81192,431,72813,87828,152,57222,58713
44234,1301,70268,98677,937,86343,114512,364,45690,53818
44233,2948,107656,143923,2410,123804,158826,538,43939,71617
44231,3445,62409,71589,2290,76774,80065,1155,36571,48827
44230,3601,70996,86392,2564,89750,104661,1037,26935,38363
44224,16095,76552,95223,10318,91987,112769,5777,46632,60790
44223,7963,71787,82588,4808,88242,102119,3155,40454,50839
44221,12967,55975,65923,6924,70429,83239,6043,39551,44466
44217,1340,60625,68210,1025,64272,72219,315,30855,40832
44216,3376,78828,88501,2667,86145,96086,709,55781,54308
44215,944,60000,67884,634,69375,78709,310,34808,42441
44214,732,83235,99391,595,93112,107723,137,28063,32861
44212,17532,71554,85359,11579,92492,102491,5953,41802,49153
44203,17077,50017,68104,10234,63982,77534,6843,30602,50880
44202,7680,103790,132550,5375,120893,158458,2305,45750,68532
44201,2476,70296,80633,1728,89516,94476,748,40425,47471
44149,7892,99351,119435,5643,120941,140686,2249,52977,63894
44147,7961,87900,122037,5624,106848,141332,2337,62887,69786
44146,14269,46648,59590,6824,66767,79733,7445,36757,39298
44145,13779,92917,131276,8168,123194,170705,5611,54507,71727
44144,9415,46647,58976,5305,51104,65257,4110,36354,43421
44143,10783,64679,90134,6364,93531,115480,4419,35536,52453
44142,7768,56302,64320,4930,66182,74470,2838,34083,42972
44141,5586,105515,132278,3899,120969,157137,1687,52401,73200
44140,5860,102938,136773,4128,124128,154028,1732,62986,93636
44139,8622,114047,157903,6584,142308,187715,2038,46786,58037
44138,9089,80326,96654,5894,93699,112481,3195,40722,64808
44137,10043,42475,52023,5910,45078,55911,4133,37358,40678
44136,10610,80843,102920,6839,104837,120374,3771,50417,68641
44135,11733,39768,56015,5865,51578,67220,5868,30123,40706
44134,15865,55087,67851,9380,69507,78786,6485,38219,49084
44133,13145,69588,98886,8353,94952,122348,4792,44896,54643
44132,6381,37786,50592,3535,49781,62190,2846,25817,33130
44131,8377,84405,105143,6002,101674,121757,2375,50898,61652
44130,22153,60022,69657,12645,74824,85290,9508,36363,46666
44129,11852,58460,67434,7379,70647,78526,4473,41210,47636
44128,12946,36847,46513,7705,44060,51031,5241,28560,38765
44127,1960,25792,33133,1142,28605,36275,818,14250,21421
44126,7150,63814,83858,4241,83386,99096,2909,49979,59349
44125,11500,48385,60614,6734,60146,70052,4766,30600,43310
44124,17329,66117,99828,9788,85014,126611,7541,42351,63303
44123,8147,42711,53123,4008,50773,67018,4139,34755,38507
44122,13955,83621,137505,8625,112334,170349,5330,45558,83016
44121,13396,54846,65551,8024,66661,77103,5372,34456,46137
44120,17128,37733,65196,8106,62092,94621,9022,23248,37806
44119,6154,37295,53108,2903,48340,70437,3251,29469,36599
44118,15919,63679,96487,9109,90343,124059,6810,40744,57768
44117,4919,34778,48110,2322,50313,70410,2597,17328,27830
44116,9038,81319,132285,5094,125238,178523,3944,47660,70569
44115,4387,15034,35556,1505,9843,34640,2882,17713,35690
44114,3806,43159,55998,783,34395,66089,3023,44679,53042
44113,10043,63658,90602,3081,73405,118067,6962,61529,77818
44112,9525,26236,37145,4841,37907,50148,4684,15363,20739
44111,18438,45425,57751,10639,55746,64833,7799,33618,44561
44110,9767,25244,32442,4017,31861,42491,5750,15965,24142
44109,17427,35987,47929,8952,41621,55671,8475,24186,37123
44108,10007,27325,50585,5183,36723,69737,4824,18643,28460
44107,25489,54515,74812,10319,81947,101247,15170,42432,55509
44106,11050,30669,65431,3517,71726,122438,7533,19640,37878
44105,15187,31248,39581,8032,35837,45475,7155,23876,30054
44104,8559,16650,28142,4425,18514,32860,4134,14824,21321
44103,7172,21468,33851,2943,28975,41391,4229,15204,26589
44102,20377,32289,52846,9376,37023,66929,11001,24421,38419
44101,0,0,0,0,0,0,0,0,0
44099,727,50250,83110,595,57422,96860,132,17269,20697
44095,14627,59038,69290,8451,70906,84003,6176,39500,46781
44094,16345,65004,87778,9328,88145,111771,7017,39035,53294
44093,437,80938,74618,264,95153,89745,173,50268,50610
44092,7697,59330,72126,4163,74612,88021,3534,40909,52340
44090,4339,69401,76933,2999,81495,91963,1340,27421,40987
44089,6591,66050,97886,4306,79148,117812,2285,40286,55863
44087,8574,82701,108553,5731,103502,134601,2843,44961,51950
44086,966,73897,88399,664,78077,101793,302,49500,54825
44085,1308,59167,78600,1018,62969,84672,290,43958,52373
44084,1190,62910,77491,827,74338,85242,363,52902,51273
44082,545,51709,62931,359,50944,52568,186,36231,41122
44081,2524,78511,91607,1982,90880,101709,542,35577,44986
44080,109,47277,49614,59,57621,52692,50,0,45982
44077,22249,65801,85183,14348,83415,104106,7901,35988,46857
44076,1852,47965,61552,1081,57375,77452,771,34539,33647
44074,3780,57139,81747,2260,74167,104213,1520,31566,47141
44072,1740,90250,122292,1175,97386,138027,565,69141,89567
44070,13040,71784,89859,8531,84854,97711,4509,45625,72002
44067,8469,78404,94637,5510,93692,112008,2959,49925,61213
44065,1811,76776,110607,1374,99815,133548,437,35925,37777
44064,714,70625,89595,399,101250,102177,315,48958,71602
44062,4229,60771,74779,3125,70578,85166,1104,36582,43935
44060,25247,72261,88135,16389,91563,104483,8858,44511,53099
44057,7503,64406,75711,5278,74643,84976,2225,41394,47757
44056,4671,96029,123308,3387,112399,140339,1284,50357,78383
44055,8116,33054,41066,4362,42895,49353,3754,21167,29167
44054,5305,64063,82253,3586,78646,92374,1719,42394,54906
44053,8104,53775,68748,4789,71124,84683,3315,35318,43763
44052,11494,36161,48014,6859,43636,55690,4635,23449,32759
44050,2426,77014,85785,1800,97898,95313,626,49097,54859
44049,76,54583,63463,64,55938,67511,12,53000,41875
44048,829,53064,68828,657,61205,78826,172,26538,27475
44047,3327,51250,67281,2066,70658,84815,1261,21935,35211
44046,866,52012,75517,603,70366,89751,263,40386,42881
44045,258,64432,73067,181,75875,83491,77,29489,42887
44044,4188,74464,92757,2958,82266,103435,1230,48500,64340
44041,6326,43015,60975,3560,61500,79555,2766,27407,35221
44040,1109,178750,256342,908,215313,281476,201,0,142315
44039,12730,77433,91881,9001,84251,98235,3729,52017,71587
44035,27155,45646,58496,15839,57922,68592,11316,32314,40553
44032,387,37240,142907,305,43958,160871,82,26750,43038
44030,6267,50587,59931,4238,58250,69646,2029,25039,35382
44028,3632,79219,107515,2574,95598,126537,1058,26100,56568
44026,4441,84566,111711,3271,103692,128152,1170,39056,51022
44024,9007,83750,105085,6578,109583,122485,2429,41890,52442
44023,6800,109727,146083,5214,126280,162116,1586,65156,85695
44022,6876,124049,209278,5189,139290,226598,1687,68342,152981
44021,2222,68133,88345,1502,80400,101153,720,48148,56343
44017,7053,60432,75421,4057,85008,95296,2996,38598,46181
44012,9912,82994,109667,6621,110228,132897,3291,37866,60613
44011,8496,109539,132460,6579,134837,150839,1917,34268,64709
44010,558,55446,65603,380,65625,69472,178,25735,50704
44004,13399,41577,53862,8131,53903,63917,5268,25202,35363
44003,1666,52924,65817,1198,54883,71885,468,23048,30253
44001,8208,75301,93247,5807,86349,104247,2401,34713,61724
43988,1011,52550,57691,650,62628,64310,361,32875,42351
43986,784,37105,51417,484,63289,68682,300,15236,19755
43985,22,48750,60005,19,0,57768,3,0,0
43983,190,76438,67551,87,75817,64299,103,80040,70298
43977,814,52159,61778,522,62097,74893,292,23333,36316
43976,633,44583,64831,450,60500,77174,183,35163,34087
43974,32,57000,74447,26,70000,81619,6,0,0
43973,898,47500,57044,671,60650,61195,227,24028,42774
43972,79,23974,30343,24,0,0,55,0,0
43971,504,41974,66245,278,68750,85620,226,27105,42094
43970,0,0,0,0,0,0,0,0,0
43968,2750,51980,63998,1634,52500,59853,1116,48804,68012
43967,0,0,0,0,0,0,0,0,0
43964,3890,42957,60208,2370,59792,72492,1520,26975,39073
43963,599,39145,50595,322,57813,67064,277,22446,30712
43962,32,38750,60581,23,0,76639,9,0,19556
43961,177,31023,49084,94,44286,46551,83,27344,48869
43953,4664,60125,68830,3154,73125,76898,1510,29375,46630
43952,7339,39106,49898,3820,55994,62839,3519,21560,33732
43951,20,0,0,7,0,0,13,0,0
43950,5148,70030,86059,3632,86809,100213,1516,42708,49144
43948,253,63984,97441,220,64531,92119,33,0,110124
43947,2107,55517,65708,1329,66541,78811,778,35451,38199
43946,958,53333,64024,636,55000,66843,322,49900,57571
43945,1195,38375,47691,800,45714,55635,395,23603,27667
43944,1040,57341,73295,795,68125,83439,245,28397,40380
43943,1244,48456,57399,900,58654,67266,344,24091,29561
43942,1033,46250,73197,668,69750,93596,365,25573,32395
43940,256,0,38073,213,24427,37363,43,0,29637
43939,165,58942,69148,120,59375,68303,45,52708,65727
43938,2414,47073,64107,1775,53686,68515,639,28906,47767
43935,3577,47390,59160,1991,65622,69249,1586,28347,43634
43934,160,39904,52939,99,56528,64374,61,0,34380
43933,822,47000,63648,598,58448,72996,224,33333,38691
43932,393,57760,72595,298,59063,59414,95,0,112643
43931,120,0,91588,86,0,109721,34,0,0
43930,314,68250,80417,241,81719,93036,73,0,32693
43928,39,92679,90805,39,92679,90805,0,0,0
43927,76,41959,44841,68,41689,42251,8,0,0
43926,93,40625,44997,50,49750,57082,43,28750,30695
43925,45,0,0,0,0,0,45,0,0
43920,9259,41831,56229,5736,57734,67515,3523,24473,34904
43917,1466,54118,75860,1008,62984,78155,458,22973,68398
43915,487,44712,58811,308,70000,68619,179,35398,40138
43914,29,60234,47528,18,40833,38711,11,0,0
43913,579,40406,48815,343,50481,53935,236,32237,31608
43912,2777,44789,54193,1617,55341,66409,1160,30042,34529
43910,1400,62115,87115,968,74634,102574,432,48750,50060
43908,575,42019,46506,420,48688,50806,155,25288,33288
43907,2331,50774,66273,1440,69500,78608,891,27743,45227
43906,3210,36738,54967,1906,51000,65825,1304,24878,36747
43905,40,0,97630,40,0,97630,0,0,0
43903,762,38864,61698,496,45857,73226,266,32337,38717
43902,55,78750,79620,55,78750,79620,0,0,0
43901,771,58304,75181,554,61458,81340,217,33523,55539
43845,1766,47118,55628,1256,57056,64011,510,26461,29109
43844,1694,48591,58876,1217,51425,60894,477,30352,44020
43843,299,59948,63176,206,75278,71684,93,0,41073
43842,149,31648,43031,77,32891,44088,72,0,41900
43840,421,49306,58716,274,56875,61334,147,34671,50835
43837,710,44167,55478,497,64013,70046,213,0,19324
43836,66,55000,56244,43,62292,72181,23,26250,26443
43832,3194,47326,55999,1992,60962,67043,1202,28364,34676
43830,2139,73343,96574,1716,88906,109547,423,33777,39270
43824,1352,52228,70000,1056,62000,79793,296,27386,34312
43822,2062,50780,59605,1295,57172,68698,767,45757,42117
43821,1436,57813,68743,1054,73561,81833,382,21636,30010
43812,7832,47026,58334,5023,58837,66578,2809,24264,35216
43811,290,38750,55150,169,50694,69191,121,21950,35539
43805,78,0,52908,72,0,0,6,0,0
43804,957,62880,81094,838,70278,86693,119,0,28928
43802,380,68214,76642,346,70833,79122,34,53333,45882
43793,2017,42238,61427,1224,60897,79128,793,22266,32330
43788,274,24747,44013,165,41146,54155,109,23782,24153
43787,1246,44156,54023,919,45324,58880,327,24464,33157
43786,11,26250,34645,6,41250,49583,5,14063,16720
43783,1821,63398,66967,1300,67353,70882,521,36386,50284
43782,224,54500,57762,186,74375,62109,38,0,35258
43780,859,55396,100012,535,68164,115059,324,34917,73167
43779,271,47370,49090,229,51128,56863,42,0,6705
43778,482,59500,78395,376,73864,91616,106,30000,29437
43777,1982,44167,57005,1465,48822,61044,517,25865,32357
43773,1195,42930,53472,832,50921,59970,363,26023,35518
43772,777,56845,65270,627,54470,64103,150,32031,39877
43771,844,46484,57869,578,48971,61803,266,22426,39724
43768,164,0,71720,121,85536,69723,43,33750,70702
43767,394,66875,70632,229,81313,87488,165,52996,45590
43766,620,55139,60962,385,65938,70245,235,24044,39135
43764,3013,43080,67259,2228,47290,77626,785,19538,33013
43762,1710,67027,78299,1134,71933,91269,576,35670,51443
43761,42,0,0,42,0,0,0,0,0
43760,496,40779,46086,306,41981,56198,190,0,28928
43759,31,37083,46929,20,51429,59170,11,24250,24682
43758,1219,42183,52341,862,51310,61689,357,23355,27881
43756,2191,45262,52227,1371,54818,60417,820,26029,35546
43755,702,46250,63070,538,48372,69217,164,25833,32946
43754,507,50804,87798,392,53095,66005,115,0,159726
43750,35,0,59460,27,71083,69519,8,0,0
43749,964,44412,56942,599,62782,69593,365,25913,34994
43748,974,53407,61336,713,58320,67754,261,30996,32663
43747,409,50368,89669,247,65885,93828,162,35598,78712
43746,561,51793,65921,382,68393,78317,179,32589,39468
43740,106,50833,55193,70,60909,59474,36,30000,39056
43739,788,86747,103747,731,87416,106164,57,0,53789
43738,62,68125,61603,33,69688,73439,29,0,43872
43736,23,39107,37830,8,46250,48450,15,38393,32167
43735,124,0,38107,113,0,39930,11,0,0
43734,600,80833,96813,539,84271,102633,61,0,24230
43733,18,0,0,18,0,0,0,0,0
43732,681,53785,61180,355,76063,79863,326,28598,40595
43731,1959,44040,57802,1410,56032,67865,549,19926,26436
43730,838,57500,62294,614,62976,70566,224,22045,35284
43728,593,35450,48966,447,45375,50889,146,21510,26542
43727,473,53875,63698,325,75750,76403,148,45467,35797
43725,8674,43133,59907,5252,53907,69440,3422,29206,41176
43724,2864,52989,67233,1644,61146,85187,1220,31204,41574
43723,1964,41373,54498,1200,52054,65829,764,19954,34560
43722,121,0,74166,121,52917,60166,0,0,0
43721,64,0,40941,64,0,40941,0,0,0
43720,476,56857,55961,304,62813,69666,172,20565,26897
43719,1050,47200,88235,685,72765,109896,365,27179,45575
43718,1115,63692,85395,765,74844,99436,350,37083,49511
43717,64,52500,66783,29,72813,68362,35,0,65474
43716,980,35030,56240,598,48553,78890,382,17917,20574
43713,2500,51886,66445,1731,63924,74771,769,30625,40991
43711,11,16250,23055,9,0,0,2,0,0
43701,22787,44666,61478,13674,55511,71609,9113,26128,41682
43623,8933,58864,71556,5047,71869,88549,3886,37000,47950
43620,2441,23983,46356,1224,33209,55673,1217,14978,35747
43619,3031,70680,92810,2107,86394,111557,924,51765,46785
43617,2733,102745,129058,2071,119632,141323,662,41222,78963
43616,8718,62415,76649,5516,81014,92721,3202,27665,42757
43615,18207,47939,63740,9941,61539,80794,8266,32782,39623
43614,14183,48355,62669,7069,67298,78838,7114,34246,41639
43613,13622,52403,61372,8075,67635,73559,5547,36254,41231
43612,12259,44200,56304,7254,50101,61272,5005,33722,44423
43611,8033,48166,58518,4907,55821,67247,3126,32793,42177
43610,1750,27428,43815,1067,42774,50674,683,19554,32170
43609,8850,34070,43131,5072,41587,49749,3778,23298,28814
43608,5416,24108,34669,2963,27690,38713,2453,20205,27257
43607,8910,30860,40462,3932,41192,52124,4978,24314,30152
43606,10335,47237,70954,5462,71098,94266,4873,32543,42595
43605,10377,28881,36838,6280,33418,40634,4097,18701,26726
43604,4761,15029,29413,1563,18259,29380,3198,13167,29112
43571,2760,77817,108018,1790,110278,117033,970,44000,83422
43570,1193,59482,68956,848,67409,78763,345,30938,42416
43569,1087,54258,67972,700,74821,80519,387,34479,42950
43567,4969,59985,71602,3439,69824,80510,1530,38039,42546
43566,3274,91290,105402,2314,103563,118815,960,51071,68868
43565,150,54583,62831,103,59583,68177,47,37083,45926
43560,12287,88439,127651,8958,106655,148773,3329,42384,67940
43558,5687,64485,81428,3787,73580,90468,1900,48029,59968
43557,1021,64718,70045,722,72143,77977,299,31898,45814
43556,697,61696,70808,517,77917,79503,180,31739,43371
43555,89,69831,75018,63,69628,80035,26,0,0
43554,946,51094,60615,599,67386,74858,347,27159,34084
43553,97,81354,72062,58,95909,85548,39,0,52003
43551,16085,82493,108283,10213,101413,135030,5872,54378,60226
43549,515,75625,81368,397,82250,91312,118,26042,37317
43548,297,56367,66717,204,87708,78541,93,40302,39663
43547,162,116875,118465,162,116875,118465,0,0,0
43545,5724,55333,74437,3606,71279,84989,2118,38010,52348
43543,3323,52172,61135,2051,61614,66755,1272,30575,48335
43542,1126,134091,131564,901,142299,153808,225,33406,30145
43541,52,54167,55252,33,65417,60021,19,48750,41626
43540,505,85848,106082,323,110875,128915,182,60208,64102
43537,11940,74985,91777,7251,93816,111109,4689,45521,58629
43536,81,90846,81010,47,0,73564,34,0,0
43535,237,52054,61314,187,62083,69641,50,25313,27904
43534,731,63438,67308,482,74038,74148,249,33958,45983
43533,746,55938,72635,485,80729,85011,261,50960,48329
43532,1507,69561,75907,1160,76100,83429,347,37599,44127
43531,128,19318,28441,83,0,35798,45,0,0
43529,101,58125,59888,85,63750,60484,16,26667,46944
43528,6475,78843,99921,4521,95961,117909,1954,43393,54784
43527,905,59659,81420,591,81771,101645,314,30446,36297
43526,2263,59154,66002,1556,72240,76517,707,32656,38005
43525,370,89318,96308,303,101583,105913,67,44821,51843
43524,444,71875,72355,370,77500,76907,74,26250,36765
43523,9,0,0,9,0,0,0,0,0
43522,1350,74762,90013,998,80682,102094,352,41094,50253
43521,1175,49583,61194,805,56027,65766,370,31765,45069
43519,73,68875,104847,65,69875,113998,8,0,0
43518,1146,75750,81096,929,85820,88392,217,32212,48233
43517,1576,50547,64620,1005,72219,81216,571,26157,32304
43516,1142,56250,69887,795,68125,78873,347,43778,45329
43515,2890,63816,81251,2175,75772,91983,715,34865,46216
43512,11658,60908,78226,7958,71739,87440,3700,35536,54017
43511,450,51607,70799,243,79531,92542,207,45163,45153
43506,6188,51394,65542,3648,62130,75071,2540,34788,48286
43505,36,48750,53017,22,62000,64232,14,32500,32114
43504,415,83973,97912,357,85893,104452,58,40000,45590
43502,2466,64013,78697,1846,76212,88057,620,34219,48644
43501,327,54441,57528,263,60662,60084,64,42222,38222
43469,1218,68553,93711,779,83390,120365,439,29688,43686
43468,140,54018,55334,90,72000,61399,50,53661,0
43467,37,80179,65373,23,76458,71409,14,0,36621
43466,792,70000,75391,607,73487,82182,185,27396,48536
43465,2398,47609,62278,1317,67201,82566,1081,29938,36280
43464,782,31711,56261,445,51625,73637,337,21144,33055
43463,34,0,0,8,0,0,26,0,0
43462,439,60917,67066,349,62417,70322,90,51000,52033
43460,2552,75425,85781,1588,90613,101931,964,36810,53727
43458,159,64792,65058,112,49375,60894,47,63304,50794
43457,609,58042,76412,349,76375,92885,260,40625,53080
43456,170,76875,96407,109,87188,120713,61,38594,41110
43452,6919,50875,78773,3887,80649,93913,3032,40522,57850
43451,386,66667,82612,295,81369,96315,91,26250,35581
43450,1436,71765,85673,1043,82618,93691,393,37731,54003
43449,3467,59341,71707,2304,76837,86146,1163,31020,41394
43447,1170,73367,88499,901,84896,98860,269,47813,48026
43446,40,51250,80320,25,98750,100184,15,33750,47213
43445,424,81071,83464,310,95278,92379,114,75536,59224
43443,651,78942,83238,494,87237,93053,157,40625,48434
43442,329,60313,62339,210,75625,73506,119,24120,38955
43440,2368,55278,75261,1383,74920,96823,985,34716,43961
43439,43,0,0,10,0,0,33,0,0
43438,144,69500,106513,92,90938,139553,52,32500,40906
43437,176,59500,64709,143,63750,66027,33,34375,45412
43435,417,71271,83685,355,72139,87036,62,46429,55365
43434,44,0,56391,33,0,49633,11,0,60755
43433,28,0,0,28,0,0,0,0,0
43432,509,102250,260753,417,109087,307872,92,60469,47183
43431,1812,67803,74097,1318,76454,86375,494,25921,36518
43430,1886,65637,72293,1418,65556,77511,468,41383,41506
43420,12194,51398,63481,7921,62856,73696,4273,31924,41250
43416,1256,70347,77605,882,83889,92037,374,22031,37288
43413,377,64107,62268,262,69107,74233,115,33125,31859
43412,1677,79673,98660,1316,88833,103304,361,51583,77478
43410,3949,55354,74143,2766,75479,87840,1183,33490,37961
43408,105,54063,60094,79,52813,63481,26,32500,32592
43407,181,57432,73125,158,60833,77229,23,0,41709
43406,778,50756,59361,562,57177,64792,216,39000,36583
43403,5,0,0,0,0,0,5,0,0
43402,13414,48193,66421,6297,70788,91330,7117,27256,43175
43360,598,80900,80621,489,87936,88227,109,35417,44495
43359,300,59306,69713,204,65455,68408,96,55000,68608
43358,1195,71023,77119,922,62109,77629,273,30313,52833
43357,1587,62891,75160,1052,72679,89025,535,27969,41660
43356,510,59722,90855,336,85395,105301,174,42353,61697
43351,4472,54507,69372,2912,66634,83913,1560,29327,39077
43348,1064,34135,56780,581,55721,65399,483,24395,44806
43347,465,69071,73777,362,69257,73519,103,35417,60576
43345,375,73047,72463,284,74833,78178,91,40625,50776
43344,2326,60682,72804,1582,69659,80286,744,41048,49340
43343,648,51854,61147,328,66094,76779,320,50278,43643
43342,1257,71726,102367,942,83993,110306,315,39544,70573
43341,372,49808,75419,201,76094,102900,171,43207,42953
43340,658,78421,75908,504,89907,84199,154,32083,44886
43338,3954,58556,71017,2807,69759,82555,1147,26832,34260
43337,504,44659,58331,322,65000,77514,182,0,24204
43336,0,0,0,0,0,0,0,0,0
43334,2203,65668,104643,1803,65139,87658,400,60313,130943
43333,238,70179,76229,195,62336,81698,43,0,51426
43332,770,47619,60919,447,73266,82255,323,26250,30976
43331,2069,50137,70986,1236,63264,94261,833,30508,35637
43330,45,32250,46989,26,57500,59423,19,25417,25521
43326,5432,47322,60823,3559,57691,72028,1873,25104,38289
43324,1225,76625,108831,819,98542,136646,406,39375,49878
43323,315,60260,61067,182,62344,74531,133,0,41807
43322,115,42054,55487,91,51250,61301,24,20000,29650
43321,106,49167,59258,62,56250,72192,44,35833,38484
43320,563,60102,61369,309,54250,70411,254,60296,49482
43319,364,72792,62542,292,74292,71376,72,23723,26715
43318,1635,60550,72283,1188,75875,81129,447,33990,46492
43317,48,43000,50163,27,58958,67844,21,31750,27429
43316,2405,61791,70310,1639,74264,82132,766,34231,41585
43315,2872,65254,76398,2225,69220,84350,647,38324,45726
43314,1151,68091,63825,805,72882,73772,346,28750,34449
43311,7485,59647,70477,5051,74136,80596,2434,34695,44785
43310,1198,62614,75531,948,67083,76636,250,53824,64393
43302,20193,46806,64237,12358,60881,79391,7835,27119,37077
43240,2101,80852,91324,994,105714,108857,1107,69635,75023
43235,18505,77951,104731,10723,106974,133989,7782,54089,61753
43232,18329,42592,51461,10963,47221,59129,7366,31622,37371
43231,8243,57348,69593,5164,65616,72574,3079,44108,58093
43230,24546,75960,93890,15727,95989,109916,8819,49666,62980
43229,21343,44804,54438,12688,51324,58878,8655,36774,43368
43228,22188,52275,64108,12871,61986,72268,9317,39497,49904
43227,9751,40353,51639,5483,46072,57518,4268,29870,40486
43224,17585,39038,49149,9838,45010,54817,7747,30923,38893
43223,8786,41292,54240,5321,47624,54898,3465,30130,47711
43222,1956,14455,29756,1231,0,27153,725,19817,29953
43221,14190,96233,136298,8850,119688,165550,5340,65564,84058
43220,12475,70167,113242,6413,113666,161509,6062,45280,60718
43219,11479,40172,52941,6642,48690,58594,4837,31067,40738
43217,678,42679,46958,505,39250,41552,173,35820,51231
43215,9609,64368,89144,1543,92708,159838,8066,60276,75443
43214,12682,76831,95581,6371,101544,115924,6311,56354,73400
43213,14163,43989,61105,7667,52344,69173,6496,33517,48146
43212,11712,66326,104032,3772,144167,182421,7940,51309,65810
43211,8714,28610,37783,5484,32010,40640,3230,22054,28995
43210,192,19107,32472,123,32292,42873,69,14896,13930
43209,11990,69290,114469,6950,102500,157332,5040,40062,53169
43207,18656,50582,59625,11462,62298,67242,7194,32963,43157
43206,10435,59082,82137,4969,63346,90788,5466,55045,72746
43205,5510,40559,60218,2179,44420,67447,3331,35933,53488
43204,17220,48770,61660,10052,55405,66734,7168,37220,50045
43203,3758,36418,47659,1484,35137,54276,2274,35806,39817
43202,8889,56332,71603,3201,80461,100709,5688,45162,53574
43201,13106,34884,58864,2919,47014,82813,10187,31920,51303
43164,779,54053,73246,538,60435,83988,241,25208,43272
43162,2766,63889,80216,1885,71993,91218,881,40590,52612
43160,9062,46073,61880,6039,55469,73367,3023,23345,35094
43158,137,85179,71149,81,94625,94791,56,38813,36950
43157,205,41875,49894,141,52386,56560,64,23750,28292
43156,90,71875,77116,70,87895,81280,20,51500,51195
43155,1112,73833,81798,809,84976,96874,303,0,38649
43154,1275,71217,85845,1120,84167,92424,155,33977,35852
43153,423,61442,79870,283,82083,92435,140,45208,47298
43152,316,55179,74051,224,56250,82734,92,51000,51238
43151,94,55938,62594,74,56250,67865,20,0,30335
43150,909,61042,75792,618,74052,89163,291,46488,44050
43149,1001,55938,67229,738,67500,75396,263,26908,42413
43148,738,59448,78959,558,62656,86954,180,25250,44294
43147,14098,107400,120445,11443,113540,130948,2655,57083,69890
43146,3635,64719,90134,2915,83024,100078,720,43578,48750
43145,899,63730,61645,601,75136,71852,298,25694,31785
43144,164,32353,38826,116,32955,42451,48,23750,30069
43143,1948,68553,81744,1434,84620,93216,514,42606,43959
43142,54,46000,56409,30,48750,69537,24,38929,40000
43140,7740,67263,82542,4915,78676,92982,2825,45997,60936
43138,7485,54032,63947,5433,64981,71250,2052,25636,34594
43137,763,57005,76401,590,63000,72143,173,39844,79718
43136,357,74950,92200,225,110069,112357,132,48500,55026
43135,1684,39833,64432,1191,65699,73777,493,29813,30543
43130,24002,55063,69205,15643,69026,80104,8359,29641,45606
43128,948,50338,58283,692,58875,65707,256,25556,30268
43127,59,0,56281,59,0,54231,0,0,0
43126,177,66938,80285,134,69265,91888,43,27250,33937
43125,5948,68103,78122,3573,84047,95447,2375,41821,48515
43123,25432,75644,92243,18486,92048,105417,6946,43765,52031
43119,10470,73299,90308,7192,87527,102594,3278,49273,57198
43117,24,0,0,24,0,0,0,0,0
43116,586,84063,93765,466,91500,101116,120,52222,59102
43115,584,61550,68375,459,49494,66542,125,23606,34314
43113,9476,54444,68445,6364,68476,80223,3112,33575,40434
43112,1618,103388,113557,1243,111644,128666,375,47917,56549
43111,78,83269,69194,57,84279,86660,21,0,0
43110,15784,62489,84686,9655,82516,99285,6129,45121,58128
43109,84,46552,56958,41,0,66390,43,45905,43742
43107,1300,65784,71409,1058,69697,74405,242,37308,44698
43106,640,47217,66208,465,47656,68403,175,33250,51346
43105,3183,66118,92566,2182,96061,112074,1001,35742,47102
43103,3853,78849,89945,2902,84103,94000,951,49289,70079
43102,1609,68250,83910,1225,73162,90897,384,56333,59405
43101,167,45313,48347,98,59583,60182,69,16302,26113
43085,10115,93953,118420,6693,114258,141524,3422,61778,71699
43084,215,85809,95006,167,86397,101695,48,58333,63492
43082,12189,131449,147009,9938,145273,163072,2251,56989,73275
43081,25850,83296,96504,16407,96364,111129,9443,57823,68622
43080,1897,63420,73644,1442,82820,88138,455,22675,25184
43078,8256,55696,66637,5424,68714,77730,2832,35113,40746
43077,89,70729,69064,65,72386,77043,24,48929,45917
43076,3588,73225,84942,2539,86317,96920,1049,37279,45380
43074,4956,90242,107411,3764,101864,117918,1192,44196,65775
43072,2458,67339,72771,1749,74861,82112,709,49250,47869
43071,807,69952,96226,642,91250,109891,165,24821,36482
43070,45,88917,74916,31,0,0,14,0,0
43068,21424,62075,75489,13455,80348,90458,7969,36885,46139
43067,555,85417,78970,371,106016,92243,184,47679,48618
43066,609,108155,129165,456,133591,156432,153,41384,47899
43065,14927,135179,164849,11961,150008,182617,2966,56944,85235
43064,4635,106128,127436,3748,120302,141978,887,59609,61647
43062,10320,85564,100727,8163,91880,108115,2157,49105,66810
43061,1580,112281,125995,1319,130035,136896,261,53015,59500
43060,1006,59531,73176,777,67218,80546,229,35583,44048
43056,7148,58554,79837,4742,76429,96671,2406,27553,43661
43055,23857,52209,65637,15143,64404,79556,8714,29685,37418
43054,9987,119947,176545,7258,148495,207782,2729,67990,85205
43050,11686,55636,66929,7964,65722,75400,3722,32911,44663
43046,1405,68958,97129,992,74904,109363,413,37396,58049
43045,750,84318,96566,593,77405,96776,157,70729,79319
43044,1963,64097,82104,1420,75227,90998,543,28967,55307
43040,12743,81160,97269,8762,100563,112438,3981,51268,59636
43037,101,29250,47120,65,41563,51752,36,19063,26878
43036,137,54792,54055,77,0,56038,60,0,31025
43035,9094,133643,153731,7640,144204,162206,1454,60948,101110
43033,153,59688,77992,111,70046,72217,42,41250,88512
43032,7,0,0,7,0,0,0,0,0
43031,5001,93107,109558,3789,104547,115922,1212,54858,86110
43030,47,0,0,47,0,0,0,0,0
43029,149,90362,84562,138,90724,87535,11,0,0
43028,2979,67832,84011,2270,75054,93635,709,47899,51471
43026,24166,93036,109014,16830,107708,123426,7336,53141,68822
43025,1947,62775,88544,1329,80711,95122,618,29063,70336
43023,4366,116714,153324,3550,128594,167037,816,45156,90969
43022,1033,78542,88640,637,82039,103343,396,51806,64989
43021,3977,143582,169292,3338,152158,179677,639,75724,113985
43019,3103,65920,75039,2362,73313,82196,741,40456,44549
43017,15377,111250,154621,11322,133848,175109,4055,62468,89942
43016,15402,93056,121277,9983,122970,147727,5419,60638,71224
43015,21131,81146,96678,14373,99980,114839,6758,40196,55096
43014,1186,64038,67068,834,75763,76885,352,42805,36716
43013,477,0,174576,389,0,128023,88,0,312761
43011,2992,77585,89299,2077,91118,104791,915,55250,52374
43010,123,41615,60407,81,46250,70258,42,25000,39448
43009,722,78200,90433,587,82344,93009,135,46406,59876
43008,1177,52198,68362,748,57105,76933,429,47390,49462
43006,231,52067,51204,162,66458,65283,69,0,16913
43005,176,60791,60823,75,0,60311,101,61218,61203
43004,9675,84363,99684,6795,98576,111631,2880,53485,66275
43003,1162,56282,72204,769,60625,76260,393,50389,56286
43002,2111,73073,81817,876,86538,90556,1235,69772,74344
43001,1003,72545,93541,706,72461,101683,297,51563,69167
42788,137,46250,60715,91,0,80143,46,0,22283
42784,798,46477,61790,547,62891,76879,251,21797,25514
42782,319,39896,51912,209,72981,65444,110,23162,26204
42776,955,52557,63450,679,56250,70359,276,35833,42376
42765,2366,44120,57606,1528,56250,72999,838,21519,27618
42764,219,0,44250,82,49821,59298,137,13925,35244
42762,41,0,60420,32,0,0,9,0,0
42758,31,88672,94365,31,88672,94365,0,0,0
42757,1164,48994,59887,734,56389,72493,430,24280,38105
42754,5983,36376,51450,3799,43379,63789,2184,22500,28331
42753,350,45625,73114,264,52188,87538,86,0,28379
42749,2177,39555,53640,1432,42760,60773,745,28984,37090
42748,3568,51327,60588,2475,62679,69506,1093,40868,38342
42746,768,43750,51991,500,65341,64979,268,18056,23270
42743,3594,35045,56508,2447,47750,59967,1147,20015,47737
42741,192,53750,67357,163,63438,74778,29,0,21431
42740,921,71442,71730,804,72944,73368,117,0,60477
42733,585,47379,48689,401,46815,51958,184,48846,41283
42732,780,46458,62679,675,47847,65102,105,30662,31785
42731,72,43553,52472,46,65417,59839,26,42143,39442
42729,678,34231,55477,394,52222,75987,284,17500,27023
42728,6015,43084,56961,3927,54187,70635,2088,20022,30023
42726,1925,41886,63087,1391,54958,74655,534,23603,32436
42724,1937,69659,93064,1575,80114,103329,362,43750,46533
42722,179,31875,51859,154,31912,55393,25,0,10284
42721,1308,37889,46417,843,45268,54193,465,14954,29275
42718,9714,48793,65577,6622,62952,79359,3092,23063,34834
42717,2590,34600,47252,1464,51747,61791,1126,15694,26387
42716,629,41060,62752,466,45093,69291,163,30547,44056
42715,92,0,30026,62,0,43315,30,25000,0
42713,747,25995,42044,458,41250,51447,289,21307,25597
42712,562,61591,59793,375,63750,69582,187,0,36859
42701,20830,60130,83647,13586,77168,104817,7244,29674,41241
42653,1743,24295,35116,1115,31863,46175,628,10728,13776
42649,735,29112,44791,453,37806,58149,282,0,18774
42647,1334,37000,43493,996,34531,46913,338,0,29901
42642,4871,42313,52755,3240,57500,63626,1631,24821,30151
42638,30,0,0,30,0,0,0,0,0
42635,1521,29701,44542,895,49308,64545,626,10721,15943
42634,668,31800,58040,429,31544,61038,239,0,52659
42633,7922,37855,55137,5343,50918,64582,2579,16960,33104
42631,68,0,0,68,0,0,0,0,0
42629,2223,36925,59013,1419,61354,72504,804,23477,33297
42603,8,0,0,8,0,0,0,0,0
42602,4046,32835,51845,2480,41667,58163,1566,19650,39203
42567,2360,37159,49674,1202,50395,63650,1158,24340,28752
42566,127,18818,33784,90,30156,40254,37,0,0
42565,293,14505,43485,236,0,48186,57,11767,21007
42553,2132,39835,53672,1402,51759,60443,730,15698,37647
42544,2313,38143,66364,1476,48779,59275,837,23075,77935
42541,185,0,34579,130,0,38707,55,0,21365
42539,3624,33212,43673,2265,40103,52085,1359,19110,28769
42533,304,34242,49304,171,37639,61025,133,0,32971
42528,605,34781,55045,381,53750,71398,224,0,27229
42519,1311,37159,46869,859,45933,55724,452,23182,29705
42518,1217,36549,53751,783,46750,53757,434,16958,50983
42516,276,34871,58056,212,34655,62850,64,0,34086
42503,9994,49336,70187,6631,64533,85302,3363,22384,38686
42501,6631,34945,61372,4158,44192,66098,2473,24210,35174
42464,645,42292,51298,397,53750,64356,248,21901,29124
42463,47,35250,38234,32,38750,51541,15,0,9847
42462,476,62561,82435,402,63611,76691,74,50952,106911
42461,512,39022,54538,309,43456,62764,203,29798,41273
42459,1575,50190,61846,1177,58341,71519,398,25000,30918
42458,616,51239,73048,539,51892,78003,77,24180,38362
42456,637,43819,59674,370,50147,56169,267,36494,61752
42455,1167,49099,63840,828,65968,73770,339,30083,37319
42453,198,41333,51667,170,46875,56262,28,0,23764
42452,834,64643,101993,676,84412,93195,158,45398,35515
42451,274,34083,32747,204,27167,28635,70,34333,39929
42450,1561,42011,59252,956,52500,75713,605,17006,27296
42445,4374,46865,77546,2952,64833,92076,1422,24657,45833
42442,1312,53611,69643,925,77411,80707,387,21023,39907
42441,523,52117,71489,347,75347,87941,176,31574,38142
42440,394,40595,46782,246,41667,52312,148,0,36790
42437,2740,48402,62035,1965,57192,73809,775,24013,29949
42436,535,44750,61343,352,56667,69388,183,40950,40996
42431,10789,45466,59100,6978,51091,68837,3811,27993,38887
42420,15733,48625,62011,10242,63204,75966,5491,26225,33522
42413,1300,76164,85439,917,78668,95640,383,75055,53315
42411,692,51667,77919,486,69524,96697,206,37105,32610
42410,416,44706,55655,306,45000,57681,110,28636,37310
42409,901,52039,66552,616,68750,82538,285,23036,29068
42408,2905,43477,58067,1903,56438,72392,1002,21582,30529
42406,1210,56910,75266,807,71328,90806,403,28694,43817
42404,961,38011,55800,640,51300,69210,321,19306,27865
42378,1247,59063,78186,886,72321,94971,361,24671,35119
42376,2151,62164,79446,1556,68790,88769,595,41656,47708
42374,124,44500,50157,100,0,54735,24,21000,24271
42372,629,53125,53601,395,67645,60672,234,39211,39703
42371,137,91875,91375,108,106912,112175,29,0,0
42370,1,0,0,1,0,0,0,0,0
42369,93,42250,48030,70,48750,52579,23,28750,32465
42368,510,46090,56779,396,45705,55893,114,54000,51891
42367,247,42344,47032,181,45347,54049,66,23333,25111
42366,1885,75977,95011,1551,88555,107594,334,26071,31133
42361,207,0,40305,139,0,49376,68,22647,21762
42356,0,0,0,0,0,0,0,0,0
42355,723,60685,68564,531,64176,80780,192,24625,34668
42354,56,59583,81627,48,80000,91731,8,25000,11850
42352,816,40000,57122,543,54464,70357,273,15707,27530
42351,1635,59267,69075,1210,71016,77555,425,30060,38496
42350,659,72961,83844,515,81343,84636,144,22500,66266
42349,653,48018,49281,462,39639,55318,191,0,25347
42348,1830,60333,68633,1319,73259,73933,511,38802,51766
42347,2385,47205,61885,1727,67022,71378,658,17866,33988
42345,4660,53786,75091,3237,67167,86883,1423,21712,45867
42344,252,34191,37460,200,38000,40838,52,28438,24469
42343,541,37625,44117,416,41250,44485,125,24028,32705
42339,307,55625,79482,222,57143,89696,85,0,52807
42338,21,30938,37029,6,0,0,15,0,0
42337,667,42969,54547,495,47574,62712,172,16250,22453
42333,471,50938,55018,279,38203,43928,192,60934,58254
42332,96,13359,21919,17,0,0,79,12695,14381
42330,3288,45740,61798,2202,54951,72821,1086,32801,36322
42328,443,49327,60249,358,55417,68144,85,16696,24505
42327,1600,54063,71788,1149,68398,84198,451,29980,38557
42326,151,62396,53446,76,63281,50316,75,61354,54663
42325,820,38065,49582,570,54444,62774,250,14694,17714
42324,419,49174,64035,289,49844,65562,130,0,59755
42323,267,46442,56386,192,60625,58686,75,23973,31688
42322,8,0,0,0,0,0,8,0,0
42321,58,15859,26259,40,0,31763,18,0,0
42320,3320,43119,72198,2393,45590,83996,927,26558,36323
42303,16383,53312,74551,10739,67793,85967,5644,32701,49268
42301,18409,51769,70860,11752,65746,81754,6657,32832,47534
42286,476,42750,63551,344,65703,78275,132,17407,22396
42285,179,47788,49255,112,55286,63584,67,0,25301
42280,115,74861,83442,93,89107,94823,22,0,0
42276,5801,52274,59077,3895,62405,68393,1906,26364,38556
42275,293,50195,55382,219,50664,58896,74,0,44982
42274,873,69792,72833,488,86591,89848,385,31989,51265
42273,151,63304,113464,112,90833,141273,39,24115,26456
42266,735,74427,78861,573,80260,87655,162,39167,47636
42265,267,44219,68477,160,115357,95314,107,23958,28347
42262,3106,39018,53434,1974,49375,58812,1132,22738,41641
42261,4134,45655,54405,2967,55328,62100,1167,19391,32469
42259,421,42250,51784,293,52440,59505,128,37000,34109
42256,1957,48887,59208,1364,56250,62034,593,26161,50298
42254,96,0,42780,35,59464,64797,61,20966,30148
42240,16928,43181,65142,10456,54678,81565,6472,27207,36194
42236,215,80250,74714,136,83000,78769,79,0,62228
42234,1071,35074,60717,735,44567,67715,336,21944,43344
42232,275,75350,84782,255,75950,85360,20,0,0
42223,4856,45735,50972,4501,45561,51943,355,35038,32957
42220,2468,51194,65320,1775,58362,77597,693,24896,29879
42217,1243,44574,54368,871,51065,62942,372,23141,33076
42215,548,56250,70351,441,69358,81591,107,0,22436
42214,301,0,60410,241,64023,71195,60,16827,17090
42211,5481,51021,63638,3640,63016,73701,1841,27365,41992
42210,1975,37044,49147,1369,45655,57628,606,21622,29432
42207,522,39063,47267,413,39441,52400,109,19063,22841
42206,2098,45889,68774,1425,53750,64250,673,25821,74998
42204,283,47639,69417,148,71250,87424,135,11128,49676
42202,828,44000,67873,580,57833,84921,248,25934,27382
42171,2499,59228,71114,1772,75212,82171,727,34646,43045
42170,528,52778,73437,369,74063,87877,159,40145,37288
42167,3468,34094,54604,2276,53357,71936,1192,14409,21276
42166,967,42370,54722,741,43194,58532,226,21019,27482
42164,6502,43664,57380,4626,56341,67782,1876,25426,29135
42163,19,0,0,19,0,0,0,0,0
42160,631,31569,46556,390,50789,56502,241,18640,26861
42159,702,54047,72179,578,54852,80049,124,0,31319
42157,205,52721,96414,159,0,79260,46,0,153941
42156,157,0,66464,105,69931,84120,52,35385,30812
42154,154,41757,53067,117,41723,54181,37,0,49543
42153,154,48000,48228,126,49000,50728,28,0,33539
42151,52,0,49706,28,0,0,24,0,0
42141,12388,42703,56246,8313,48266,64973,4075,31634,35871
42140,477,30509,54374,319,39861,68782,158,17826,24766
42134,6809,49385,59393,4660,59771,69612,2149,26098,33186
42133,567,48917,60739,382,62742,73162,185,29750,34458
42130,97,35417,53000,97,35417,53000,0,0,0
42129,2824,36623,45097,1934,43173,50651,890,20660,31510
42127,2792,38966,48698,1749,49931,58717,1043,22541,30804
42124,17,0,0,17,0,0,0,0,0
42123,408,44028,67102,257,53504,84644,151,27250,37118
42122,1960,81375,120236,1596,86319,133912,364,38750,53395
42120,878,60238,67042,711,69375,73135,167,16758,26437
42104,14991,60695,80279,9103,78851,96043,5888,38538,53379
42103,8669,69270,118307,5664,99500,152192,3005,41917,51978
42102,21,0,0,21,0,0,0,0,0
42101,22278,42158,55926,13066,50225,60783,9212,32512,45439
42088,882,48621,60191,567,52338,73835,315,0,33387
42087,950,42600,54318,660,43673,63952,290,29167,29533
42086,1733,64293,74636,1126,75833,90421,607,26766,41924
42085,292,32209,44596,217,38958,47594,75,0,35613
42084,18,0,0,0,0,0,18,0,0
42083,165,31313,42032,108,57955,53381,57,0,0
42082,665,59514,72754,510,63581,82272,155,33162,38981
42081,932,52031,81914,547,63431,86584,385,17539,74228
42079,570,62609,90524,444,64511,106934,126,20417,28049
42078,738,41625,54352,477,55380,65662,261,0,33604
42076,529,26288,35430,261,0,46536,268,25919,24614
42071,12740,40908,57571,7116,65221,77867,5624,21989,30739
42069,218,50189,46193,88,52075,60542,130,19500,36480
42066,9510,42844,57428,5911,53097,70297,3599,22013,34111
42064,3238,46398,60046,2153,63894,71320,1085,20994,33676
42061,62,0,19408,18,0,0,44,0,0
42060,0,0,0,0,0,0,0,0,0
42058,878,60625,70297,627,81399,84146,251,29531,35704
42056,521,47321,58305,299,57212,69923,222,26806,41837
42055,1151,47596,60764,650,50690,64619,501,29145,55723
42054,376,73069,69431,272,74026,81660,104,23750,37447
42053,2138,50400,67500,1508,68558,82535,630,27689,30184
42051,1092,57174,81634,844,64438,67701,248,35833,127453
42050,1208,39079,47912,750,46929,61294,458,20786,24628
42049,538,55500,68075,398,61814,79836,140,24091,34353
42048,740,36083,49848,465,37948,58760,275,30938,33978
42047,108,21250,29454,67,0,31131,41,26141,26712
42045,881,52232,67975,604,67321,79205,277,38327,41500
42044,1578,50577,70296,1189,55496,77543,389,40466,41642
42041,1746,30938,48508,1163,38194,54228,583,19028,32798
42040,352,61563,90463,249,78250,105796,103,32663,53398
42039,608,62750,68167,389,79453,85026,219,0,38154
42038,1986,51089,69099,1216,67059,87974,770,30366,38172
42037,26,0,0,26,0,0,0,0,0
42036,516,77500,66388,406,80822,75157,110,37823,34021
42035,409,53831,82082,271,62750,96385,138,42222,47002
42032,69,39750,47348,35,47083,58317,34,38500,34900
42031,1262,43868,74611,790,68372,97353,472,23532,33094
42029,2537,61060,77065,1912,67679,87727,625,25737,38955
42028,234,30864,39730,142,31563,45080,92,24375,31472
42027,646,63704,89514,493,77969,106751,153,32981,33972
42025,8174,60625,74639,5502,77981,93766,2672,27659,34108
42024,461,53938,71054,307,60938,87545,154,30192,35294
42023,878,38375,83498,598,52115,108557,280,25978,26811
42022,57,72313,88093,38,71125,70387,19,0,0
42021,598,33030,49572,380,47188,55559,218,23190,38417
42020,684,41643,57585,468,55204,62368,216,13681,47220
42003,11722,41561,60594,6902,58209,78321,4820,23072,32787
42001,12990,52762,77460,7908,68062,94986,5082,33322,48742
41862,414,28846,33889,305,38640,40379,109,11719,14766
41861,68,0,44026,62,44375,48255,6,0,0
41859,161,22019,33189,115,35750,40415,46,11000,15126
41858,3320,31368,56432,2094,37153,57477,1226,20227,51630
41855,408,48968,49678,269,50222,60454,139,28341,28824
41849,62,55221,50671,25,0,0,37,0,0
41848,0,0,0,0,0,0,0,0,0
41847,208,0,35935,92,0,35215,116,0,36505
41845,134,22593,24610,75,0,0,59,0,26588
41844,545,26124,33006,314,26598,41881,231,0,20942
41843,262,0,34980,105,0,45497,157,8766,27946
41840,330,29211,47301,270,38750,51978,60,15357,25447
41839,454,44500,48618,355,49018,54849,99,0,26273
41838,313,35772,36506,274,36196,38955,39,0,19295
41837,400,40395,51028,312,63125,58521,88,18594,17552
41836,399,55148,50325,295,56589,58466,104,17903,27232
41835,326,30000,51601,281,0,58659,45,25000,7524
41834,104,26857,41050,61,0,51254,43,0,0
41833,172,0,27798,97,0,36297,75,0,0
41832,149,62869,53648,149,62869,53648,0,0,0
41831,435,65353,65813,226,86377,96290,209,21949,32856
41828,330,34405,44440,256,53000,50924,74,17273,17855
41826,232,36250,42689,146,56333,55690,86,16190,20617
41825,151,39792,46760,151,39792,46760,0,0,0
41824,694,0,45104,404,0,65880,290,9961,16161
41822,1100,32028,44624,671,37303,52068,429,23783,31611
41821,68,0,0,37,0,0,31,0,0
41819,161,43117,31772,82,0,30288,79,0,0
41817,98,40625,49393,51,40469,37735,47,0,0
41815,322,21481,55721,240,21923,70293,82,0,11843
41812,99,32986,47635,63,0,44652,36,0,36558
41810,208,44236,45057,159,50489,37459,49,0,0
41804,322,63370,50165,239,67977,59208,83,23405,24127
41777,438,41389,42516,334,42625,47331,104,0,27052
41776,390,32571,42093,338,33684,45150,52,21184,20625
41775,25,0,0,25,0,0,0,0,0
41774,1048,38281,64290,784,49531,75080,264,21111,30748
41773,520,22635,27305,332,18667,28024,188,23482,25220
41772,115,43594,50150,73,61083,68342,42,0,18533
41766,101,0,33194,60,0,40012,41,0,0
41764,310,45543,43443,207,40694,45478,103,45924,36561
41763,249,0,81637,180,0,61580,69,0,133961
41762,0,0,0,0,0,0,0,0,0
41760,49,0,0,0,0,0,49,0,0
41759,94,21765,27677,83,22625,30077,11,0,0
41754,200,45872,50918,191,46003,50573,9,0,0
41751,105,65707,77076,94,66304,79611,11,0,0
41749,1405,29865,48305,803,58403,64660,602,19464,24586
41746,352,0,51575,298,0,58663,54,8663,9369
41745,143,31509,47426,91,30302,41195,52,0,57319
41740,322,67404,72144,288,69318,73472,34,0,0
41739,85,0,15638,65,25000,0,20,0,0
41735,57,21875,27226,21,0,35019,36,21818,22681
41731,375,22196,43289,273,31583,50003,102,14167,19189
41729,0,0,0,0,0,0,0,0,0
41727,450,60743,78779,234,60245,105470,216,60765,48410
41725,19,0,0,19,0,0,0,0,0
41723,612,20050,35801,249,46023,61771,363,14450,17987
41722,488,22457,33358,314,21552,37810,174,24000,25323
41721,243,17446,30072,170,19551,37088,73,9728,10334
41719,534,29107,41064,338,34286,50265,196,25926,25197
41714,166,0,32590,101,0,46536,65,9757,10920
41713,0,0,0,0,0,0,0,0,0
41712,141,58911,68313,130,59355,69745,11,0,0
41701,6649,44686,61633,4727,55531,68931,1922,25777,39909
41669,262,27500,43218,185,51250,51077,77,14904,18083
41667,127,69280,69692,112,68030,62486,15,0,0
41666,279,22096,37980,154,0,51900,125,15859,20830
41663,149,0,20570,106,11583,11713,43,0,0
41660,159,0,50251,134,55357,49456,25,0,0
41659,205,0,62292,154,92500,73132,51,28843,29559
41655,485,0,46746,388,67997,53666,97,0,19068
41653,4239,35461,51837,2807,44023,61510,1432,21393,31648
41650,151,24598,32687,111,26615,34483,40,0,0
41649,930,27150,69955,680,43611,54353,250,16473,110615
41647,754,33763,40472,551,45089,45958,203,0,23239
41645,380,53426,65307,250,68611,68878,130,31466,58438
41643,53,20542,18604,47,20792,19787,6,0,0
41642,328,0,43977,215,49219,47705,113,0,19242
41640,532,30000,36942,417,32188,37196,115,20313,23763
41636,357,0,38262,294,0,41759,63,0,21948
41635,1177,36687,45723,831,46452,56904,346,16500,18870
41632,222,22143,31317,147,34191,39340,75,18125,15592
41631,500,31250,33693,323,39418,41922,177,18578,18677
41630,502,25221,42517,329,34464,55913,173,15592,17042
41622,54,43235,39635,39,0,0,15,0,0
41621,65,54006,49455,65,41506,42182,0,0,0
41619,106,37188,32249,42,0,0,64,36719,37539
41616,373,48083,45651,261,56483,61889,112,0,7812
41615,141,0,28089,128,24286,30726,13,0,0
41612,72,0,0,17,0,0,55,0,0
41607,167,25268,21625,99,26304,26727,68,13214,14197
41606,383,0,41481,268,42841,46171,115,10375,30552
41605,327,36840,45429,245,35938,50696,82,38102,29695
41604,166,0,56577,125,78098,60642,41,0,44185
41603,656,31250,40101,392,46417,52547,264,14522,20370
41602,333,67939,93676,262,69527,65592,71,0,193096
41601,253,30625,38986,87,50625,66301,166,0,24670
41572,1560,43529,50745,1148,46706,57077,412,22151,31525
41571,221,44556,41646,177,45625,38319,44,0,0
41568,479,30625,28697,297,33476,35465,182,0,17653
41567,47,0,44991,24,61000,63754,23,0,0
41566,256,65313,60045,206,81667,69208,50,16625,22290
41564,295,37168,43876,205,38052,47656,90,31250,35266
41563,129,49375,46910,110,0,48785,19,14792,22858
41562,1087,41778,42908,771,48942,52523,316,13946,19448
41560,73,32798,44059,66,32143,36089,7,0,0
41559,78,0,30863,78,0,30863,0,0,0
41558,380,58472,54457,297,65451,63076,83,22250,23612
41557,850,27750,47360,591,0,51909,259,22782,34258
41555,290,0,49852,225,72250,60737,65,0,12175
41554,471,26208,49252,247,36583,70096,224,20082,26268
41553,535,34375,40728,423,40559,46822,112,0,17712
41548,479,22240,37394,327,35094,43827,152,0,23554
41547,345,0,28614,243,33568,34146,102,15992,15436
41544,252,32061,52552,192,0,61894,60,18750,22658
41543,209,15625,24051,94,0,32865,115,11497,16845
41540,42,52143,60655,42,52143,60655,0,0,0
41539,643,29050,36838,438,40000,47153,205,0,14799
41538,44,69688,73005,44,69688,73005,0,0,0
41537,1826,34381,52876,1319,44561,62410,507,18641,26922
41535,291,0,47702,227,0,59029,64,9052,7525
41534,115,0,21887,44,42000,46475,71,25000,0
41531,394,34952,43734,330,40938,48266,64,0,20361
41528,447,52292,43899,423,52834,45412,24,0,0
41527,296,43250,68349,164,76667,107953,132,23068,19143
41526,55,0,0,55,0,0,0,0,0
41524,74,29405,30186,74,29405,30186,0,0,0
41522,2120,32560,43144,1521,40256,50855,599,19283,21194
41519,460,42045,49117,302,65455,64970,158,0,16083
41517,52,52717,40977,34,53696,54494,18,0,0
41514,1215,33109,44968,821,48285,57047,394,18529,19252
41513,224,38879,43915,112,0,50025,112,38707,37806
41512,304,36250,43578,190,44022,56525,114,15938,19809
41503,231,97902,107535,199,99330,117851,32,48182,43384
41501,9813,34589,60321,5967,46561,74368,3846,16724,37563
41472,3420,40308,54278,2354,47692,64020,1066,19808,30440
41465,4462,27992,43275,3116,35722,50430,1346,15026,25124
41464,305,26806,54270,205,44453,73314,100,15758,15230
41425,485,31793,52955,345,53542,66939,140,13929,17592
41421,237,32802,32182,81,0,33431,156,33046,30481
41408,183,20563,30050,119,36563,38529,64,9844,14153
41397,4,0,0,4,0,0,0,0,0
41390,14,0,0,0,0,0,14,0,0
41385,186,36944,44978,101,46917,52553,85,0,35976
41367,88,0,35156,51,72548,58071,37,0,0
41366,21,0,0,15,0,0,6,0,0
41365,275,9431,18773,178,0,22790,97,9925,11401
41360,116,43846,54412,88,46667,65915,28,20313,18261
41352,287,26488,36101,220,29375,40854,67,0,20494
41348,492,18007,27311,265,25163,36446,227,13087,15647
41339,4147,31548,51821,2869,42946,61967,1278,15407,26120
41332,348,41346,48254,235,51806,59849,113,20230,23656
41317,111,44145,49232,85,49306,57826,26,0,21135
41314,1793,29693,47549,1207,41763,55354,586,9959,28333
41311,2776,24323,37540,1523,34450,47630,1253,12205,23268
41301,2591,24873,38910,1494,32667,42714,1097,15020,29900
41274,166,53684,58254,78,90391,72110,88,0,45972
41271,59,29120,41929,59,29120,41929,0,0,0
41268,376,77273,66182,279,90530,83941,97,0,15103
41267,300,25634,36801,251,25046,38563,49,0,15894
41265,438,32167,45829,306,43571,54831,132,19500,24960
41264,211,52792,39389,147,53534,46393,64,0,23302
41263,127,0,51828,78,68690,61749,49,0,0
41262,435,42788,50622,275,64673,60548,160,35789,28665
41260,291,0,43442,214,41136,53107,77,9592,10961
41257,252,39207,67152,222,39512,72753,30,0,25710
41256,1102,53494,89347,821,53991,82264,281,20331,90087
41255,296,39375,55531,208,53571,67267,88,14702,18938
41254,188,35732,31912,94,43250,41878,94,18942,21947
41250,603,45775,49596,534,46232,52770,69,25865,24816
41240,2605,42116,53484,1804,54196,62956,801,16055,31176
41238,243,39353,51573,163,62841,65929,80,0,22323
41234,222,23836,41547,169,0,46510,53,14152,18757
41232,255,19855,48675,194,26563,59698,61,25000,13616
41231,280,32727,52913,177,0,72163,103,0,19834
41230,4140,33793,47914,2805,45775,58046,1335,19366,24089
41226,52,14200,21383,52,14200,21383,0,0,0
41224,1990,49830,58191,1235,57141,72311,755,15843,35061
41222,952,35625,50536,752,43141,57688,200,17981,21670
41219,727,22028,32702,414,23929,41597,313,13125,17529
41216,516,60469,71683,485,68021,75147,31,0,17490
41214,186,0,25280,97,0,37262,89,0,0
41204,221,52660,46618,162,40500,46333,59,19073,35232
41203,219,42694,48767,149,0,54507,70,42697,31611
41201,75,0,52689,38,66071,0,37,0,37038
41189,767,33819,44221,521,51103,56948,246,9903,17265
41183,704,55686,60175,412,60417,73316,292,38333,40786
41180,370,35909,42329,259,43438,46263,111,20511,30201
41179,2985,27780,48130,1850,40000,62479,1135,16383,23813
41175,2081,39688,53185,1340,57500,66285,741,20942,27358
41174,442,62065,85366,384,63571,90121,58,27273,26941
41171,1348,35833,46265,1025,41892,52467,323,11736,24942
41169,2304,56410,70423,1378,65809,85146,926,54000,47219
41168,1060,57708,69091,911,60114,73257,149,27847,35763
41166,452,44286,45238,381,49837,49078,71,0,14083
41164,4841,41011,55863,3356,46742,63020,1485,24583,36907
41159,188,19250,32369,139,22188,35819,49,14219,19673
41149,185,33795,34762,164,27174,30850,21,16719,17505
41146,132,0,21239,96,10769,14523,36,0,0
41144,3683,48244,64474,2793,57338,74280,890,24600,30553
41143,4924,39612,54962,3371,65346,70682,1553,15982,19779
41142,0,0,0,0,0,0,0,0,0
41141,795,21951,34253,575,30625,37025,220,17127,24686
41139,3176,51907,64271,2118,61683,74143,1058,28750,41157
41135,67,24044,30048,19,0,0,48,0,17992
41132,134,19063,34965,104,21500,42483,30,0,0
41129,3657,58678,74972,2559,66595,85837,1098,27292,45994
41124,353,22679,37276,218,39839,49468,135,9602,17154
41121,805,41048,61447,440,62935,79942,365,40569,37153
41102,7253,55643,69585,4780,62186,79251,2473,35224,49453
41101,7616,44298,62799,4875,60889,78114,2741,22130,32544
41099,0,0,0,0,0,0,0,0,0
41098,774,33800,51071,534,44261,61748,240,26583,26443
41097,2473,47829,60837,1619,55142,67107,854,40041,44907
41095,1339,48614,56935,783,54213,61776,556,34444,47760
41094,5234,83325,100542,4007,91102,113269,1227,33996,53279
41093,1281,49083,54663,1023,52359,59575,258,18688,34779
41092,1126,76058,94310,863,90938,109419,263,0,41498
41091,6677,120826,144642,5641,127343,155487,1036,60663,77988
41086,943,51649,71227,614,64167,84224,329,38222,40391
41085,315,49236,48979,194,54844,55522,121,32946,34742
41083,670,55152,61664,529,56337,69034,141,18438,29606
41080,705,100363,102679,525,90893,101676,180,100782,89270
41076,6901,60797,76345,4168,76679,97864,2733,33548,41626
41075,6292,77162,109536,4200,105616,131908,2092,38696,61424
41074,2353,53345,65176,1424,55769,69992,929,43397,55841
41073,2589,68819,84525,1422,88902,103654,1167,37266,56170
41071,9612,43390,67083,4618,71111,94422,4994,30142,40697
41064,744,52838,53795,471,63170,61954,273,29095,32840
41063,1107,71612,80440,837,81766,90922,270,45000,45445
41062,14,0,0,0,0,0,14,0,0
41059,1283,59336,89327,841,84617,113469,442,37574,40208
41056,5300,41047,67295,3448,60000,82087,1852,22789,37398
41055,715,71250,104652,522,103750,111381,193,22708,85378
41052,41,0,0,24,0,0,17,0,0
41051,10107,82591,91096,7825,88962,96569,2282,59419,68063
41049,979,35433,48118,684,43929,57954,295,14375,24029
41048,5159,104606,122339,4261,109097,126658,898,67727,76985
41046,509,55481,61289,398,67594,67149,111,28274,36879
41045,430,49408,64633,277,50341,70243,153,33287,52495
41044,387,63244,74428,245,76250,96637,142,0,36111
41043,586,63967,88446,492,64038,89943,94,0,74296
41042,21516,65698,79759,13869,80027,90936,7647,42294,54836
41041,2852,37952,60821,1958,53860,73706,894,18182,30496
41040,2839,48717,58799,1956,67463,72642,883,14932,25620
41039,1047,50447,56711,748,53846,63676,299,34188,36600
41035,4211,58759,68038,3121,71209,78528,1090,16371,33685
41034,403,59813,78289,298,120278,98219,105,0,19157
41033,580,98333,100377,474,98533,108062,106,0,65001
41031,6562,50720,64019,4622,63452,75554,1940,19242,31928
41030,2163,61135,80768,1673,68250,88012,490,46773,48165
41018,10703,59799,77326,6724,72198,88677,3979,41675,50851
41017,15533,84360,113680,10401,103030,134979,5132,47716,66525
41016,2771,56884,64637,1414,64745,73671,1357,46036,53042
41015,7707,56126,75337,4820,73306,89299,2887,33562,47995
41014,2747,45015,57141,1397,53015,62074,1350,36983,49792
41011,12360,49317,80663,5716,67622,110804,6644,37988,53589
41010,1409,50234,63548,899,63750,69724,510,33581,51854
41008,2785,43271,64032,1857,46996,70276,928,24500,43305
41007,1716,85032,105145,1320,90950,117460,396,43889,59147
41006,1481,57696,67501,1047,70815,80402,434,18108,34371
41005,8624,88500,93557,6638,99712,101500,1986,37367,62988
41004,1545,55272,66918,977,73689,76759,568,28571,49323
41003,854,51250,54053,615,65507,61946,239,19432,24897
41002,1006,58333,71888,760,84167,84546,246,20769,29590
41001,6141,86182,103628,4838,97500,113706,1303,40803,58238
40997,132,9000,13492,87,8935,15308,45,9076,9982
40995,27,0,22359,14,0,0,13,0,0
40988,279,31438,37891,203,36422,46486,76,15556,14934
40983,95,16836,26677,87,0,27783,8,0,0
40982,125,39554,39006,112,39464,39979,13,0,0
40979,0,0,0,0,0,0,0,0,0
40977,3987,29792,41832,2871,36607,49574,1116,15873,20216
40972,447,24583,38525,302,47361,51070,145,8661,12397
40965,4843,26412,39231,2966,36567,43089,1877,16661,32187
40964,27,0,64907,20,0,0,7,0,0
40962,6534,27222,40998,4835,36533,46371,1699,13504,21479
40958,120,0,37589,74,65227,51073,46,0,15898
40953,200,40962,39039,136,61818,46436,64,0,23322
40949,298,34573,39476,254,50987,44601,44,0,0
40946,89,0,40893,78,0,41882,11,0,0
40943,221,0,35302,143,38750,45105,78,9125,17329
40941,69,0,26420,37,0,0,32,0,0
40940,128,18065,20611,80,18438,22311,48,17667,17777
40939,84,21771,30950,65,20781,21589,19,0,0
40935,1082,17851,23961,707,18660,29764,375,9094,11803
40927,201,53811,149652,190,54146,155803,11,0,0
40923,186,51458,45409,146,56136,53090,40,0,17375
40921,55,0,33987,27,63393,54863,28,0,13854
40915,374,32756,48781,335,33054,51532,39,0,19785
40914,168,0,63176,134,24750,52784,34,0,57582
40913,138,40278,33999,94,15903,27541,44,0,28882
40906,4425,27039,46228,2541,38845,58631,1884,15127,29049
40903,274,0,49868,223,62031,57082,51,0,18327
40902,457,31033,42340,389,34417,46959,68,11545,12171
40874,146,0,44858,100,51379,49142,46,0,35546
40873,903,39952,39078,603,50152,46626,300,12500,16052
40870,149,31359,41961,104,38333,51089,45,16146,20862
40868,346,27237,35141,193,0,52461,153,0,13293
40865,167,0,33636,98,0,32452,69,0,35317
40863,185,13869,19095,131,20795,22931,54,8587,9789
40862,176,57813,63061,130,71364,81195,46,0,11815
40858,156,0,37797,138,0,37536,18,0,0
40856,320,35833,40589,236,55385,48426,84,13289,18570
40855,309,32125,39003,232,39500,44617,77,20250,22087
40854,460,33750,36528,240,40093,42893,220,22266,29467
40849,139,0,30004,120,0,32483,19,0,14353
40847,84,30658,47115,84,30658,47115,0,0,0
40845,218,21458,25842,159,28958,30881,59,10417,12263
40844,31,0,0,0,0,0,31,0,0
40843,111,35804,46054,97,0,50588,14,0,0
40840,90,17941,22018,81,18272,23558,9,0,0
40831,1993,21438,38946,1314,28947,47028,679,15867,23136
40830,131,22525,20754,87,23225,24137,44,10556,14064
40829,58,0,0,26,0,0,32,0,0
40828,1374,29693,37459,1043,37212,42588,331,18188,18580
40827,366,47778,50826,346,44926,49668,20,0,0
40826,276,19113,34185,173,26250,32485,103,8594,14976
40824,178,0,34785,110,0,38310,68,0,29082
40823,1589,30896,39887,973,36514,46440,616,21961,28678
40820,183,27384,42522,117,27434,38505,66,0,48088
40819,300,25539,33583,206,0,41661,94,13393,15881
40818,35,31563,32829,35,31563,32829,0,0,0
40816,0,0,0,0,0,0,0,0,0
40815,393,27688,30804,362,29625,31599,31,23510,20419
40813,154,33281,37576,89,43375,52913,65,0,13562
40810,432,27125,39597,325,50292,47420,107,12026,15321
40808,18,0,53344,18,0,39333,0,0,0
40807,125,50536,52798,101,53854,60078,24,21250,22158
40806,1042,46000,62543,737,60033,71589,305,18750,32931
40801,176,26667,48313,106,19265,22097,70,43333,77533
40771,706,32199,30817,677,31732,30337,29,0,0
40769,5953,38780,50782,4077,47989,59822,1876,19491,29367
40763,215,19813,32151,118,25167,40014,97,11042,13058
40759,976,0,38670,771,30929,41288,205,19089,28423
40744,6584,50252,62301,4725,62018,74664,1859,18502,28723
40743,45,0,53780,45,0,53780,0,0,0
40741,9281,43935,62820,6555,49107,69325,2726,23182,40968
40740,1284,47174,49895,967,50836,54035,317,21629,36299
40737,443,61157,87171,414,66250,92143,29,17868,16190
40734,1365,30237,36474,911,37532,43964,454,14773,19920
40729,2091,32813,49409,1548,36122,52582,543,23144,28149
40701,11098,45743,63967,7703,56523,76451,3395,20737,31681
40604,0,0,0,0,0,0,0,0,0
40601,21652,59397,74774,13600,75457,87112,8052,36883,50246
40517,16644,46696,61136,8475,60524,74466,8169,34727,45265
40516,1372,77717,97094,837,90972,117362,535,49063,63270
40515,14462,78366,108170,9947,98349,124393,4515,43171,67441
40514,6041,85119,105668,4355,99121,122366,1686,52123,59789
40513,4564,106195,142469,3316,132232,168843,1248,50000,69537
40511,12555,66188,83663,7808,76233,85459,4747,50041,76426
40510,465,131549,148813,171,114688,138796,294,131940,153804
40509,17069,79977,107533,10979,99903,127907,6090,47960,65468
40508,9615,28850,45375,3219,43294,73406,6396,21088,30865
40507,1271,31146,73865,242,127212,213915,1029,19418,40339
40506,0,0,0,0,0,0,0,0,0
40505,10828,43305,55717,6145,52829,62801,4683,29635,42092
40504,11493,38634,53428,5591,48402,63579,5902,30337,40045
40503,12314,64054,84073,7469,87539,103465,4845,40160,52502
40502,12763,67449,118359,6379,128802,172842,6384,41295,62871
40489,1527,44718,52348,1189,49554,58205,338,34306,29947
40486,1020,56203,59742,919,56590,63573,101,0,22368
40484,4730,43326,59663,3187,53971,65285,1543,25940,43773
40481,33,0,43930,21,0,0,12,0,0
40475,23722,52109,71993,14369,71924,90336,9353,28095,40189
40472,792,33269,43551,516,40948,51885,276,14559,24987
40468,736,52127,65041,546,55000,72738,190,25875,38267
40464,498,56389,60232,358,65536,68476,140,27143,38179
40461,1248,59821,67315,909,70442,76877,339,41641,38843
40460,480,43750,51849,390,55818,55509,90,21543,32859
40456,3974,36875,54224,2558,53949,68839,1416,18766,27315
40448,14,0,0,0,0,0,14,0,0
40447,3408,25068,37512,2317,32674,43324,1091,16771,24132
40445,300,26250,35983,212,37188,45582,88,10250,12538
40444,5683,56393,70677,4066,66026,78671,1617,27780,46798
40442,303,63125,65903,208,92738,85219,95,0,23613
40440,901,50568,62921,623,59604,72337,278,18571,31277
40437,2272,43596,52090,1713,50191,60329,559,0,24091
40434,0,0,0,0,0,0,0,0,0
40422,9225,50453,69479,5993,63806,83433,3232,24459,39928
40419,1565,41722,52007,1143,47769,56398,422,16818,37626
40409,1264,47500,57785,948,63750,68805,316,13911,22727
40404,0,0,0,0,0,0,0,0,0
40403,9271,47703,62477,6493,55871,68577,2778,31548,44759
40402,947,32776,41287,505,48964,55040,442,21111,25574
40391,14434,54868,73618,9889,69351,82056,4545,24989,50817
40390,2361,71811,84330,1679,80371,97922,682,40250,48324
40387,747,43053,48827,420,47381,58392,327,28036,36534
40385,997,52202,58288,903,62512,61918,94,17037,23412
40383,9238,66159,80822,6723,81093,94175,2515,34563,43703
40380,2408,51786,60504,1879,61789,69294,529,14028,25725
40379,1548,57674,75252,1042,77727,91897,506,31781,37497
40376,22,0,0,9,0,0,13,0,0
40374,708,37917,51913,488,46200,63115,220,19273,25280
40372,831,69526,73072,655,77779,79228,176,46250,48751
40371,1145,35813,51777,891,40375,56317,254,18846,34166
40370,1125,70905,69563,873,75856,74962,252,38750,46055
40363,17,0,0,0,0,0,17,0,0
40361,7293,48447,70262,4727,63770,81677,2566,30833,45481
40360,2693,48668,75887,1937,50316,89286,756,30952,34609
40359,2642,51667,65247,1781,66350,81117,861,21844,29601
40358,512,48333,67331,334,71731,75935,178,30577,50710
40356,16233,63870,95718,11618,77193,111897,4615,38969,50420
40353,8590,48958,58318,6129,62411,66494,2461,29089,33655
40351,7918,43385,64080,4555,64405,84305,3363,22571,35781
40350,40,0,0,8,0,0,32,0,0
40348,305,40335,36082,196,42500,46177,109,11250,17048
40347,1204,81591,107722,808,100625,127791,396,39345,62190
40346,215,0,37805,131,48934,55042,84,10849,10923
40342,8677,54221,70524,5859,67426,83000,2818,34196,40248
40339,31,0,0,31,0,0,0,0,0
40337,2022,45903,55211,1575,57795,60727,447,23250,27173
40336,4867,32406,44592,3169,44934,52571,1698,19559,26740
40334,7,0,0,7,0,0,0,0,0
40330,8004,51257,65576,4970,65816,82059,3034,29156,35160
40328,346,33000,57775,219,55750,77700,127,14896,21854
40324,18384,71786,88592,13536,85063,97560,4848,45714,59997
40322,1304,52500,54558,874,64722,62696,430,30800,36612
40316,192,39205,47955,134,62679,62040,58,14792,15410
40313,970,35648,61539,676,43636,74367,294,21471,28799
40312,2268,33404,46047,1443,60163,56210,825,15229,25533
40311,2722,45750,62438,1912,56508,70455,810,17738,37539
40310,166,49167,52246,87,64223,76566,79,23977,25463
40299,16942,74638,92905,11465,90726,108243,5477,51331,57821
40291,15152,72877,90640,10504,86671,105832,4648,44594,50739
40280,109,43419,61883,91,44081,69609,18,0,0
40272,14373,57382,70258,10071,64084,78772,4302,37596,46273
40258,10418,53223,63329,7087,65332,72987,3331,34557,39427
40245,12469,104496,143514,9470,132588,163611,2999,54417,77103
40243,4729,75901,87709,2875,95063,107805,1854,40721,55963
40242,4780,72997,90132,2877,92316,103804,1903,57894,64888
40241,12735,80811,108565,8021,105156,131047,4714,54710,68616
40231,0,0,0,0,0,0,0,0,0
40229,14897,63661,74465,10487,74142,82040,4410,43705,50821
40228,6452,66260,80880,4229,84330,97181,2223,37342,48403
40223,9726,86256,114595,6268,108190,140164,3458,49926,66677
40222,10227,75667,114411,5286,108268,155311,4941,48575,68731
40220,14837,65707,80618,8492,82246,96956,6345,45228,57043
40219,15447,49090,61502,9406,57594,71419,6041,32991,41882
40218,13614,50048,63458,7983,60553,71157,5631,37389,49688
40217,6297,58014,87282,2325,84446,88611,3972,49162,85416
40216,16914,46761,56125,10117,55256,64289,6797,28517,39349
40215,7580,35380,45034,4429,37811,48266,3151,28184,34196
40214,17783,47189,63476,10793,62288,75806,6990,30570,40392
40213,6955,49952,64841,3691,58423,74616,3264,34167,48551
40212,6628,28646,35855,3702,31411,39986,2926,20169,26916
40211,9094,28407,39082,5050,41329,49331,4044,15857,22900
40210,5558,24574,35871,3138,24651,39548,2420,17639,26693
40209,153,43247,39527,108,43299,41608,45,0,34533
40208,5239,30559,43122,1753,45993,65129,3486,23545,30884
40207,13847,82453,123009,7816,125621,162963,6031,51627,69368
40206,9812,57486,83152,4075,83229,117627,5737,45336,56669
40205,10321,83703,113676,5949,115030,145111,4372,49653,69461
40204,7590,52273,79675,2983,81442,105214,4607,48145,61950
40203,8936,25129,40085,3170,33160,47947,5766,18590,34638
40202,3104,17295,48874,561,34185,110770,2543,12061,35171
40178,194,61875,90638,166,85469,101523,28,0,26100
40177,635,43174,70224,419,45444,66655,216,0,27041
40176,350,36818,44082,234,45956,52610,116,0,22269
40175,5278,63514,82168,3906,76100,91988,1372,37596,51237
40171,69,28583,32599,26,0,0,43,15469,18330
40170,157,64583,65592,102,66694,66840,55,0,0
40165,14041,65599,77422,10391,74486,84893,3650,34429,50537
40162,1864,76726,91512,1604,81853,96495,260,40500,45323
40161,72,52800,52471,14,0,0,58,47083,48024
40160,9458,48058,60759,5763,54742,71747,3695,36967,39567
40157,298,65417,79588,206,97857,97251,92,36667,39097
40155,462,50361,46020,305,51706,54707,157,20956,27442
40152,338,64792,103855,283,95781,119202,55,0,24885
40150,1703,55293,68607,1433,56250,71096,270,30227,43695
40146,1489,42054,50934,917,51397,60674,572,19417,32961
40145,208,46375,78141,172,46250,74455,36,0,43239
40144,589,46806,57348,246,72115,82321,343,33190,38855
40143,2429,51905,69249,1596,71875,83191,833,29777,41036
40142,833,66278,80080,587,79840,98223,246,38977,36788
40140,305,0,31744,172,0,30305,133,0,29726
40121,2472,63119,76528,1903,66583,81120,569,46719,57106
40119,796,67561,67046,611,71927,69560,185,31875,57095
40118,3650,51217,60141,2461,54453,68871,1189,35404,38160
40117,864,46937,62925,549,61438,60991,315,45466,60271
40115,241,53063,57193,184,59000,62475,57,42813,39621
40111,661,39375,47270,419,49145,58386,242,15909,24513
40110,30,0,0,30,0,0,0,0,0
40109,696,61971,85950,501,69010,98364,195,60401,53981
40108,4616,66652,80169,3280,84194,94962,1336,32225,41177
40107,899,73969,76000,749,82742,84904,150,30000,31283
40104,426,63542,74405,241,85417,89494,185,54226,54749
40078,977,47470,66035,607,65313,79220,370,25952,44373
40077,237,68958,71452,156,94000,92605,81,26958,30711
40076,963,70156,79429,767,84276,87231,196,32208,45884
40075,368,58000,58099,300,59333,63549,68,0,34057
40071,5854,85696,97651,4745,92201,105255,1109,33178,57170
40070,193,53242,65932,92,122813,104521,101,0,30695
40069,3311,58299,73872,2141,75018,89419,1170,38333,43530
40068,795,74620,90039,573,79704,105598,222,35781,48186
40067,2261,93832,121966,1792,100319,133308,469,46354,77794
40065,11213,66231,82355,7836,79651,96131,3377,28293,45018
40063,0,0,0,0,0,0,0,0,0
40062,69,26458,37378,44,43438,50070,25,0,15040
40060,520,45000,50272,328,46875,55992,192,41250,38840
40059,7830,151111,216271,6220,175938,248461,1610,65682,91378
40058,42,0,45583,36,0,47631,6,0,0
40057,1518,52577,62302,1129,53295,66253,389,41806,44773
40056,1236,87647,113321,926,97656,124913,310,48816,73597
40055,780,71061,78510,625,66276,79247,155,76149,67959
40052,162,46125,63487,123,0,71585,39,0,37946
40051,1817,57712,65836,1235,68580,78133,582,25172,33792
40050,656,29100,40579,318,51029,62722,338,0,16830
40049,0,0,0,0,0,0,0,0,0
40048,0,0,0,0,0,0,0,0,0
40047,7091,75428,82962,5245,90076,94252,1846,33500,41320
40046,545,76165,79604,401,86563,93691,144,0,26992
40045,1634,44786,69834,1049,61571,89503,585,21637,33744
40041,300,0,68737,75,148838,141411,225,20134,44512
40040,158,22394,34222,88,34375,39667,70,22012,27377
40037,1040,56979,59147,733,71283,67705,307,23125,31711
40036,124,61250,63211,57,62411,67298,67,0,59733
40033,4868,40485,57823,2866,59679,74325,2002,24527,32563
40031,7529,74973,90376,5668,90300,102442,1861,40325,46094
40026,1949,117882,166985,1718,127300,180145,231,53295,58318
40025,43,"250,000+",480965,39,"250,000+",511985,4,0,0
40023,1872,114659,132931,1586,127611,141212,286,67083,79358
40022,325,114250,120913,288,125857,131927,37,0,35181
40020,138,75514,67888,112,75959,75696,26,0,34258
40019,1533,43098,68822,1019,64830,86437,514,28523,30572
40014,7287,105942,132359,6398,115000,137973,889,42554,84196
40013,2250,73779,104608,1614,83276,120664,636,50500,58861
40012,255,58542,66127,210,53214,70218,45,0,28871
40011,1046,55403,64654,767,65614,77099,279,16026,26826
40010,207,113661,123018,195,114732,129055,12,0,0
40009,572,55117,51992,354,63472,56952,218,0,38572
40008,1333,50037,61121,884,58889,70263,449,34542,40179
40007,25,0,48472,5,0,0,20,0,0
40006,1675,61838,67429,1106,66486,74150,569,39028,52763
40004,11732,61974,76107,7793,73332,90463,3939,32125,45161
40003,749,78068,84259,572,75000,78937,177,80720,101185
39897,1253,41801,57963,931,45964,60927,322,37674,43261
39886,569,37125,47445,323,38295,54207,246,33333,38468
39885,23,62917,57322,18,0,58944,5,0,0
39877,198,39667,47970,128,52344,61441,70,17143,23320
39870,929,32019,54192,529,56250,74055,400,12115,20375
39867,137,20764,36386,93,0,43625,44,0,21089
39866,177,34821,55519,92,57750,81723,85,16375,27156
39862,437,41950,61312,283,52426,69331,154,18654,44899
39861,420,34167,39190,247,40972,45255,173,17813,21729
39859,413,32569,53694,308,45938,61838,105,17679,23992
39854,1047,38060,55490,625,55417,72061,422,27904,27959
39851,868,27625,39907,404,34848,54350,464,16250,27319
39846,681,34871,47614,479,40156,51743,202,22656,35315
39845,3044,35370,60107,1917,43652,73766,1127,27639,34707
39842,2818,33938,48770,1938,35761,52769,880,25774,35060
39841,358,41944,114247,177,40903,61290,181,0,164529
39840,2085,28338,33726,1303,34620,41000,782,16484,19830
39837,2510,48617,57603,1723,59254,71092,787,18536,26689
39836,111,90462,79960,111,90462,79956,0,0,0
39834,723,38487,55734,498,48333,65437,225,19432,32067
39828,5319,44764,58119,3525,58357,71986,1794,16883,26939
39827,1527,55742,83168,1181,70162,96084,346,30781,38499
39826,245,30694,47987,113,56607,75295,132,17061,24611
39825,465,47220,77286,395,64107,84753,70,27000,35156
39824,284,41597,50363,175,75150,56725,109,40816,34849
39823,3205,32324,47253,2097,38507,51591,1108,20633,36419
39819,4029,39280,58867,2628,53594,71815,1401,30213,32467
39817,3785,40536,50871,2727,46808,60424,1058,17864,21556
39815,537,45417,48901,371,57969,56454,166,0,30958
39813,896,39712,51408,702,55441,57043,194,0,21193
39776,563,35023,49315,402,46250,60368,161,17679,21481
39773,6222,33272,55972,3889,45205,58550,2333,23516,50644
39772,686,34211,47573,475,41250,53926,211,26688,30159
39771,51,49375,66418,40,0,78595,11,0,22136
39769,576,51902,86029,299,65099,67563,277,0,105963
39767,406,37750,85831,211,51761,137968,195,16387,25212
39766,988,58382,69164,680,71071,82714,308,31136,37801
39762,23,0,0,23,0,0,0,0,0
39760,12,0,0,0,0,0,12,0,0
39759,17580,39472,60145,8901,64196,81815,8679,18763,37727
39756,607,32109,39942,407,37888,46258,200,26643,27090
39755,352,42188,64023,207,48558,77808,145,37679,44343
39752,1020,45962,57316,716,63871,70044,304,21064,27138
39751,506,51058,62247,354,66458,74928,152,33000,32419
39750,1089,35898,45218,594,59762,60544,495,16791,26363
39747,800,33491,43294,384,42841,54797,416,20455,30437
39746,1036,46786,60641,654,59700,73271,382,25682,39018
39745,277,36058,47728,147,82417,76978,130,11036,14652
39744,2128,43500,52603,1412,55208,61756,716,21719,34450
39743,681,40900,60382,414,42465,67143,267,22917,48787
39741,707,32458,45204,479,0,56870,228,14706,19980
39740,2137,74761,76770,1647,88013,89174,490,24063,34034
39739,989,35764,42203,630,35926,48911,359,0,30432
39737,70,65662,59437,49,66434,75298,21,0,0
39736,135,16681,26070,59,0,27790,76,16724,24734
39735,1488,38607,59672,967,63250,70568,521,21455,38002
39730,4220,42313,61156,2869,56550,71043,1351,19479,38118
39705,5143,66605,74638,3204,76047,86729,1939,42585,53290
39702,8383,49612,65747,5866,59903,78364,2517,21538,34835
39701,5290,26000,49128,2452,47180,69766,2838,15030,30730
39669,1960,28931,48786,1165,37679,60192,795,25598,32071
39668,400,0,51583,359,65502,50243,41,0,31495
39667,4743,30805,53615,2676,54444,69382,2067,13374,33086
39666,3554,38292,65434,2234,51400,71330,1320,17798,54191
39665,667,31162,43514,563,37039,48560,104,13125,16198
39664,758,42971,59150,535,53977,73047,223,20766,25810
39663,983,46964,49272,612,54054,58287,371,0,34361
39662,425,46359,71353,304,73915,87912,121,0,29752
39661,955,34513,47924,683,36250,54699,272,0,28676
39657,785,25179,38009,386,34063,58219,399,0,18221
39656,234,53482,57600,165,58163,71279,69,0,24893
39654,2108,33423,49741,1368,34821,61915,740,17895,26044
39653,943,44616,53826,786,44803,52388,157,0,60911
39652,3088,37136,42711,1936,45628,52978,1152,15962,25278
39648,7649,30646,41855,4066,40657,51665,3583,22532,30477
39647,289,0,76417,223,71518,94461,66,25000,13959
39645,2152,30978,44830,1244,44485,62563,908,13512,20471
39643,347,31329,42108,238,42283,55356,109,13750,13183
39641,1711,41278,50526,1247,41942,54232,464,0,34741
39638,1304,34394,54969,961,50982,65173,343,17066,24776
39635,124,22833,24358,86,0,29566,38,0,0
39633,497,19739,34408,357,0,39369,140,0,21756
39631,1533,28438,49039,912,40333,60935,621,23207,31569
39630,448,21875,32345,248,20769,29463,200,24773,34536
39629,2618,42214,61664,1859,76715,78713,759,14289,19520
39601,9051,40551,58167,5960,49773,71591,3091,18343,29923
39581,4324,36055,47555,2407,42167,57797,1917,26840,33871
39577,3557,36463,54756,2459,39978,64064,1098,19333,30574
39576,2724,50900,72825,1908,89858,90275,816,25365,29019
39574,5064,56184,67715,4044,62614,74233,1020,29397,38559
39573,3095,67527,78509,2287,69854,91284,808,38106,38232
39572,496,50641,56942,307,58125,67488,189,42688,39812
39571,5635,51989,70233,3729,60708,77450,1906,27405,51492
39567,3830,50406,74496,2329,67261,101771,1501,24026,30948
39565,6824,69722,87402,5140,83618,98847,1684,26532,49518
39564,15926,61212,80763,10966,76942,94251,4960,43762,48900
39563,5207,45763,65491,3358,60024,74423,1849,27152,47128
39562,7026,40965,60839,4223,61889,75387,2803,20863,38420
39561,722,44250,52680,555,50439,59386,167,24205,30395
39560,7132,60507,74976,4829,74221,87755,2303,37701,47390
39556,2978,53694,74453,2283,62458,83954,695,16811,34507
39553,6346,51316,65548,4351,64985,77294,1995,32528,38787
39540,3654,42390,65086,2169,64280,71821,1485,37285,52547
39534,0,0,0,0,0,0,0,0,0
39532,14071,59485,73691,9535,67908,84299,4536,43182,48139
39531,7291,46819,66504,4181,62409,83467,3110,31852,42164
39530,3391,30378,46119,1881,40116,55018,1510,21819,32456
39525,3857,64041,84241,2715,86927,99831,1142,34762,45758
39520,8943,43685,75182,5905,51365,72034,3038,35137,78792
39507,7311,46457,65626,4110,60066,82445,3201,31508,41269
39503,20788,54264,69411,15037,60976,76994,5751,35212,47230
39501,9376,28315,37785,5336,30821,41015,4040,21626,30454
39483,2412,28060,51792,1409,33958,61181,1003,19375,37075
39482,4072,68413,74335,3431,69555,80949,641,28641,38144
39481,633,54755,78916,524,90486,87434,109,41250,37967
39480,1157,54005,61373,852,68520,72593,305,21669,29961
39479,2499,41250,55006,1712,45913,60234,787,0,42364
39478,735,41268,55144,485,42272,68412,250,15573,28698
39477,255,39276,58025,205,44327,64409,50,20000,25034
39476,2688,44318,55817,2079,49659,60795,609,21838,35739
39475,5079,57441,77315,3672,67083,91088,1407,27633,39174
39474,2358,26175,44470,1476,44750,56192,882,15925,21356
39470,4558,48333,63024,3153,55830,72019,1405,33292,40249
39466,11319,45140,58831,8189,57238,68102,3130,21926,31455
39465,7650,59113,71859,5874,64104,79593,1776,38534,41449
39464,1007,53132,63778,922,53564,65062,85,52690,43148
39462,376,52759,76949,236,133500,106387,140,20389,27134
39461,271,43489,65038,171,0,83472,100,43134,33514
39459,1320,44625,52076,930,46912,57374,390,26818,38691
39456,224,40139,49667,139,55625,64340,85,21932,25675
39455,3475,40053,56606,2466,59276,68609,1009,14002,25632
39452,9369,47100,63676,6760,57838,70871,2609,21380,43465
39451,1147,33589,53966,718,60346,72396,429,18886,22474
39443,7795,51165,72080,5824,65422,80925,1971,23507,42261
39440,8282,33953,54700,5136,42481,63980,3146,25727,35564
39439,1863,29927,46976,1410,34872,54358,453,17670,22873
39437,4318,47727,61533,2969,64578,73662,1349,26250,34015
39429,6573,32138,49490,3896,44555,63687,2677,19890,27839
39428,3374,30810,43339,2422,37688,50732,952,13180,23984
39427,540,47273,69459,383,52356,76201,157,20855,44159
39426,6477,74818,82189,5299,77062,88070,1178,22207,39084
39425,868,56007,74036,634,60946,93635,234,13192,20933
39423,1203,48297,52179,753,47722,59692,450,49188,39375
39422,1716,39937,56207,1265,53075,66469,451,19276,26373
39421,1225,32485,51864,814,49181,65370,411,17784,23959
39406,0,0,0,0,0,0,0,0,0
39402,15326,61083,94466,10322,82884,116436,5004,31739,47191
39401,16313,32917,49466,9019,40771,58140,7294,24247,36452
39367,5905,29404,57554,3935,49678,71629,1970,15469,27417
39366,332,26071,37210,173,60134,51863,159,19180,21267
39365,2704,45254,57947,1987,54010,68718,717,18042,26511
39364,1193,37127,45104,884,54444,56032,309,7798,13840
39363,555,24646,43911,351,55039,53180,204,14661,18859
39362,1626,49141,61490,1100,0,69034,526,48131,45601
39361,630,38302,46669,358,63826,62159,272,27813,26028
39360,1426,24880,50473,952,36200,65710,474,19205,19316
39359,112,44375,73449,78,71250,85486,34,31250,45835
39358,398,44500,69080,227,96813,103772,171,18829,21926
39356,216,0,71103,149,76191,91735,67,18950,15615
39355,2643,40156,52731,1797,53880,59722,846,17399,36794
39354,1034,40172,76485,638,55309,99483,396,24762,32049
39352,294,37108,46496,144,56708,65551,150,35098,28203
39350,8877,39885,54446,5816,49714,63716,3061,19926,30778
39348,272,26000,30229,113,26125,31860,159,18109,21466
39347,615,37532,39557,431,39078,48434,184,9474,18153
39346,781,46050,63971,520,47833,58113,261,22292,71338
39345,2254,35367,47601,1451,41519,54612,803,30137,34617
39342,611,52917,52218,432,60284,57578,179,27875,39282
39341,2355,36326,47679,1660,40813,51372,695,16250,36103
39339,5849,37048,55834,3777,46497,62251,2072,23789,42348
39338,1550,24534,41402,1020,43553,54306,530,17661,16189
39337,678,54571,65391,486,58750,74756,192,30588,38124
39336,413,42784,46235,314,46000,50319,99,25114,33282
39335,989,74391,91143,691,83688,107424,298,0,45619
39332,650,42434,80689,446,77045,89790,204,40822,60790
39330,1006,66071,81690,733,73102,99598,273,24654,33484
39328,2025,22259,39421,1264,29758,46394,761,14866,21455
39327,1584,51063,88237,955,85578,122232,629,30747,36137
39326,132,0,24870,115,0,26645,17,0,0
39325,2394,59773,83832,1808,73571,101392,586,14980,28910
39323,496,33617,49911,341,43897,62877,155,17250,21148
39322,629,45893,55618,483,47265,67667,146,13399,12878
39320,669,43738,67109,638,43550,65847,31,132578,93065
39309,0,0,0,0,0,0,0,0,0
39307,6364,26909,38817,3999,33842,43249,2365,15084,29232
39305,8229,56455,73136,5452,74375,88175,2777,26749,43441
39301,10188,37972,60454,6292,49890,68815,3896,23647,45413
39272,4683,67348,74617,3540,78492,80073,1143,50802,53326
39269,0,0,0,0,0,0,0,0,0
39232,3388,69198,89300,2179,101091,109855,1209,32574,51092
39218,2843,46782,57587,1886,59522,69903,957,35189,30294
39217,0,0,0,0,0,0,0,0,0
39216,1788,40595,73980,705,104240,126152,1083,28994,38491
39213,8195,26177,38592,4844,33849,46944,3351,18411,24169
39212,11239,48200,60266,7598,57722,67269,3641,34982,42714
39211,10019,62606,90218,5964,79067,112901,4055,43464,53932
39209,9599,30484,42460,6435,36362,45795,3164,21057,32372
39208,11756,49473,62290,7609,61750,69368,4147,37408,45718
39206,9916,42147,57018,5447,50252,69589,4469,30092,40088
39204,5994,29591,41069,3219,36619,51164,2775,21028,26036
39203,2099,24281,35560,1115,28628,45469,984,13188,22482
39202,3668,31308,58858,1164,73654,95923,2504,24990,39932
39201,723,66135,69514,26,0,166765,697,66096,65886
39194,5998,29516,50251,3662,34919,58585,2336,19229,31903
39193,0,0,0,0,0,0,0,0,0
39192,478,36250,40166,331,48646,51205,147,12938,15144
39191,2661,50974,62327,1990,61094,69402,671,30625,40727
39189,1312,34545,44265,798,47794,56646,514,17872,22275
39183,5313,49542,67666,3273,70057,84118,2040,27439,40416
39180,12568,46221,64385,7650,55216,75635,4918,30565,45714
39179,334,59625,82615,228,71250,75481,106,0,96742
39177,84,53385,45090,84,53385,45090,0,0,0
39176,1095,25188,38256,685,30375,43139,410,0,27883
39175,1531,32077,49786,980,56944,63955,551,17721,24548
39174,124,58125,50765,72,0,0,52,0,0
39170,3695,60438,80639,2928,72667,86925,767,29207,53152
39169,1205,23967,31700,628,30347,31163,577,16985,30894
39168,2632,38575,55077,1669,55170,67403,963,18934,32695
39167,0,0,0,0,0,0,0,0,0
39166,237,33125,43995,164,36467,57549,73,10820,12953
39162,32,43750,47491,19,0,58442,13,0,31477
39160,1048,30240,46630,799,37578,52026,249,11888,21262
39159,1171,44583,55796,853,53558,66182,318,14889,22053
39157,10235,61091,99795,6060,71522,121895,4175,44786,65924
39156,226,46535,56369,209,46420,55811,17,0,0
39154,3445,63524,77101,2468,78944,91786,977,22792,38421
39153,1176,37083,49096,681,56641,67107,495,20967,23349
39152,397,26543,39252,276,0,45621,121,0,24725
39150,1924,32500,53191,1087,36563,41928,837,18142,66418
39149,653,55295,54860,439,52243,55249,214,56224,54051
39146,1016,30946,46022,692,32143,46518,324,23382,43718
39145,2101,51405,72149,1585,52142,69819,516,32870,78268
39144,257,0,54697,226,0,56381,31,38594,42423
39140,1031,36148,52980,720,41757,60920,311,0,33526
39120,11068,30832,47501,6638,39688,59937,4430,18422,28250
39119,1728,58205,78803,1403,59920,84338,325,34826,54636
39117,3494,47810,71625,2944,53568,78485,550,18065,28786
39116,1048,48854,58421,652,62661,79945,396,14412,22719
39115,73,0,30905,73,0,21825,0,0,0
39114,3780,42426,71807,2447,62948,94273,1333,20455,26648
39113,160,11316,55078,59,0,126710,101,10724,12862
39111,2893,37660,55182,2073,43179,60254,820,18919,33820
39110,15467,112866,148163,12100,132871,170178,3367,56250,68415
39108,563,41250,50693,326,53750,61333,237,24063,33911
39097,185,21027,32589,90,30417,35879,95,0,29314
39096,612,47976,59270,326,67568,56805,286,15789,48343
39095,2288,28444,49755,1280,40917,59346,1008,16250,35974
39094,1458,43750,57611,976,54444,71275,482,18605,25273
39092,1115,38482,57996,812,48571,61961,303,23589,44332
39090,4980,33622,62796,3415,47367,74450,1565,16724,36565
39088,26,85357,99158,19,56607,60247,7,0,0
39086,519,24631,27114,382,23859,28824,137,16298,19258
39083,3404,38713,50875,2427,44776,57202,977,21295,34823
39082,412,50846,65789,370,51500,63014,42,25000,30943
39079,459,21130,32691,317,22644,37823,142,10000,19207
39078,219,46012,42705,134,56250,48467,85,32938,30519
39074,5672,39808,50884,3661,56038,65195,2011,16823,22914
39073,7757,63543,71320,5824,70693,78321,1933,20082,41170
39071,2331,65583,89642,1868,79571,102924,463,30904,32489
39069,1688,27572,41154,1120,35000,52417,568,13689,18946
39067,455,43191,47470,335,46292,55024,120,25469,26294
39066,1913,37067,63391,1199,57875,68577,714,32177,50547
39063,1359,21602,34271,877,26760,40069,482,18813,22652
39062,172,48056,64306,119,0,66061,53,35972,39098
39061,0,0,0,0,0,0,0,0,0
39059,3983,53210,83326,2696,73158,104934,1287,25625,35874
39057,871,29946,50323,694,33761,58076,177,16563,19263
39056,8969,64732,82975,6210,78038,93628,2759,34798,55663
39054,167,17813,29169,87,0,36516,80,14226,21179
39051,5953,34659,52161,3865,50008,60522,2088,23725,33055
39047,14955,88838,108461,10671,104242,121013,4284,49580,73498
39046,11076,40497,58999,7047,51020,70991,4029,28208,35702
39045,705,35234,55380,416,66500,76103,289,0,21981
39044,1248,63148,77648,929,71360,90423,319,26469,35895
39042,13383,77564,91876,10218,82243,100417,3165,46686,56433
39041,1471,34762,49821,964,59342,60618,507,31083,28122
39040,1286,39091,53537,803,53547,68017,483,15946,24717
39039,824,33750,45593,539,44250,50271,285,33327,35116
39038,2099,27987,44433,1412,30696,51588,687,17383,27414
38967,2835,45498,59214,2113,46629,59581,722,39535,51730
38966,279,21449,28488,173,24050,33362,106,20568,18376
38965,3482,46417,54776,2359,52620,60646,1123,21420,39719
38964,27,0,0,27,0,0,0,0,0
38963,801,28931,47258,652,28581,47064,149,14962,27691
38962,23,0,0,23,0,0,0,0,0
38961,259,0,40770,172,54643,55765,87,9018,11125
38958,0,0,0,0,0,0,0,0,0
38957,213,33750,42594,95,45313,50824,118,0,34576
38954,308,24521,48154,218,36111,60524,90,18125,18190
38953,185,75865,93669,185,75865,93669,0,0,0
38952,207,55583,68524,135,74107,87561,72,34167,32829
38951,536,34770,47869,249,54764,70118,287,31484,27041
38950,142,0,34228,59,58802,62976,83,14179,13793
38949,160,60250,63408,127,60938,61469,33,0,70870
38948,1059,28271,37253,571,54816,53779,488,13500,17272
38947,267,0,71818,144,0,126198,123,0,8154
38946,97,16211,21109,50,0,24112,47,16359,17913
38945,15,0,0,15,0,0,0,0,0
38944,126,49239,50945,94,49783,54282,32,38438,41141
38943,103,35350,31927,60,36400,35357,43,0,27142
38941,1332,21719,36277,732,27188,44671,600,18409,25237
38940,594,44324,61744,378,53030,78404,216,30539,31579
38930,8241,31498,56672,5102,38555,72484,3139,14778,29453
38929,711,51493,56041,582,56623,65391,129,25000,13859
38928,130,11184,13058,57,22670,19635,73,8750,7922
38927,417,0,43833,248,54652,61005,169,0,15720
38925,1200,30375,42445,712,39177,49205,488,18750,32583
38924,169,26691,44484,68,35625,52282,101,23750,38529
38923,398,66176,63042,188,97621,88454,210,26310,40292
38922,1116,38036,50264,710,48095,57002,406,23125,32418
38921,1632,33766,54909,1000,53152,71510,632,19882,25964
38920,283,26146,30041,151,31683,35230,132,12083,22886
38917,1136,54915,65912,860,63000,73062,276,25313,42735
38916,2005,37851,48272,1371,44570,56633,634,22439,28986
38915,1569,44741,51822,881,61275,67917,688,24018,29695
38914,272,45714,50635,232,45536,50407,40,48750,50885
38913,180,38333,39657,152,38611,41757,28,0,28261
38901,7281,37976,61930,4399,53121,79450,2882,24387,32384
38879,278,65833,45610,190,68567,55795,88,15588,23619
38878,994,40213,48090,713,45625,58225,281,14320,17180
38876,531,41375,52919,438,33000,51171,93,18750,27219
38873,993,48750,49780,703,54837,59525,290,16694,24333
38871,590,60000,82511,461,71583,90896,129,19375,50663
38870,931,47443,57272,704,52130,64775,227,23424,27641
38869,155,39432,57471,95,53365,79854,60,0,22025
38868,2225,40240,50661,1472,57969,62022,753,19083,25232
38866,4368,67807,83859,3454,72267,94864,914,29310,38535
38865,1732,46711,53253,1297,49901,59602,435,26450,31815
38864,715,43681,57538,610,64063,62211,105,26307,23710
38863,6896,49941,61093,4831,58679,71457,2065,26692,34255
38862,1051,48164,57192,706,62015,72749,345,22950,23695
38860,1983,34517,52468,1368,47813,62197,615,20889,29155
38859,212,78015,66494,154,79412,77264,58,0,37900
38858,2552,56314,66331,1968,61103,72282,584,30500,38671
38857,1468,71212,81993,1196,93667,91894,272,32500,31594
38856,741,57083,81469,450,81544,78189,291,40524,86064
38855,1744,50909,88884,1204,56111,65958,540,31637,135413
38852,3767,38591,52475,2541,50075,65577,1226,13736,24096
38851,3410,36727,45480,2370,45793,54108,1040,17378,23509
38850,890,36818,52014,619,58438,62587,271,13304,27204
38849,1989,63388,71739,1607,70129,79291,382,31643,35792
38848,270,44545,49133,178,57857,56045,92,21250,35759
38847,1357,45915,53430,901,49210,60558,456,27935,39346
38846,798,49516,56781,561,62917,68276,237,22266,28750
38844,102,53654,59388,59,0,65820,43,53622,50560
38843,3958,43198,60524,2756,61206,74119,1202,18584,27529
38841,1181,43139,51238,929,48787,58728,252,12976,20644
38838,456,23000,33683,286,43375,43863,170,14609,16556
38834,11769,40256,56784,7417,53472,72280,4352,18529,28510
38833,951,38309,51399,538,44632,60978,413,24492,36789
38829,6940,40658,52916,4537,50053,67884,2403,14708,22316
38828,1392,46167,59720,941,57171,74581,451,18991,27776
38827,1502,36727,47325,817,61417,68281,685,16174,22330
38826,1743,64519,75709,1134,85385,94260,609,31473,39969
38824,2767,38916,52712,1843,50234,61671,924,21579,31097
38821,5128,49145,62695,3472,63947,77197,1656,20694,30108
38804,6686,46129,71818,3784,60341,99104,2902,23407,35197
38801,11715,56285,71139,7635,65097,81418,4080,32719,49686
38781,87,10972,21961,34,0,30359,53,10787,16342
38778,494,24167,48370,321,41164,61897,173,14125,22053
38774,735,27088,36216,495,25241,35705,240,34435,35005
38773,1352,29392,42890,935,37675,49846,417,18750,26429
38772,19,0,0,0,0,0,19,0,0
38771,1098,42616,58286,611,47928,63260,487,28750,39527
38769,809,16023,28451,499,16960,33551,310,14407,18652
38768,31,0,0,14,0,0,17,0,0
38767,26,37500,37277,9,0,0,17,0,0
38765,71,0,0,27,0,0,44,0,0
38764,145,23438,36288,67,55398,55904,78,13700,19437
38762,905,27813,38434,528,40441,48613,377,19074,23711
38761,677,27391,51107,498,27230,56624,179,27292,34972
38760,303,37083,49715,199,43664,58738,104,17813,32450
38759,510,45625,84904,255,63317,68329,255,0,101480
38756,2648,45735,73141,1675,52858,79604,973,29469,60178
38754,614,35463,141429,375,32279,67124,239,35387,256729
38753,487,47574,61167,344,62917,74344,143,26250,29467
38751,3887,31936,47341,2312,43949,60970,1575,15400,26511
38749,23,0,0,20,0,0,3,0,0
38748,1130,45233,66046,781,60114,75251,349,29875,39406
38746,165,21354,46887,111,22396,40409,54,14688,52220
38745,69,0,51658,16,0,0,53,0,39742
38744,253,29509,55359,111,28795,45026,142,0,63437
38740,67,41625,63416,42,41250,49026,25,0,87592
38738,66,33646,56324,15,0,0,51,32865,33451
38737,1205,22238,35947,773,25057,41799,432,18231,24502
38736,91,41771,52458,52,72083,65237,39,26917,35162
38732,6161,36316,63000,3914,51940,75589,2247,18367,38336
38731,68,0,58841,38,0,105295,30,0,0
38730,792,52890,64853,570,54156,74376,222,35938,35270
38726,194,27167,40305,127,27125,37091,67,20417,44240
38725,341,48750,57642,243,90129,69320,98,19219,26439
38723,27,0,0,27,0,0,0,0,0
38722,106,18333,32482,77,0,37362,29,17917,18297
38721,423,30478,62411,248,72500,86516,175,25893,28251
38720,353,0,40134,204,50192,43978,149,23265,33882
38704,5,0,0,0,0,0,5,0,0
38703,4323,28517,45110,2761,38104,48722,1562,20957,34374
38702,13,0,0,13,0,0,0,0,0
38701,9096,30488,52105,5718,41944,63636,3378,18096,30351
38685,506,54650,96490,405,0,115826,101,0,15318
38683,1644,34096,46959,1086,47370,60458,558,15952,19884
38680,2338,56146,66764,1759,63433,72614,579,31882,41610
38677,0,0,0,0,0,0,0,0,0
38676,2230,30565,38739,1327,37557,48695,903,13595,21899
38674,309,37198,48840,252,39688,56472,57,0,15100
38673,399,82271,90594,313,82165,89491,86,0,94608
38672,5155,97127,105343,4251,109155,113101,904,55652,66032
38671,14355,52897,64466,9548,58023,69890,4807,38162,48477
38670,371,30234,35839,203,42094,49060,168,15809,19495
38668,4827,61754,76146,3724,77253,87106,1103,25587,35958
38666,2924,33892,59831,1651,38068,81388,1273,26481,28984
38665,1085,51139,67859,829,52880,75816,256,0,40097
38664,1383,42104,44308,626,34500,41288,757,37946,41882
38663,4691,35200,49253,3121,45972,60914,1570,14413,25293
38661,809,42159,55922,587,62838,63028,222,23750,32850
38659,1055,43083,58391,801,47063,65795,254,0,24712
38658,885,53594,51125,613,70257,63495,272,11791,19747
38655,16476,53497,79949,9289,74357,106447,7187,33825,42613
38654,19040,86949,97880,14220,95933,108522,4820,50237,62462
38652,6060,46987,61286,3952,61026,74607,2108,26844,33424
38651,2786,93108,104201,2416,91705,107339,370,0,67319
38650,1413,47715,69696,1150,52337,76596,263,30078,24929
38647,235,19207,26261,196,0,27186,39,0,0
38646,1276,27252,45386,715,52292,56331,561,16898,30754
38645,571,37250,50238,366,49167,59535,205,28542,33640
38644,71,42813,175841,45,68472,253793,26,30882,40927
38643,797,17147,29704,356,25833,38916,441,11660,22268
38642,996,47995,53143,737,50589,57338,259,33234,33238
38641,798,58306,75623,533,92344,88757,265,34161,49205
38639,334,17368,28487,214,26000,36037,120,10476,15023
38637,9298,52196,61656,6697,54981,65872,2601,40884,44897
38635,5538,41023,54953,3735,46010,62736,1803,21967,31790
38633,868,43789,58762,674,61250,69953,194,14397,19882
38632,9726,72123,91757,7382,83714,102851,2344,39455,54497
38631,540,21786,27449,373,15104,25041,167,22688,26587
38630,72,39103,44222,21,0,0,51,0,0
38629,594,52785,56852,414,52738,58822,180,52969,52294
38627,527,0,51829,301,71490,77497,226,13758,17642
38626,475,0,48182,294,50400,67706,181,0,16468
38625,614,44231,58311,496,46875,65199,118,14401,25681
38623,103,21382,34050,56,29750,36071,47,11679,29323
38622,281,19904,26771,206,31842,29934,75,11442,14908
38621,658,27841,35817,432,31053,40110,226,22353,22623
38620,1008,38829,52614,730,55042,63134,278,13400,22524
38619,1868,25262,38455,1217,38683,46436,651,16515,22176
38618,4658,41831,59320,3422,49274,66152,1236,27885,39889
38617,225,21116,36300,105,64375,58410,120,12045,16239
38614,6447,31662,50599,4129,39596,57400,2318,16024,35398
38611,6198,50828,71174,4690,60059,76693,1508,29182,50797
38610,918,42432,51505,631,55598,62279,287,16484,27818
38606,5299,46957,72160,3649,57406,80757,1650,25877,43432
38603,1216,46290,51794,723,53762,64215,493,21784,32404
38601,719,33563,51149,474,46250,62965,245,18976,25111
38589,110,47660,41642,81,48431,47257,29,30486,25959
38588,342,44000,55602,170,72500,78899,172,23125,32576
38587,509,31736,43236,237,52361,68227,272,18500,19896
38585,1691,41128,51268,1175,53083,61267,516,17295,24764
38583,9299,45976,60977,6491,53262,66449,2808,22544,46729
38582,700,58389,71722,533,61518,79907,167,30568,42219
38581,1455,41538,54784,1068,50988,63685,387,27690,27543
38580,605,57625,68967,438,66964,80357,167,32109,31665
38579,402,43636,61886,260,72000,71793,142,41000,38522
38578,90,0,43358,35,70625,73674,55,18993,24065
38577,554,42616,54240,326,56750,66466,228,20690,36758
38575,450,43421,48897,353,49432,53633,97,25089,28762
38574,3360,45158,57801,2503,54125,66438,857,20509,29000
38573,791,52708,74874,591,72423,92429,200,14135,21698
38572,4916,47797,58870,3297,55226,69101,1619,29923,36717
38571,5721,49755,64863,4254,60594,74090,1467,23497,34113
38570,4231,31786,48264,2420,46507,59779,1811,20292,31271
38569,66,0,191636,52,0,229092,14,0,0
38568,778,45263,67313,495,56705,87296,283,25893,31185
38567,288,0,64240,216,97609,75133,72,27143,23190
38565,310,33769,51830,212,46081,63916,98,26071,25685
38564,264,18857,30642,120,0,47873,144,14470,16282
38563,1101,56285,78891,918,57589,84655,183,32004,44703
38562,2372,36236,45550,1500,50802,57346,872,17154,24100
38560,480,46250,57819,369,51583,62469,111,36094,39984
38559,494,53194,64332,350,65278,79958,144,16200,23287
38558,4875,57998,63380,3598,67851,71998,1277,33910,38376
38556,5001,36960,46282,2882,48083,58171,2119,20035,29054
38555,8741,44773,59890,5564,58001,71968,3177,26689,35343
38554,329,32386,39743,246,37159,43767,83,30673,27813
38553,1120,43801,50211,877,45779,53746,243,42963,36466
38552,72,77143,74860,67,80268,77284,5,0,0
38551,1698,30504,39876,1033,34261,47719,665,14658,27149
38549,1693,42621,52827,1169,54904,64581,524,15375,26248
38548,441,50615,52883,387,51687,59090,54,25000,8396
38547,834,47455,69235,619,68894,81959,215,37875,32600
38545,717,34421,50455,393,51518,58048,324,33200,41208
38544,2700,43673,63497,2124,48636,68542,576,24350,38512
38543,155,36806,55188,135,37361,58041,20,0,35935
38542,8,0,0,8,0,0,0,0,0
38541,802,34271,44561,524,38387,53780,278,18190,26321
38506,11993,48661,67183,7970,60679,82747,4023,24824,33791
38505,0,0,0,0,0,0,0,0,0
38504,280,75164,57473,198,0,56450,82,75820,59944
38501,16715,41555,58573,9524,59040,74710,7191,23509,33717
38488,965,70729,88858,707,87204,110182,258,19688,29557
38487,361,48456,75522,300,50167,81912,61,0,38120
38486,456,41184,44674,290,49583,58946,166,13904,17912
38485,2558,43839,59119,1679,63079,70379,879,21804,34042
38483,2109,42155,58131,1434,53264,67801,675,26629,36355
38482,600,61916,88595,468,70978,99182,132,30833,51058
38481,413,37375,50904,237,61417,69060,176,16014,25611
38478,7130,46250,59849,4498,59469,74979,2632,24435,33251
38477,1136,56125,64761,800,80694,77295,336,31563,34369
38476,378,83971,76845,288,107672,87443,90,44643,42930
38475,252,64861,65385,239,77875,68732,13,0,0
38474,2900,48204,66979,2101,63958,80204,799,19362,25002
38473,372,50000,66337,270,51364,72007,102,36500,47165
38472,1126,54342,72509,754,59829,85857,372,36250,43933
38471,129,0,48348,129,0,48348,0,0,0
38469,1579,47863,57637,1168,58627,66837,411,23291,29344
38468,1995,43698,66778,1507,57799,73704,488,19565,39534
38464,8991,41089,57700,5671,53641,64700,3320,24007,43692
38463,918,42619,57113,569,49417,60648,349,23355,50369
38462,3984,36100,54232,2600,59185,68047,1384,25625,27209
38461,578,47669,59473,415,49003,67693,163,0,38547
38460,658,58913,81772,510,70375,91209,148,57754,48309
38459,128,73269,83634,72,80000,102260,56,55833,56896
38457,258,44318,52558,186,48958,57341,72,24079,28213
38456,1307,59375,69078,1043,70313,77648,264,18043,33914
38455,55,0,68296,33,0,99333,22,23333,21627
38454,406,53750,60227,291,69205,73997,115,0,23003
38453,119,0,66900,89,78606,80992,30,30526,25093
38452,345,43355,84482,247,71607,109201,98,0,22180
38451,1538,58214,71027,1069,62194,79338,469,29632,46599
38450,1213,35972,47766,800,56250,59769,413,17784,22936
38449,1126,47931,70453,775,70156,86985,351,19172,29158
38425,654,42664,68351,479,49886,80105,175,30781,30586
38401,23980,58553,75257,16981,69343,84858,6999,33172,48652
38392,236,53889,60710,189,58083,69322,47,30163,26079
38391,403,35417,45276,287,57969,53876,116,20556,24000
38390,411,44911,54701,278,60417,67437,133,21406,26932
38388,641,58588,70489,525,65568,77073,116,35284,34964
38387,125,44583,54314,73,69792,70411,52,32500,31713
38382,3587,41833,49762,2187,51826,62459,1400,20919,29042
38381,570,37670,48101,374,31000,50268,196,39750,40935
38380,226,38333,46196,135,53092,61679,91,21750,23229
38379,513,39081,53235,358,41852,58690,155,25625,39033
38376,48,0,61940,41,0,63517,7,0,0
38375,3362,35362,49780,2096,55549,58310,1266,20976,34957
38374,875,32351,45561,601,41250,55053,274,22500,23257
38372,6428,42908,58753,4422,50266,68615,2006,20385,32020
38371,381,36927,53806,241,69688,70371,140,20776,24325
38370,354,40703,44954,232,40625,45861,122,40714,38332
38369,617,38068,54103,397,55536,69873,220,19688,25646
38368,837,45313,51071,522,58636,65981,315,26135,25004
38367,1095,45156,62967,843,58967,74090,252,17500,22414
38366,685,60208,77257,546,78564,87932,139,20625,34671
38365,0,0,0,0,0,0,0,0,0
38363,2215,33081,58449,1387,46847,71970,828,16566,34851
38362,413,56926,73753,258,78000,88904,155,48194,48535
38361,394,50822,53200,332,50822,55471,62,48750,41040
38359,117,43281,52233,82,61000,62402,35,0,28197
38358,4378,48910,62997,3002,58868,74551,1376,20688,30710
38357,990,47813,64736,690,59125,72274,300,30556,41136
38356,1118,52460,61919,759,63558,73320,359,28691,33558
38355,2735,81418,82757,2201,90436,91001,534,0,47287
38352,210,69516,63781,165,49896,63282,45,0,0
38351,7042,45199,56349,4491,55150,64438,2551,26595,40459
38348,416,30556,51101,249,65208,63923,167,19485,31983
38347,45,21797,36331,34,0,43744,11,0,0
38345,674,45357,70334,504,65486,86217,170,16719,23248
38344,3039,40152,63867,2131,59698,80755,908,18000,22211
38343,6620,39888,57881,4232,53278,71093,2388,24041,30869
38342,614,32279,45784,350,52206,59035,264,30104,26449
38341,1066,44219,54256,595,56406,66614,471,16906,38376
38340,4169,51832,61566,2990,58929,72058,1179,24459,33838
38339,287,43516,45876,169,58125,59590,118,25250,26006
38337,580,53152,62592,409,64688,74611,171,19899,31009
38334,775,46250,65151,602,58235,74627,173,19688,27724
38333,98,0,33418,40,65227,52713,58,13942,20112
38332,478,53500,49418,403,55091,53502,75,17102,19883
38330,1608,42121,59116,1167,51039,63373,441,29088,46974
38329,1172,48160,63720,912,54565,73586,260,21538,26387
38328,302,38833,64483,163,100893,92235,139,22482,31938
38327,181,28669,37078,92,30833,48379,89,23750,25396
38326,1374,40812,64000,905,51432,83883,469,20560,25254
38321,998,47115,60071,573,61343,76350,425,22270,31456
38320,4289,39394,55016,2677,56311,65855,1612,23241,35628
38318,131,61607,53489,116,67083,55516,15,0,0
38317,1115,32569,46814,575,52165,63719,540,20441,28443
38316,1070,47031,56693,795,52039,63541,275,21776,28585
38315,1547,34522,48004,1096,51147,58261,451,17425,20936
38313,1409,69877,69021,1138,73433,73837,271,41979,46805
38311,439,47270,58725,310,57143,63146,129,0,48053
38310,2293,38713,57772,1556,50700,70570,737,23795,29988
38305,19968,56118,76219,13689,68904,88425,6279,38948,46558
38301,13808,31426,47108,7612,42405,57244,6196,22587,33260
38261,6527,35972,49054,3976,50559,63147,2551,21068,26639
38260,1544,44417,57335,942,63859,73473,602,30172,31068
38259,308,40625,49453,230,45750,56010,78,25441,24562
38258,640,44906,62456,410,63611,78939,230,27308,27273
38257,1874,48688,68750,1259,54702,84249,615,30156,36079
38256,1631,46602,64635,1044,63523,82152,587,22063,33480
38255,1069,41709,48912,697,51898,58546,372,22736,28238
38254,22,28000,29923,18,29000,32478,4,0,0
38253,383,44135,66357,303,60234,77767,80,0,21670
38251,1202,40375,50207,812,52713,60425,390,14009,20849
38242,8222,38806,57953,5283,55551,72620,2939,26315,29986
38241,408,48750,49112,324,54000,50381,84,43214,44219
38240,956,44489,55492,569,45804,62903,387,39712,41640
38237,6112,40406,54637,3618,63182,69522,2494,22274,31979
38236,258,83362,74590,148,63125,58925,110,108382,95126
38235,217,46556,64090,170,0,73869,47,23036,27498
38233,1150,48915,58622,844,51920,63402,306,26111,44588
38232,859,39313,46153,591,44688,53908,268,21750,26325
38231,724,41696,65215,387,51250,94970,337,0,29666
38230,1631,37323,53978,1062,50439,66146,569,15889,28292
38229,1231,51367,56853,852,64310,70149,379,23065,26135
38226,140,0,41702,120,0,45208,20,21667,20660
38225,2237,44283,63745,1475,53788,78921,762,30136,32144
38224,287,44271,64918,231,63162,72129,56,35375,33998
38222,718,41739,48081,563,49440,53872,155,16641,26045
38221,1399,41384,55169,829,60599,74427,570,16944,25783
38220,721,37216,49800,427,51893,67276,294,21458,23712
38201,3901,43293,54419,2717,64973,65876,1184,18443,26127
38152,0,0,0,0,0,0,0,0,0
38141,7755,52448,63993,5186,59330,66629,2569,36095,49092
38139,5635,153383,193826,4767,173950,211652,868,75667,95930
38138,9807,106855,143922,6987,128313,173499,2820,47236,70141
38135,10797,77818,90473,8187,85580,97867,2610,42500,62257
38134,15063,50045,58797,9603,53967,65207,5460,34841,42319
38133,7957,70238,92858,5688,85783,107373,2269,42670,51792
38132,0,0,0,0,0,0,0,0,0
38131,0,0,0,0,0,0,0,0,0
38128,15860,36672,50134,10460,41520,56083,5400,24325,32419
38127,14308,31083,41323,9900,34211,46649,4408,20224,26700
38126,2299,13998,29759,1117,18188,34412,1182,11938,25234
38125,13686,69551,88601,9482,78512,98666,4204,46250,62445
38122,8876,39850,49778,4987,41730,55516,3889,33906,40451
38120,6427,107278,200657,4559,150660,252555,1868,55667,73589
38119,10244,76419,98403,6148,96792,119008,4096,54020,65777
38118,12803,36782,46661,8453,40897,48809,4350,27220,37309
38117,11523,76240,116582,6930,107000,153106,4593,51386,60197
38116,15508,39403,53967,9585,46423,64072,5923,30086,35494
38115,17023,34126,44422,8335,41617,50716,8688,28865,35663
38114,9952,24267,35867,5357,32393,42595,4595,17208,26110
38112,6679,35323,63092,3136,47784,84667,3543,26393,41672
38111,17656,40836,75459,8134,57792,106846,9522,28272,47846
38109,16486,31609,44410,10396,39295,50619,6090,20860,28528
38108,6572,25129,35352,3630,32551,43521,2942,16699,23323
38107,6848,31293,44880,3016,46981,52413,3832,24059,34491
38106,9478,27036,36712,4415,34202,43139,5063,19394,29764
38105,3183,19328,35841,1003,35085,46356,2180,15778,30893
38104,13218,43087,73165,4088,85608,124848,9130,34621,49756
38103,7742,72488,111351,2286,142344,190361,5456,57535,78217
38080,938,36806,63477,737,55074,73082,201,19353,26150
38079,1311,32629,54397,612,45789,79904,699,18631,29267
38077,33,0,0,17,0,0,16,0,0
38076,445,59107,66018,359,64625,73297,86,32000,35353
38075,1405,46188,59093,944,72931,75445,461,19464,24957
38070,73,51156,44827,21,0,0,52,0,0
38069,1018,37935,51012,609,56806,66539,409,21275,27211
38068,3995,47886,63851,2950,60956,73477,1045,22702,32650
38067,658,35778,47111,459,36094,52595,199,23490,27065
38066,1198,80000,112010,848,98947,131642,350,0,63948
38063,6439,42695,55327,4576,44900,60941,1863,21883,34580
38061,365,49135,53938,295,53192,60614,70,0,21454
38060,4199,71467,85444,3202,76285,87846,997,46125,72600
38059,3003,50652,58097,1922,58444,70535,1081,23491,33038
38058,3601,67708,81562,2888,72250,83606,713,48264,64831
38057,1478,58167,70000,957,64107,81226,521,35521,48446
38054,35,0,116191,35,0,116191,0,0,0
38053,9413,57766,78716,6858,67013,90735,2555,34896,44520
38052,1749,44338,52876,1185,50551,62099,564,26600,29045
38050,306,43125,52417,206,50750,60246,100,0,29058
38049,1526,51618,63797,1123,61927,74033,403,26023,34999
38047,47,48487,53009,47,48487,53009,0,0,0
38046,36,54583,76781,22,66250,97545,14,0,44143
38044,281,58750,72266,197,82813,82422,84,0,46836
38042,358,32000,50217,187,63125,73003,171,24896,25298
38041,1049,37094,47345,684,44130,54257,365,19961,33625
38040,2039,41037,52451,1322,47083,59597,717,26304,31030
38039,653,38378,44612,450,38085,46899,203,23949,33993
38037,628,44125,45261,500,52609,49697,128,18846,27359
38036,250,23750,24028,116,29167,25657,134,21111,22390
38034,1258,38864,55961,749,56469,75739,509,11914,23392
38030,154,62361,65388,89,82928,67827,65,0,55340
38029,14,0,0,14,0,0,0,0,0
38028,2765,128984,157780,2256,149167,181629,509,40182,44173
38024,11120,44880,75112,7550,56649,90476,3570,26803,40960
38023,2187,60806,69178,1887,67716,73818,300,31071,31155
38021,22,0,0,5,0,0,17,0,0
38019,6050,47281,64169,4283,62442,77274,1767,21168,29876
38018,13795,73727,91354,9620,88313,102467,4175,48168,60189
38017,19940,117660,147642,15871,125073,158670,4069,67443,102220
38016,18491,63054,79936,11722,78824,90890,6769,45758,59811
38015,851,46074,60823,597,58661,71769,254,31014,32828
38012,5209,38077,54063,3417,48534,65273,1792,22584,28938
38011,3290,64493,80160,2585,75726,88938,705,30694,42629
38008,3750,39229,50635,2207,47374,60628,1543,19211,35347
38007,41,0,27149,27,0,35419,14,0,0
38006,2029,50116,62496,1512,63274,70499,517,25491,37200
38004,3742,87674,104704,3044,95347,113373,698,44600,55476
38002,13288,97829,117624,10671,108691,126802,2617,37530,73359
38001,1741,44004,65517,1163,58292,69420,578,32568,57649
37938,6710,78561,97601,5285,89677,110561,1425,35757,46427
37934,10580,104429,138753,7986,121966,158663,2594,55273,75255
37932,7454,90021,104583,5312,104411,120575,2142,53632,59731
37931,11145,82179,93525,7769,92560,102683,3376,49917,68680
37924,5002,49419,60726,3266,70664,74312,1736,27308,34268
37923,12877,65842,81013,7572,79479,98215,5305,42633,53328
37922,13920,108654,153796,11139,120331,167895,2781,60274,92786
37921,10907,49984,61760,7143,55495,65724,3764,36653,52074
37920,17183,48890,64826,9488,66198,83200,7695,29200,39812
37919,13444,62865,114689,7328,115142,168678,6116,32517,47959
37918,18065,57397,73223,11590,71443,87154,6475,34342,46485
37917,11867,41151,52551,5104,50984,64236,6763,30964,42905
37916,2992,22432,30289,286,34750,42205,2706,22114,27532
37915,2737,16447,25897,902,19406,30225,1835,14004,22748
37914,8791,41156,56879,4994,48504,67636,3797,31682,41457
37912,9959,36406,46864,5046,45204,57339,4913,29971,35162
37909,7344,49496,69398,3617,63769,81821,3727,41264,54903
37902,1590,48106,71376,358,136944,167641,1232,32065,43381
37892,824,33015,47515,601,37331,54894,223,16675,23910
37891,1492,38446,55142,989,42540,70489,503,23601,24965
37890,2934,58387,69187,2144,74700,78955,790,33056,41174
37888,1193,43072,53375,894,48725,64287,299,14754,20049
37887,1983,44718,55621,1367,53519,65432,616,25130,30036
37886,1578,54286,65478,1189,60647,70584,389,34183,40057
37885,2565,53656,73436,1861,62250,82418,704,34023,41373
37882,1303,51836,67066,938,71280,79242,365,29225,35722
37881,830,35600,56805,573,40938,69047,257,20977,26585
37880,1543,45739,59475,1026,52143,67005,517,17550,44093
37879,4790,36519,47316,3023,53569,57916,1767,18767,25090
37878,144,46875,55976,96,56250,69656,48,32083,28617
37877,3404,65769,74343,2440,75955,87992,964,33013,36849
37876,12585,51659,64924,8807,61881,74213,3778,30620,40641
37874,6448,39312,53662,4394,46667,61859,2054,19985,30585
37873,1843,34864,45648,1151,45313,57910,692,20368,24504
37872,645,40083,52307,481,50417,58351,164,0,32310
37871,3419,56472,67142,2394,65857,76160,1025,30739,41136
37870,1941,34290,49673,1260,45455,60010,681,22806,30498
37869,1933,27969,52595,1146,47714,64059,787,19339,28937
37866,637,61462,74614,510,62331,74678,127,0,74357
37865,9148,64951,80753,6867,74800,93908,2281,30371,38246
37863,2476,48477,56453,1764,53465,60549,712,26042,37934
37862,9069,46136,70340,6142,54196,83671,2927,34188,40285
37861,3524,45726,53756,2583,52721,61950,941,18527,26367
37860,1412,47095,64495,974,64896,76721,438,19792,37306
37857,8000,42103,53244,5568,52463,61311,2432,22140,30964
37854,4746,45046,67876,3396,61406,82930,1350,20467,27666
37853,1465,44766,63178,856,56204,75985,609,25668,42938
37852,1046,51042,47533,791,53112,53351,255,18583,23211
37851,11,0,0,4,0,0,7,0,0
37849,10552,68058,81345,7485,80329,95032,3067,31814,45868
37848,45,0,76633,26,0,118419,19,0,0
37847,1092,50787,52453,884,49286,53812,208,21429,33652
37846,1562,56630,65337,1152,73036,75916,410,0,34198
37845,165,30703,30400,115,30703,28203,50,0,0
37843,1758,55246,64054,1060,59489,67342,698,33088,54914
37841,4016,36950,52805,2667,45729,65342,1349,20279,27033
37840,3957,49036,62746,2723,69620,74983,1234,23281,31688
37830,12287,55740,76570,7849,67243,89863,4438,35750,50370
37829,636,47000,56791,408,63333,64047,228,40658,39836
37828,694,62321,96969,450,120000,131265,244,29286,33717
37826,1888,52642,62016,1473,59888,66197,415,27875,43359
37825,3607,41811,60527,2363,54688,72738,1244,20227,34931
37821,8548,36354,49309,5770,43609,55722,2778,21760,34326
37820,2866,48488,57246,2116,52467,65418,750,24567,29393
37819,248,50078,50473,157,61042,58891,91,36058,32046
37818,2103,37844,46367,1455,38750,52284,648,23417,27374
37814,13155,45898,61472,8143,59840,77889,5012,23407,33805
37813,6775,35838,49591,4744,40794,57932,2031,24219,29080
37811,1635,40754,53122,1131,43668,59334,504,32059,35407
37810,664,43167,58665,503,50563,64213,161,21442,35602
37809,916,65678,71254,763,66507,71693,153,0,60107
37807,4110,47917,60564,3184,55682,65578,926,26111,33887
37806,1221,50605,57849,803,61510,67036,418,29659,36540
37804,9504,66988,73202,7199,76518,81052,2305,35463,45545
37803,12997,65060,87938,8845,79357,104189,4152,36755,51488
37801,10785,53773,71403,6997,69686,87155,3788,32298,41146
37779,1424,38182,62059,1061,44358,72989,363,19583,27669
37777,5027,62618,87308,3595,68988,98800,1432,35812,53201
37774,8050,67875,82518,5560,77500,97584,2490,36932,45545
37772,5201,71186,108456,3843,81022,123512,1358,43190,60521
37771,6519,51142,64077,4427,62095,74873,2092,23838,35472
37770,1302,39103,59383,835,43250,76646,467,0,28368
37769,2364,42308,62354,1517,56563,64729,847,30951,51335
37766,7389,38903,56524,4789,47348,67256,2600,23569,32514
37765,198,40357,55630,170,45455,60806,28,0,24207
37764,3823,59865,70348,2826,65654,77628,997,41940,45050
37763,6476,63670,87100,4258,78253,103597,2218,33781,52653
37762,1246,25972,41982,724,42000,48607,522,14551,32793
37760,4632,49028,67175,3353,60250,77363,1279,24170,37861
37757,4127,49253,63180,2728,62098,75983,1399,25369,35211
37756,1186,29366,42756,765,36950,53869,421,15225,19778
37755,1039,37936,40228,644,38214,45025,395,23792,30338
37754,1498,48176,60181,1103,66446,70884,395,24811,26341
37753,291,35321,50686,233,37036,59273,58,10417,10697
37752,2674,43021,60600,1673,54245,77890,1001,27136,31615
37748,7189,44601,67891,4733,61262,81231,2456,22391,38416
37745,7516,42166,59660,4477,55974,71607,3039,23400,39870
37743,9566,42968,66526,6549,51568,76380,3017,24516,42077
37742,2430,66310,77726,1724,81146,87290,706,36209,49632
37738,2275,43902,57847,1377,54005,69400,898,24216,38025
37737,2484,70281,82206,1846,75781,88329,638,43500,62679
37733,19,0,0,19,0,0,0,0,0
37732,33,0,0,33,0,0,0,0,0
37731,123,39904,51330,84,0,64826,39,17708,22262
37730,6,0,0,6,0,0,0,0,0
37729,663,52083,58062,546,54531,63520,117,16587,25495
37727,939,45283,51210,674,47024,51642,265,25750,47165
37726,707,40792,51073,536,49148,59371,171,18045,20801
37725,6485,54249,73832,4845,60879,82896,1640,33953,44165
37724,1111,30295,41495,628,37500,57357,483,15306,20871
37723,511,37477,51295,332,50861,55186,179,23625,43983
37722,2645,41250,52970,1834,46189,59501,811,25764,34753
37721,5416,54332,66614,4223,60725,73647,1193,32917,39011
37719,81,0,75869,33,0,0,48,0,0
37716,10946,52935,68425,8249,62924,77909,2697,24772,34363
37715,379,25361,38951,316,27000,43156,63,20121,17862
37714,1735,44196,60269,1307,49158,67864,428,19259,27466
37713,543,24464,32649,362,22857,34496,181,25938,28035
37711,2072,43433,54307,1509,49656,57106,563,17636,44047
37710,448,24231,39070,302,0,38106,146,0,38992
37709,1413,58924,83095,1074,68155,97126,339,26853,35851
37708,2623,41306,59060,1647,52782,72770,976,25833,33017
37705,1629,49040,82819,1157,76484,100224,472,27464,38939
37701,3118,48479,65840,1964,64286,79474,1154,30338,38389
37694,927,53882,92470,690,62857,91541,237,0,92380
37692,2069,44337,56351,1252,55182,68562,817,18417,34586
37691,212,0,47488,139,0,51103,73,0,15966
37690,1852,62574,73637,1451,72401,78727,401,24073,42845
37688,525,35529,42565,317,41701,53969,208,16111,24310
37687,1760,34794,64119,1213,53423,70485,547,21992,49536
37686,3113,69521,94164,2417,85144,103664,696,33871,54091
37683,5017,37342,59457,3482,42697,70472,1535,22725,28859
37682,90,38281,47474,23,0,0,67,0,0
37681,2639,48709,62584,1938,57833,69807,701,27568,40159
37680,232,38984,59505,187,40528,67894,45,0,24647
37665,2222,37826,45590,1456,42946,54028,766,23571,27035
37664,12286,50264,71585,7905,62712,84239,4381,33438,47393
37663,5847,63997,79284,3975,74516,95859,1872,31520,41950
37660,17424,40450,62823,10170,53960,77806,7254,27377,39450
37659,11480,58504,75457,8364,68740,87303,3116,31524,41081
37658,1644,46814,56931,1103,67542,74462,541,15576,19429
37657,354,56250,56023,264,60486,56870,90,29211,43509
37656,1407,51908,79807,1053,62740,81387,354,22384,35342
37650,5460,45603,52903,3332,58279,65235,2128,25380,32618
37645,2120,57280,76088,1571,69925,75593,549,20439,76438
37643,14186,40929,54074,9501,53107,64339,4685,24253,30088
37642,6186,51508,64984,4335,66618,77011,1851,28357,34228
37641,3995,46462,55243,2608,58506,67958,1387,21964,30346
37640,1569,38701,49257,987,51146,58138,582,19295,33990
37620,16324,42786,58499,9935,56770,70685,6389,27577,38024
37618,5334,49435,62140,3828,55296,70112,1506,29917,38900
37617,5532,61505,81573,4025,73281,95335,1507,35643,43002
37616,2157,41875,49691,1496,60957,59577,661,16102,26931
37615,9250,60833,81962,6045,79025,101412,3205,36683,43867
37614,0,0,0,0,0,0,0,0,0
37604,16725,38310,65313,8495,65013,92094,8230,24434,35940
37601,15850,39626,58149,8933,52736,74114,6917,25820,36020
37421,21509,64859,90432,12676,88760,113710,8833,40714,55409
37419,2678,58621,97343,1818,68889,108870,860,41108,71613
37416,6225,49279,64297,3935,63542,78387,2290,29643,37507
37415,11413,50246,76282,5651,74596,106648,5762,32515,44780
37412,9236,48304,58569,4802,59797,69358,4434,34239,45128
37411,7296,42729,56966,3823,59128,78110,3473,25081,33423
37410,1472,22737,40307,708,25393,49296,764,14926,21281
37409,1526,59130,65957,769,65030,71861,757,51378,59695
37408,947,63869,104925,358,128000,169316,589,31583,65594
37407,3605,25716,33633,2199,26075,35297,1406,20484,27468
37406,6281,31295,38352,2971,38936,47748,3310,25711,27591
37405,8483,62560,101007,4018,96645,148457,4465,45057,57730
37404,5016,35435,62084,2580,49438,80345,2436,23388,41626
37403,1799,53393,88920,370,80357,139286,1429,41528,75729
37402,2258,18319,40497,544,18306,35892,1714,18324,41959
37398,5699,53448,82465,3918,66802,97696,1781,31213,46294
37397,3916,53565,61268,2837,62786,67412,1079,22250,34684
37396,64,107949,79013,47,0,0,17,0,0
37394,55,40313,48480,44,41458,56936,11,0,14645
37391,653,43750,56801,467,56576,66024,186,35106,31444
37388,10573,47707,66987,6848,64309,82539,3725,28502,35765
37387,1191,49914,65544,879,75233,80351,312,15600,22816
37385,3353,51680,57456,2788,56038,61012,565,29395,35383
37381,3860,45496,63391,2539,56616,73156,1321,24883,41685
37380,2557,42013,56001,1647,50024,66444,910,24268,33722
37379,11248,62748,81765,7962,78125,97715,3286,30944,41880
37377,5785,102853,129469,4225,123495,154678,1560,41607,59632
37376,266,0,24153,96,34511,51976,170,25000,8441
37375,1046,57431,100818,583,96250,128912,463,37031,63851
37374,727,55950,65343,619,48463,62780,108,80821,64117
37373,1142,46500,74430,852,46800,77202,290,38393,63787
37370,1930,52930,67956,1208,59524,85021,722,29167,38707
37369,242,52500,64190,197,59688,67072,45,0,40207
37367,3817,51395,66198,2881,64221,73067,936,20033,42169
37366,447,38958,67598,332,70000,83726,115,16399,21038
37365,388,37000,46384,278,40750,46205,110,22500,42772
37363,15894,75799,97164,11795,92643,111320,4099,46819,55537
37362,1358,36447,46185,908,49231,56964,450,18433,19418
37361,878,50909,66971,616,72614,77981,262,40952,41085
37360,711,77083,100139,599,78547,99099,112,33026,101759
37359,399,46622,53219,309,47847,56134,90,18500,40036
37357,1967,43558,69710,1419,60144,82568,548,30417,34201
37356,1006,45143,59927,759,47183,66618,247,31458,35350
37355,10510,54518,65282,7088,59399,72866,3422,37257,46958
37354,6621,44362,59878,4245,59993,70229,2376,20621,40452
37353,1891,51075,72148,1547,55337,77792,344,23413,45495
37352,1384,64464,73981,972,68771,87052,412,19672,30760
37351,134,45865,48357,115,46322,54433,19,0,0
37350,754,137368,241946,581,164583,267306,173,65417,155517
37348,323,55720,56974,254,57121,66511,69,0,21870
37347,3254,47018,60927,2190,56897,68304,1064,21346,44723
37345,989,41393,63980,728,55385,77488,261,18598,24709
37343,16755,67603,96550,11293,84372,117655,5462,35300,47137
37342,1506,55144,65803,1145,56214,72688,361,36023,35328
37341,4889,75029,83999,3615,82455,92234,1274,35227,57555
37340,182,53221,96943,106,62750,155731,76,12436,14950
37339,681,43125,51723,514,46154,58204,167,16313,18478
37338,1129,37153,53910,696,43375,60266,433,31722,42585
37337,543,35070,49053,320,59231,73982,223,9422,13281
37336,1836,55791,60771,1440,60094,67759,396,20987,30434
37335,952,65536,77428,747,72784,87626,205,31141,35138
37334,9386,52589,69371,6230,64860,82459,3156,28682,39449
37333,237,28304,47497,159,35114,46981,78,25147,42583
37332,934,70769,76276,732,93542,87407,202,29013,35790
37331,2784,41131,68249,1912,54375,75339,872,22649,50294
37330,2980,48359,57286,2087,57940,63884,893,24371,36444
37329,2464,46071,67670,1741,70491,75223,723,24516,29795
37328,611,38894,56101,402,48897,61019,209,35201,41066
37327,4340,44743,57963,3203,55811,64658,1137,25163,35398
37326,258,0,35706,112,68500,62460,146,8661,13004
37325,778,44865,59971,457,47250,67999,321,42550,48386
37324,2493,33792,51823,1413,52702,67970,1080,23422,26093
37323,12026,57028,70687,8567,66726,77423,3459,32088,48994
37322,3357,50828,58072,2293,57373,67790,1064,23913,35043
37321,7174,45160,59327,5127,54702,68534,2047,24124,33521
37318,725,31150,44346,417,45859,55527,308,25708,28838
37317,1414,39556,67634,1005,53549,78447,409,27292,40598
37315,0,0,0,0,0,0,0,0,0
37313,628,33267,42837,472,47500,51851,156,9897,14813
37312,13648,56462,77547,9348,74530,90179,4300,36088,45226
37311,11030,38129,52395,6698,47704,60247,4332,25113,36520
37310,1458,65904,70686,1128,72281,77922,330,37143,44395
37309,785,53872,61630,597,58990,66612,188,37065,45809
37308,1062,59694,80510,776,70455,92553,286,50774,47158
37307,1934,58857,87960,1497,65404,101370,437,20938,40740
37306,795,51295,67960,551,47656,64263,244,42813,66049
37305,517,63050,54675,449,63281,57548,68,15833,35525
37303,10127,42685,59678,6318,54052,70639,3809,28018,38895
37302,1862,70637,103279,1587,76236,108869,275,0,70226
37301,381,32891,60320,233,38523,65341,148,19444,49630
37246,0,0,0,0,0,0,0,0,0
37243,0,0,0,0,0,0,0,0,0
37240,0,0,0,0,0,0,0,0,0
37228,1077,52344,115000,71,0,201023,1006,38846,108929
37221,18140,85933,103715,10744,101213,126641,7396,55474,66875
37220,2368,117917,203090,1807,134375,231419,561,76350,109233
37219,777,85463,87750,137,0,139972,640,85125,76571
37218,5816,46434,63613,3831,50873,72838,1985,35095,43916
37217,12724,50423,65837,6846,53651,66777,5878,46706,60868
37216,8244,62214,87031,3897,86834,99570,4347,46573,74710
37215,10541,122715,190503,6522,171493,244065,4019,61483,103149
37214,13890,61206,75054,7077,74135,88520,6813,47910,59650
37213,21,0,0,0,0,0,21,0,0
37212,7149,71699,135689,3106,147594,195793,4043,44846,89159
37211,29353,59075,75023,16289,66893,86207,13064,46038,56913
37210,7337,36985,56999,3116,48791,67381,4221,27591,46961
37209,16513,61096,82024,7684,78679,98193,8829,48758,66976
37208,8415,47903,74491,3655,54669,91810,4760,41857,60363
37207,15151,50583,60380,9113,53671,64034,6038,40773,51019
37206,11584,66065,88614,5814,81107,104177,5770,53164,70878
37205,10999,107876,173784,5998,157289,246772,5001,63057,85434
37204,6080,89954,148770,2958,132708,188485,3122,64549,110283
37203,10201,58032,84415,1925,66527,119698,8276,54482,75626
37201,620,92827,120146,99,170819,195110,521,80329,105902
37191,1548,80376,89641,1311,78295,93895,237,31086,56271
37190,3295,53505,68781,2251,68325,79484,1044,28955,42775
37189,1717,74963,93205,1272,79563,97172,445,60750,79796
37188,5807,79948,91578,4754,84637,100063,1053,42796,45582
37187,2821,56191,70180,1983,69871,79492,838,35543,41014
37186,3615,48880,69143,2763,52708,77302,852,27391,36277
37185,3425,43528,55844,1950,51864,69320,1475,32903,37454
37184,2592,56225,72558,2070,62963,82197,522,21885,27581
37183,1386,56154,89267,993,66382,83863,393,33625,99640
37181,706,62059,73662,387,61583,77466,319,0,68698
37180,1483,63837,82806,1350,64444,87025,133,30673,33615
37179,5131,104498,119184,4357,113050,128304,774,37373,61483
37178,763,42188,51141,448,50882,65539,315,16886,28506
37175,359,32159,72749,160,39423,49781,199,27098,90298
37174,13513,81823,93434,10658,93222,102934,2855,50431,54433
37172,11294,57334,74742,8449,65992,83423,2845,35948,43024
37171,273,125462,109726,231,126182,119507,42,0,0
37167,21579,69482,80715,15271,80757,92001,6308,42707,48138
37166,5457,44195,60105,3860,51934,71633,1597,24929,30139
37165,19,21406,31321,6,31250,36283,13,20893,29031
37160,11919,50642,69053,8407,58505,75560,3512,35154,48716
37153,2180,88000,100668,1966,90392,103237,214,61750,66912
37151,267,0,73112,186,84107,97903,81,20489,16184
37150,1851,29071,46435,1135,57974,64092,716,15212,17819
37149,1013,59578,73869,726,70875,86404,287,0,41187
37148,8726,59050,67190,6555,66926,75764,2171,26172,35477
37146,2618,83786,97034,2231,87530,103141,387,34826,46875
37145,879,52679,134786,668,66364,166847,211,20417,33287
37144,1158,55875,67835,847,72788,80268,311,28616,32286
37143,1459,71094,90780,1050,80761,100516,409,52961,60368
37142,607,68750,65538,486,76635,73704,121,19275,24198
37141,570,60484,79508,483,61895,85084,87,33958,40891
37140,41,0,115063,20,0,0,21,0,18376
37138,9369,73710,84734,6516,86040,95990,2853,44069,54461
37137,1134,36816,52663,679,50216,61005,455,26542,39501
37135,5356,128281,141620,4598,139286,150707,758,68082,82699
37134,1031,61875,66706,770,65455,71698,261,36563,46973
37132,0,0,0,0,0,0,0,0,0
37130,21987,49229,75749,12414,60058,95013,9573,35601,48214
37129,21225,73818,89713,15738,85111,100750,5487,41318,52590
37128,21834,76988,90974,15823,92165,103041,6011,47148,54905
37127,6948,71059,85471,5185,82225,96349,1763,40877,51055
37122,22013,92944,118299,17254,106974,124295,4759,51398,93485
37118,413,63839,83767,345,85865,92636,68,0,0
37115,17024,46777,59429,8870,57212,70217,8154,36270,43499
37110,12787,43106,57663,8075,54177,73048,4712,24194,29139
37101,2325,53453,70483,1669,56829,76659,656,35795,51168
37098,2010,52570,119242,1425,54315,148718,585,46319,44694
37097,803,43750,59794,557,49750,72968,246,25128,28878
37096,2109,52829,76151,1513,56778,93957,596,17337,28581
37095,1080,43359,54238,759,51858,64258,321,0,27670
37091,8598,48679,65977,5995,60744,72688,2603,31535,46005
37090,5636,66536,79864,4004,78829,93607,1632,29209,34690
37087,17808,66141,89169,12856,82089,101527,4952,35089,51096
37086,11552,64130,77384,8990,70556,80374,2562,40522,60024
37085,2064,80484,85262,1414,91757,103399,650,45469,44769
37083,5809,37188,59183,3844,58690,67832,1965,29210,40810
37082,2237,77909,83007,1600,87232,95773,637,28250,46865
37080,3143,63201,81085,2068,69474,90092,1075,50991,60802
37079,1119,44419,67302,754,54891,75950,365,42772,40942
37078,146,55278,62709,112,60208,76003,34,0,18921
37076,16682,64392,77550,9868,76003,89264,6814,47329,57202
37075,24850,77320,104158,18078,93825,120322,6772,49009,55190
37074,2923,55855,63952,1823,56983,73118,1100,40672,45402
37073,5276,69875,86922,3969,82542,100199,1307,34504,43104
37072,12869,62655,79188,8205,80254,95208,4664,41850,46642
37069,6983,129569,198443,5541,156426,225681,1442,59022,90083
37067,12492,107464,130626,8642,118382,148097,3850,67009,87587
37066,20704,64908,88567,14687,77520,102854,6017,33292,48405
37064,21795,105342,134928,16861,122202,153914,4934,43996,67005
37062,4597,69290,92048,3545,76412,97218,1052,57662,68327
37061,1694,46047,60369,1052,57339,78591,642,21378,28301
37060,987,67247,90940,794,83036,101760,193,44688,45081
37059,511,38065,57039,345,0,69328,166,21875,28343
37058,2926,47289,60038,1933,61678,68727,993,34238,41676
37057,279,27899,34629,194,30441,42857,85,12168,13840
37055,10289,53062,68833,6730,62392,79016,3559,31795,44643
37052,943,65995,76131,696,85921,82653,247,43203,49044
37051,1312,52008,55403,867,63417,65764,445,25647,34300
37050,648,57838,57277,484,75329,67247,164,25370,27747
37049,1438,74000,84305,1110,83272,91304,328,38529,58365
37048,2268,76196,89495,1688,93250,103378,580,42500,45856
37047,854,60417,64054,602,70541,69806,252,35571,49422
37046,1901,116875,148108,1591,133574,165650,310,44167,43359
37043,18483,76555,94779,13021,91657,111268,5462,36357,52735
37042,29781,55184,63558,21202,61106,68228,8579,38014,45537
37040,19374,54348,69562,13293,65172,78702,6081,35151,44078
37037,2618,89756,109848,2315,95936,116767,303,35529,42088
37036,2134,47500,61442,1564,63233,71766,570,17750,30561
37035,1505,63412,72298,1030,81722,83514,475,38783,46712
37034,2732,66627,72767,2070,71274,80714,662,37000,44927
37033,3029,45149,57195,1965,54896,68152,1064,26140,35634
37032,1721,74760,92847,1401,84464,103054,320,39659,46218
37031,1665,75393,84358,1256,80422,94603,409,29699,51368
37030,3087,44531,55510,2076,50769,63962,1011,24238,34930
37029,2518,84848,117564,2040,86825,111255,478,43889,138816
37028,261,80489,75698,107,97443,100159,154,55652,58703
37027,20608,133254,189233,15670,162549,218101,4938,62997,93486
37026,869,51354,63035,589,65625,79059,280,14551,24306
37025,2075,51595,60853,1499,64186,68830,576,26875,34565
37023,518,59293,63621,320,75975,85489,198,20946,25105
37022,2332,61875,61865,1851,63813,63001,481,59250,50386
37020,2222,59094,72023,1512,69943,83903,710,37453,40638
37019,233,39453,56460,170,56667,62087,63,28994,33122
37018,911,50694,65193,641,68555,78497,270,20859,33606
37016,416,59714,83922,321,67153,104578,95,25000,11934
37015,6821,59144,68454,4743,64059,75516,2078,34010,45618
37014,1268,123137,172160,887,150325,220342,381,44071,59987
37013,36217,60602,72977,23302,66420,79523,12915,47725,55285
37012,843,49883,62589,602,63750,70694,241,25398,42005
37010,1736,93794,108652,1375,106657,123843,361,0,45789
36925,1293,36275,41880,740,45560,53434,553,19632,25501
36922,220,40741,57081,159,65804,65892,61,37063,34116
36921,504,28100,46695,180,70227,82488,324,22823,26810
36919,716,30648,49685,477,44083,58638,239,25625,31592
36916,452,33333,53925,315,60893,62208,137,20640,34346
36915,220,32813,47378,164,34167,55768,56,0,22811
36913,21,0,0,21,0,0,0,0,0
36912,752,43232,52573,486,53750,64203,266,25233,28193
36910,21,0,0,21,0,0,0,0,0
36908,732,48929,62401,535,58750,62486,197,35386,62169
36907,788,29231,38090,471,46964,50984,317,12147,18868
36904,1614,36708,52658,1012,64848,67194,602,25313,28219
36901,174,31296,33275,124,37969,39683,50,0,0
36879,916,120110,114232,717,131106,128415,199,31058,56991
36877,4432,57857,83552,3440,69058,94075,992,32719,43272
36875,1499,55070,58776,1069,63566,67990,430,35500,34451
36874,3317,56489,70654,2623,64657,78377,694,23194,39046
36871,455,35625,61310,328,47143,76934,127,16278,20958
36870,7051,63797,81030,5153,74586,84307,1898,31534,69854
36869,8545,40574,51853,5348,53342,64229,3197,16113,29163
36867,9608,41627,61517,5531,54478,69314,4077,26395,50108
36866,1554,44554,54574,1047,51239,62961,507,29647,35322
36865,22,55750,59468,20,56000,60930,2,0,0
36863,4822,36680,53702,3314,48348,60903,1508,19892,32605
36862,2374,32500,49298,1516,50488,62659,858,16614,25683
36861,1201,55072,71790,798,64167,83517,403,24338,47781
36860,795,40190,51570,510,52000,57393,285,21125,39379
36859,4,0,0,0,0,0,4,0,0
36858,178,31458,53154,87,0,67946,91,31750,39012
36856,2659,59542,77212,2276,66926,81984,383,46756,48854
36855,704,50768,60197,454,50347,53135,250,50934,69537
36854,5865,52469,65711,3940,63004,75018,1925,29632,41235
36853,3454,55107,71466,2319,65261,84543,1135,20359,42598
36852,972,42927,68901,646,45556,83687,326,35863,37360
36850,1156,37500,44762,808,45104,47929,348,21042,35969
36849,0,0,0,0,0,0,0,0,0
36832,10274,30068,54769,4712,60469,89464,5562,16194,24770
36830,15986,56595,87247,8745,98272,127243,7241,25299,38173
36804,7343,52629,65440,5066,61083,74666,2277,37229,42691
36801,9973,51697,65584,6112,72200,83248,3861,23918,36449
36793,105,0,57228,65,84236,79785,40,0,0
36792,465,0,59029,267,80684,81859,198,0,28244
36790,169,0,83011,157,0,74929,12,0,0
36786,1041,20281,30488,374,22172,45817,667,12757,19366
36785,504,44118,50750,289,68819,66956,215,16094,26501
36784,2627,39028,62377,1384,59551,78151,1243,29134,42476
36783,295,30913,47770,176,0,67422,119,9909,18704
36782,901,38173,50932,542,67150,66878,359,18125,25816
36776,630,14552,38518,359,0,60202,271,8033,8650
36775,600,47500,44086,250,40208,54342,350,52785,36760
36773,142,25385,37025,54,28182,42481,88,16875,33677
36769,928,32727,44399,579,44023,58481,349,13438,20900
36768,345,32634,46004,238,33846,50885,107,29018,35148
36767,487,25085,36934,278,35250,53527,209,9346,13689
36766,14,0,68600,8,0,0,6,25000,0
36765,597,24135,40282,441,0,47711,156,15000,19281
36763,41,77596,65890,24,78077,74542,17,0,53676
36761,356,24609,53858,218,25000,38815,138,23611,77622
36759,607,32321,43891,385,42841,47362,222,14464,32726
36758,460,51759,55341,345,65077,64620,115,30929,26234
36756,1699,24834,35647,856,37980,48378,843,23213,22720
36754,198,0,262615,99,0,513617,99,25000,11613
36753,26,0,0,0,0,0,26,0,0
36752,526,46176,58720,338,72500,75735,188,23125,28040
36751,176,40613,33640,81,42969,39523,95,0,28623
36750,916,54013,68046,672,68947,77067,244,20536,35342
36749,370,22800,31330,235,42644,39586,135,12321,16958
36748,875,40742,55408,493,55568,74992,382,24063,29178
36744,2347,28946,44305,1359,42679,59509,988,20155,23392
36742,1093,31338,52216,544,59290,80043,549,20483,23512
36740,517,35391,56557,260,0,79181,257,25710,33230
36738,278,27041,37906,128,45000,58160,150,0,20622
36736,413,0,71389,322,103304,88271,91,0,11649
36732,3217,33136,55851,1460,63147,82975,1757,21762,31279
36728,97,19740,26216,53,29620,37770,44,0,12300
36727,98,26280,29051,86,0,0,12,0,0
36726,1802,36483,53958,1196,52273,65493,606,20522,30733
36723,138,15227,23051,88,17386,23506,50,25000,0
36722,141,47917,45252,80,68125,55391,61,0,31956
36720,310,19762,29264,181,30402,38527,129,12734,16040
36703,4927,28003,42361,2825,40019,58748,2102,12909,19929
36701,8221,35204,49738,4955,52234,60932,3266,23548,30887
36695,19345,70786,85333,14219,81074,97300,5126,38822,48640
36693,7763,64370,84717,5300,80804,97356,2463,35345,55868
36688,0,0,0,0,0,0,0,0,0
36619,5670,50533,73585,3861,68178,87456,1809,28064,38845
36618,6579,46716,57664,4431,55403,66798,2148,25718,37402
36617,5039,35450,46142,2907,45689,54476,2132,21940,33801
36616,8,0,0,0,0,0,8,0,0
36615,0,0,0,0,0,0,0,0,0
36613,4218,40631,58190,3239,42118,64841,979,20052,29234
36612,1620,22500,36930,1029,21723,43148,591,14779,19736
36611,2139,32332,43217,1253,37957,50332,886,24583,31229
36610,3978,25126,35663,2227,34673,42599,1751,16916,25770
36609,11255,38894,60587,5133,56737,82830,6122,27105,41474
36608,15009,51544,75861,7821,69882,105003,7188,31890,43227
36607,2727,40074,65406,1483,51547,88998,1244,18509,32864
36606,7839,43058,61642,4281,50459,68313,3558,32294,51330
36605,10090,36815,49910,6468,43211,54825,3622,25458,37760
36604,3999,50079,77007,2074,71081,99136,1925,31390,52284
36603,2934,25516,39659,1459,40777,51459,1475,16875,24792
36602,641,23063,47616,46,81429,105909,595,19306,43109
36590,0,0,0,0,0,0,0,0,0
36587,3594,51709,63333,3067,59273,68072,527,23092,28196
36585,359,46080,57747,314,55439,61083,45,18750,23333
36584,299,0,47699,161,85547,76948,138,11168,13576
36583,268,41731,50761,175,41328,54758,93,41632,40582
36582,8949,55794,69891,6768,60853,76344,2181,34776,45163
36581,138,42250,63540,51,0,0,87,0,33643
36580,2089,47664,60409,1277,58856,78744,812,26673,29766
36579,557,53239,64490,331,79375,79501,226,25000,41103
36578,663,109735,100179,577,135097,108959,86,29706,41271
36576,1791,44313,66494,1160,66053,79899,631,33025,40235
36575,7763,57777,68109,5799,70522,78619,1964,25018,34460
36574,430,0,74499,315,74904,88328,115,0,31897
36572,2173,79955,91096,1753,87128,103486,420,25739,35575
36571,5937,58446,83013,4109,83014,102506,1828,25765,36604
36569,212,47262,78025,189,54205,84751,23,18750,22748
36568,74,0,103950,32,0,0,42,0,0
36567,5055,52773,66208,3417,57450,75784,1638,33529,42021
36564,75,0,0,48,0,0,27,0,0
36562,439,43836,50330,318,46188,57307,121,31188,29840
36561,3219,85503,117349,1984,113550,148515,1235,62527,66091
36560,1183,38164,51842,798,52684,64374,385,22305,24480
36559,92,0,211455,76,0,251080,16,0,0
36558,1540,45357,68978,1104,75568,88038,436,13664,20713
36556,196,0,82958,196,0,82958,0,0,0
36555,337,81375,103365,253,90625,126809,84,21964,32754
36553,859,47461,107812,690,79500,126444,169,15401,15679
36551,3276,60746,78232,2561,67207,86685,715,37734,44689
36550,116,0,75698,74,122143,111258,42,25000,13045
36549,2235,51285,80397,1581,64021,96949,654,32115,36113
36548,397,102542,92191,244,108462,118428,153,0,50348
36545,3480,37137,53872,2230,52000,69678,1250,14690,25249
36544,3885,46585,59370,2914,54669,67059,971,16896,31718
36543,11,0,0,11,0,0,0,0,0
36542,7276,52214,69674,4199,73714,85528,3077,36538,48028
36541,5262,63566,70769,4225,66490,72884,1037,51047,53609
36540,328,23140,39733,142,0,59692,186,0,23863
36539,234,35909,50236,162,50769,57637,72,0,33583
36538,178,29500,28729,122,29786,32598,56,0,20300
36535,13926,53606,66980,8873,67132,81553,5053,25565,40730
36532,13497,77260,111443,9999,93783,134855,3498,26540,43279
36530,2732,48993,65982,1513,65740,84417,1219,33513,41678
36529,79,25000,38946,41,0,55171,38,25000,0
36528,679,65481,98024,490,77308,105702,189,48787,77522
36527,5577,96688,115428,3912,115931,133370,1665,47346,72179
36526,12975,72997,87711,8708,89512,102931,4267,47748,54466
36525,577,50179,66103,424,61667,76029,153,28450,35996
36524,532,45152,50357,346,50938,65082,186,16125,22796
36523,1046,51250,64892,833,45268,68643,213,30865,36599
36522,2386,43482,52037,1666,51144,60003,720,25520,32242
36521,2436,56964,73562,2001,61380,80479,435,26875,34210
36518,956,41512,56519,672,44894,65049,284,0,35107
36513,64,0,43378,45,0,0,19,0,0
36512,6,0,0,6,0,0,0,0,0
36511,157,0,40345,14,0,0,143,0,33562
36509,565,43634,48084,459,43177,49426,106,42632,36954
36507,7414,44206,64737,4822,66935,80613,2592,23104,32773
36505,390,73056,66171,302,82647,77871,88,0,21448
36502,6073,30853,42474,3346,43400,54440,2727,20203,27115
36483,183,49219,62763,138,0,69859,45,48073,41000
36482,345,35438,116024,178,70610,200924,167,0,22592
36481,98,15652,22107,41,0,28510,57,15380,17502
36480,683,40417,51743,450,58333,65897,233,0,23034
36477,1587,36707,53285,1036,49036,69682,551,15651,21655
36476,3,0,0,0,0,0,3,0,0
36475,731,36420,58871,452,54643,80774,279,15568,23386
36474,1197,45750,77148,786,58676,71877,411,24556,86243
36473,40,62976,54003,40,62976,54003,0,0,0
36471,431,21607,33597,211,36750,56737,220,8269,11405
36470,35,0,0,0,0,0,35,0,0
36467,4106,35855,50191,2605,50045,62183,1501,20536,27734
36460,3571,30083,55586,2017,53310,76690,1554,19339,27446
36456,598,41250,56621,403,67574,67137,195,16493,33404
36455,95,31625,55902,45,51458,87022,50,0,24724
36454,4,0,0,4,0,0,0,0,0
36453,914,39940,56590,651,54618,66462,263,20481,27208
36451,1906,49815,66028,1463,55804,76841,443,23309,29213
36446,184,19600,31368,113,0,37394,71,12276,21011
36445,2181,33218,50312,1457,54258,62425,724,11959,25177
36444,268,45294,44976,190,55357,48129,78,0,33418
36442,1336,37027,53780,816,59559,63237,520,18026,32855
36441,1424,35088,46475,1027,39115,54784,397,23990,24981
36439,163,56875,71969,135,64688,81327,28,26786,26489
36436,118,38333,46475,97,39196,51585,21,0,0
36435,148,54583,60797,82,85400,81694,66,33750,33592
36432,578,38941,51008,389,39301,55367,189,21964,34817
36426,5527,41668,55367,3487,52141,68269,2040,25000,30692
36425,332,32500,51347,224,48500,64802,108,11375,19062
36421,4027,47153,62786,2913,55423,73715,1114,23938,32548
36420,4091,46315,64717,2452,66308,83736,1639,25344,34423
36401,2989,33026,45874,1927,42049,55879,1062,21450,24878
36376,839,40451,54733,532,64625,72293,307,23080,23200
36375,2674,42928,53734,1904,52813,60633,770,28558,35501
36374,283,63813,86798,206,78750,88923,77,51328,44569
36373,200,21364,26496,108,0,32552,92,0,19387
36371,343,36985,62251,218,67500,76729,125,21875,32391
36370,346,50000,65337,245,59904,65649,101,19609,62832
36362,1427,61769,60713,1111,57227,58043,316,71058,70066
36360,7789,44880,59004,4887,54329,72609,2902,23750,34284
36353,591,38950,57829,372,51000,73197,219,26518,27483
36352,1766,68889,75192,1446,73556,82169,320,30625,40074
36351,1337,56067,76379,870,75833,93859,467,26350,42220
36350,2691,39033,62627,1701,58036,80718,990,22262,29908
36346,576,44318,66693,418,50750,78111,158,23125,32902
36345,3128,61677,76119,2269,85250,89916,859,31997,38844
36344,2180,42801,54895,1406,54750,69328,774,16594,25431
36343,503,47569,54209,304,60000,66557,199,35125,32314
36340,2333,39478,48880,1587,40961,54933,746,0,36003
36330,14439,62545,73886,9770,72267,83421,4669,40757,51946
36323,2990,41292,56345,1998,54206,68228,992,22924,29148
36322,3922,38794,52657,2327,52836,61773,1595,28338,37033
36321,691,49659,53964,502,53125,62097,189,19493,28857
36320,1291,37420,56299,856,44571,68083,435,25346,30743
36319,848,54196,61908,604,67628,73086,244,22679,31850
36318,494,52143,61660,343,57159,69406,151,45694,44038
36317,313,49583,88838,226,0,109667,87,0,33176
36316,816,65000,77803,613,80938,89519,203,0,42426
36314,237,50516,47904,211,50859,50342,26,23684,23023
36313,114,59569,69281,28,0,0,86,58966,56224
36312,2331,46383,68738,1605,57831,85490,726,25333,29441
36311,966,38235,53665,733,41331,61109,233,19479,27742
36310,2542,41818,51593,1674,49076,58805,868,17485,35055
36305,6209,72571,97125,4483,86875,113125,1726,41964,51754
36303,11620,46961,69748,7356,63860,85570,4264,26215,39901
36301,14687,42045,60659,9312,56776,73443,5375,25714,36638
36280,1621,62468,71038,1214,74337,81880,407,30536,37733
36279,1039,57886,92237,844,65972,109083,195,13068,15588
36278,1794,35741,53975,1334,39024,57695,460,25541,33838
36277,1981,57274,64758,1492,59560,71025,489,32750,42898
36276,917,36202,51911,584,53088,63552,333,23259,29512
36274,4220,40124,55327,2850,51323,67763,1370,17727,26641
36273,1303,51205,63434,873,75950,81055,430,18936,27414
36272,5210,42804,60586,3590,51872,71583,1620,25173,33063
36271,2280,43801,66421,1760,48864,70636,520,26742,45791
36269,654,55640,63588,395,67618,80236,259,29014,30357
36268,2280,54737,59398,1613,63977,69722,667,20804,31562
36267,12,0,0,12,0,0,0,0,0
36266,2208,46875,59779,1606,52179,68979,602,16382,28706
36265,8209,47152,58307,4590,57167,74586,3619,26390,35588
36264,3179,46221,57996,2119,57229,73258,1060,18182,26119
36263,163,0,42952,81,0,63468,82,0,22685
36262,498,43750,72276,328,48636,89737,170,23696,36807
36260,1539,59228,59088,1143,60348,61159,396,0,41461
36258,592,43125,62482,374,83537,84574,218,19841,24140
36256,601,49620,57140,391,55750,68330,210,28750,35753
36255,410,45714,94500,312,79286,117184,98,18088,18742
36251,1847,40734,66447,1268,52368,79942,579,22250,36481
36250,1698,77721,80920,1419,85959,88872,279,26210,36505
36207,8118,59832,84347,5712,77982,100003,2406,36371,43379
36206,4055,48842,63291,2794,58176,74641,1261,24244,35589
36205,339,0,71122,210,85324,81935,129,13942,53519
36203,6733,61182,83480,4463,70838,91906,2270,40238,60977
36201,7313,32315,46237,4006,37919,54324,3307,21159,34588
36117,21914,66349,89806,13628,87119,110397,8286,43149,53443
36116,17838,51124,63834,10679,56808,75164,7159,42662,45888
36115,266,72708,105620,231,73438,102530,35,72188,126011
36113,287,93594,91253,253,100625,93782,34,65556,71862
36112,0,0,0,0,0,0,0,0,0
36111,4779,54613,85189,2912,64811,106389,1867,34040,50413
36110,4062,38981,57063,2642,41279,52727,1420,25000,56178
36109,10144,53884,66743,6025,72124,81688,4119,34762,42771
36108,6609,23431,37259,3629,33159,47252,2980,15978,24296
36107,3271,28825,44125,1551,36314,51979,1720,21891,36194
36106,6031,61753,83058,3428,74340,98734,2603,38505,59987
36105,4113,32588,44012,2360,39399,54722,1753,18772,27834
36104,3451,31717,52935,1454,32304,66145,1997,28542,42604
36093,3735,106233,112937,3061,115232,121853,674,57763,68980
36092,8068,59034,71481,6152,68372,79013,1916,33689,43892
36091,1375,45313,74751,962,55714,91242,413,31168,30649
36089,2610,31596,48053,1617,52588,58966,993,14032,27733
36088,1287,31801,58407,681,51910,71378,606,23281,39149
36083,3468,35324,53219,1897,53464,71856,1571,23852,30046
36082,0,0,0,0,0,0,0,0,0
36081,6025,31046,54477,2630,63282,88324,3395,16549,27904
36080,737,78365,91799,590,80658,84212,147,0,122252
36079,3462,51250,72526,2093,61263,83659,1369,31399,53996
36078,5213,54802,72455,3536,63266,90668,1677,26467,32780
36075,924,39659,65108,657,42344,78235,267,29267,29741
36071,229,31518,38766,107,0,49122,122,31250,29682
36069,785,48125,62220,501,56544,79623,284,24400,31520
36067,10025,52343,68021,7152,65569,77239,2873,26626,40976
36066,8522,66243,87930,5837,84696,102895,2685,49451,54538
36064,3635,104327,129477,3119,111766,139914,516,40488,65302
36054,5735,56593,68728,4087,67944,79590,1648,28151,38837
36053,729,31518,44367,398,55083,63694,331,16229,21128
36052,290,123342,114520,248,123861,129614,42,0,25395
36051,907,56691,79733,679,77917,91351,228,35375,37590
36049,1960,44307,58705,1480,51227,66300,480,17500,32688
36048,629,30592,38547,348,36900,49047,281,20565,25032
36047,466,46429,59754,336,49375,72069,130,16210,22292
36046,485,40885,58765,300,60303,78045,185,0,26768
36043,1353,70425,79997,1069,77589,84584,284,26277,48722
36042,577,56433,86543,466,63718,89900,111,13277,72452
36041,539,42531,98190,367,53542,119912,172,19762,50026
36040,1562,27056,38384,956,32984,45592,606,22647,26053
36039,54,49375,58696,40,73500,67378,14,38750,33893
36038,10,0,0,10,0,0,0,0,0
36037,4338,44609,63276,2913,55304,74435,1425,24628,38384
36036,764,44569,72724,542,57381,87140,222,23083,35574
36035,632,51429,67981,406,73929,86760,226,24750,33180
36034,324,41912,58704,251,57031,66567,73,29408,31145
36033,1336,48482,63263,954,69418,76118,382,25054,29844
36032,1000,35938,45600,682,43333,48211,318,20625,29081
36031,54,65417,51872,43,65260,51437,11,0,0
36030,173,48345,61854,127,49899,74508,46,27647,26920
36029,285,55744,77601,246,56905,85307,39,0,0
36028,621,38821,50203,314,67000,69609,307,15156,29941
36027,5804,34969,52692,3905,45870,59397,1899,18596,34141
36026,475,60472,119546,256,89688,120748,219,60083,118142
36025,1314,41193,61529,866,62734,78221,448,21250,28110
36024,1874,51196,75643,1135,73221,91837,739,35625,50209
36022,4590,67733,77098,3543,73869,85327,1047,45799,47883
36020,352,40441,53413,251,42417,60724,101,16250,31968
36017,779,24850,42558,505,32670,53237,274,16944,22828
36016,1630,38750,56921,1003,56875,73150,627,16717,27974
36013,228,101167,105244,201,102292,113636,27,0,0
36010,1594,39643,57644,1086,60000,73168,508,19390,23084
36009,893,46250,66912,614,72917,85283,279,16462,26203
36006,691,19792,55742,506,0,65970,185,17354,27029
36005,530,39063,66019,363,51648,80055,167,22768,35513
36003,935,22292,43947,438,46875,73545,497,13366,17327
35990,41,18598,20380,35,0,0,6,0,0
35989,1391,42652,62435,1143,44246,62933,248,17361,53683
35988,872,41287,60968,655,50089,70422,217,23125,30576
35987,938,60306,61325,723,67218,65073,215,24297,47110
35986,3099,46558,55688,2399,61516,64687,700,16352,23879
35984,833,37420,72712,528,61875,92294,305,26250,38711
35983,1536,60324,67466,1070,71071,76184,466,33017,45444
35981,667,43250,60980,489,47117,73328,178,21364,24662
35980,1952,49549,61074,1427,52024,70634,525,30905,31809
35979,450,48261,49736,366,62748,55295,84,25943,25517
35978,1806,43917,58770,1453,51458,64679,353,18946,24618
35976,6810,57885,81023,4719,73178,98607,2091,29688,39805
35975,381,24101,29482,227,32393,42255,154,8750,10023
35974,651,46339,78580,464,56330,89598,187,15893,48210
35973,1224,41694,56082,999,49417,62104,225,18618,28547
35972,499,0,49649,297,56298,64010,202,14160,18790
35971,2299,37123,64316,1717,45910,69245,582,26333,47410
35968,1506,57765,62689,1223,65341,71139,283,15558,24800
35967,6194,41973,52668,4137,49644,62507,2057,24552,31188
35966,1485,49479,55687,1223,55809,61761,262,19808,26598
35963,518,33451,49752,270,53250,68916,248,13551,26273
35962,3150,48700,57641,2308,52095,63920,842,26381,39822
35961,2387,39244,55301,1795,42049,61297,592,20966,33955
35960,4074,42604,62587,2436,62167,73493,1638,26123,45769
35959,1872,36038,54541,1281,52740,68302,591,18635,24523
35958,1212,38165,52228,840,59318,60674,372,20446,29801
35957,5649,41773,55467,3655,56268,68132,1994,22611,29406
35956,3091,52324,64958,2290,62150,72483,801,30379,41751
35954,4568,43715,58792,3099,57306,66620,1469,28313,40871
35953,2536,53679,58653,1881,57230,66049,655,28036,35369
35952,3161,40055,50449,2176,44668,57520,985,24154,32318
35951,4241,45073,62107,3102,50804,68623,1139,24618,40218
35950,7143,48535,60607,5038,55921,68394,2105,28086,38970
35907,3004,70383,88749,2303,77168,96004,701,32250,53396
35906,3746,49222,72099,2483,71594,86449,1263,38090,42114
35905,2283,55265,70771,1658,76731,87800,625,20583,24282
35904,5338,38173,51319,3323,51858,63600,2015,22277,29712
35903,6926,41103,54603,4024,57319,68309,2902,25924,34036
35901,7426,39732,58889,4530,55552,71446,2896,23061,38344
35896,0,0,0,0,0,0,0,0,0
35824,4173,86599,104946,2315,149955,136883,1858,43500,64653
35816,6701,25424,36528,2890,31285,42748,3811,20426,30460
35811,10698,65938,93990,7007,81266,93823,3691,46808,92904
35810,11487,38450,51088,7446,46588,59984,4041,22582,32246
35808,371,94896,105870,257,94896,114957,114,92500,85385
35806,11621,62355,82016,5766,98093,110902,5855,42436,52344
35805,8954,26598,37771,4317,27052,40099,4637,24571,33423
35803,11424,79214,99045,7504,100061,118269,3920,51801,59680
35802,10707,62231,95912,5749,97851,127379,4958,42312,58263
35801,10085,80276,117955,5506,109901,158780,4579,50143,67629
35776,1382,43661,56947,960,58591,67922,422,20066,29017
35775,277,37758,40592,147,39821,50596,130,26225,29281
35774,63,51250,54419,50,0,58584,13,0,0
35773,5115,54119,77643,3570,58824,81657,1545,44040,65066
35772,1844,36607,50844,1326,53393,62782,518,14509,19856
35771,1245,55662,66098,989,58376,71649,256,41000,44441
35769,3992,44969,66041,2583,58194,80761,1409,34509,37799
35768,4602,42059,57816,3055,57110,68640,1547,24122,35537
35766,69,0,40939,62,0,37123,7,0,0
35765,1576,58365,65482,1176,67976,76669,400,20000,32589
35764,275,26657,67481,167,55694,91534,108,11713,29660
35763,6565,120629,130285,5665,125856,138651,900,52841,69513
35761,5023,62888,82206,3646,79765,92199,1377,34044,54394
35760,1619,66042,77872,1248,77125,86056,371,24375,48082
35759,3434,83779,98165,2489,101750,117145,945,29708,48128
35758,19804,86495,110556,12872,117931,133306,6932,53694,66746
35757,6261,92152,114845,5000,99265,126300,1261,51898,68919
35756,4677,102135,118074,3700,118169,131214,977,57313,64439
35755,203,41875,69830,145,50417,83521,58,33500,35602
35754,2287,68673,77678,1487,91238,98377,800,37500,39202
35752,981,41359,45531,688,49043,54855,293,0,22787
35751,82,48500,106278,45,0,179820,37,0,16832
35750,5183,54321,72673,3850,63906,76363,1333,38125,55637
35749,8303,99767,110978,6164,106786,124807,2139,52351,65451
35748,2523,79185,104391,2005,104135,117848,518,38750,49710
35747,2259,57276,80566,1664,61813,89272,595,38352,55063
35746,299,34948,45354,230,27204,41583,69,0,57925
35745,74,31250,61432,34,79643,116103,40,14000,14963
35744,669,38672,42782,555,43188,44563,114,22500,29560
35741,1817,81654,134056,1329,167992,161966,488,36500,58049
35740,1553,37866,54777,974,52650,68709,579,17111,26309
35739,1916,49306,68967,1158,77177,91034,758,31754,34954
35677,777,36908,85919,576,47667,106618,201,0,26603
35674,7006,47738,58317,4960,60603,68777,2046,19848,30902
35673,2816,55213,66998,2181,65183,73436,635,31250,38712
35672,1961,51118,61103,1459,57250,69858,502,22130,31207
35671,1125,51903,56084,459,48228,60909,666,75274,52759
35670,2410,52763,64706,1699,66823,78890,711,18341,28508
35661,6932,60714,72364,4744,68018,79763,2188,31622,53405
35660,4118,36774,49863,1963,53189,68490,2155,23568,32524
35654,3018,37063,51590,2038,43538,59556,980,23512,32911
35653,3370,45297,54923,2355,51199,59915,1015,39016,39174
35652,3653,60733,71130,2660,72095,84699,993,24759,33234
35651,537,52348,78493,348,63021,100155,189,19810,37371
35650,5137,51683,64788,3506,67670,72628,1631,24583,46919
35649,23,146250,222239,20,0,236225,3,0,0
35648,1164,59135,62512,897,68179,73488,267,23242,25305
35647,335,63967,74568,267,66528,77228,68,0,31996
35646,1859,45677,55281,1241,56282,60947,618,20046,42697
35645,5259,73103,87777,4017,92938,102692,1242,30901,37942
35643,1450,45395,59475,948,64091,76862,502,22056,25854
35640,9787,56773,69985,7402,67696,80501,2385,27628,34997
35634,3819,73967,83987,2725,79232,94023,1094,34889,56999
35633,8236,58832,69990,5841,72698,84302,2395,26748,33413
35630,15057,34898,51572,7255,45598,69755,7802,24130,33789
35622,2506,48409,57870,1714,51481,62397,792,31416,36970
35621,1186,55000,81961,822,78258,107301,364,16596,20271
35620,3536,68667,76237,2614,75217,84938,922,46714,49576
35619,1703,51508,66901,1364,60833,76027,339,28558,28491
35618,813,29608,39030,491,36898,47705,322,21667,25620
35616,1459,34526,49740,954,48929,61061,505,22170,27949
35615,33,0,0,33,0,0,0,0,0
35614,2487,47961,59646,1701,60635,66773,786,33941,42255
35613,7884,81618,94340,6389,87325,102479,1495,46779,56085
35611,10290,45195,62556,6180,57581,76183,4110,22002,40432
35610,732,45000,68252,495,67991,84453,237,37785,34108
35603,13476,60078,84657,8707,79978,102017,4769,30231,51500
35601,12167,43485,58419,7150,54786,69021,5017,32085,40094
35594,2469,47860,57875,1730,64734,70521,739,16625,26939
35593,518,54500,62994,420,61000,67895,98,36100,37761
35592,1949,38299,48185,1159,50984,62518,790,13929,27112
35587,304,35682,41110,160,38478,52582,144,21705,27631
35586,1541,33520,45152,906,54583,59239,635,19044,24931
35585,414,42950,63222,280,0,81142,134,0,25778
35584,97,19844,29835,60,28125,39177,37,12639,14686
35582,2002,34602,52207,1205,51313,66086,797,21069,29939
35581,2012,41500,56563,1509,49381,62519,503,24202,31982
35580,1462,45167,60737,874,67206,73795,588,25242,38343
35579,1315,46792,60555,902,53690,65119,413,29196,46307
35578,2256,38237,59191,1651,50943,70667,605,19019,23962
35577,18,46111,47661,18,46111,47661,0,0,0
35576,1227,59028,68040,937,73047,81320,290,18295,24689
35575,468,41429,51005,344,50250,59536,124,14457,26617
35574,609,45250,57227,437,63958,70259,172,20000,24119
35572,783,55781,54521,522,58995,69981,261,23229,22882
35571,265,47202,66873,174,68333,80376,91,19327,40868
35570,4549,43041,52055,2838,56557,67293,1711,16891,25631
35565,4891,38917,53864,3140,47840,58710,1751,21239,44328
35564,948,28667,50831,667,29046,59088,281,16313,28296
35563,1634,40507,53612,1055,57969,66567,579,19219,29732
35559,17,0,0,17,0,0,0,0,0
35555,4131,41599,57894,2951,53806,67234,1180,19250,32969
35554,461,37348,47108,299,44191,55814,162,30833,29654
35553,1655,31813,48283,1084,43148,55139,571,18393,27798
35552,381,45685,45402,317,46076,47812,64,0,33458
35550,2195,43267,52956,1527,51651,60856,668,25203,32585
35549,1567,38907,48384,1087,43403,59897,480,15519,19943
35548,855,42283,43004,540,47061,50346,315,24813,30321
35546,1431,58389,63742,1072,68250,72887,359,19740,35777
35545,40,25000,30503,29,32969,33262,11,19375,23227
35544,311,47484,71830,168,62833,97476,143,46282,41701
35543,499,27188,41236,327,35893,49239,172,15236,19724
35542,337,37969,51128,189,54550,62142,148,20500,37063
35541,1593,49283,64114,1001,68313,78295,592,22143,39504
35540,961,43558,64137,731,45587,58626,230,21429,81377
35504,4904,60714,75581,3671,76519,87107,1233,23209,40205
35503,3925,49497,63781,2721,67594,74476,1204,21162,37890
35501,3591,41276,54400,2333,50885,61892,1258,19380,35463
35490,1350,58158,68841,1029,71179,75998,321,34625,43803
35481,1451,40352,50665,970,46991,59564,481,23542,31107
35480,427,58393,75101,279,97969,92223,148,52891,42826
35477,54,0,50848,31,0,68294,23,0,0
35476,2675,46728,51542,1611,54306,61904,1064,23810,35852
35475,6129,87883,93615,5125,91804,102938,1004,43017,43712
35474,2251,56250,81330,1625,73582,96878,626,25757,38622
35473,6483,64232,72591,4357,80484,83732,2126,37336,47384
35470,1952,23467,39686,928,57451,63328,1024,16507,17236
35469,43,0,31349,5,0,0,38,0,0
35466,2036,46466,73636,1360,73432,82970,676,25385,53462
35464,283,11775,26057,222,10761,28405,61,17813,17082
35463,727,56652,71356,562,67250,78730,165,50104,43708
35462,1742,27565,37355,795,45114,54296,947,23099,22735
35461,906,43750,65772,613,65208,70321,293,23750,56109
35460,360,24221,38379,201,48750,53624,159,22520,18718
35459,392,30313,46942,260,42375,55023,132,23145,29770
35458,135,0,84741,100,75673,103811,35,26146,30254
35457,28,0,0,0,0,0,28,0,0
35456,1472,50244,61288,957,51555,64611,515,44734,52454
35453,3937,64021,70802,3004,69769,77869,933,42559,41737
35452,1198,55694,82646,968,70349,94894,230,25357,28662
35447,1314,33750,51120,821,45236,57328,493,17389,39177
35446,579,42969,57109,439,44531,60281,140,41324,44240
35444,1447,48194,60666,1101,57917,68107,346,29453,33486
35443,754,18206,25995,425,0,37378,329,9119,11268
35442,1978,35000,49714,1434,45714,57358,544,14781,29212
35441,355,43750,58523,251,62014,73283,104,13681,13370
35406,6964,106653,139683,4844,134292,168607,2120,55726,72299
35405,17462,56446,67860,11135,68175,80596,6327,35594,42323
35404,7449,40776,59897,4148,46779,67837,3301,30008,48767
35401,12191,25358,38626,5209,40568,54305,6982,16202,25467
35254,134,0,41256,52,0,63971,82,0,26851
35244,11845,95647,119756,8751,116574,136635,3094,49413,69303
35243,7798,89891,129987,4198,121196,168801,3600,72040,83505
35242,22832,98055,137054,16064,128711,168182,6768,45417,61730
35235,8295,54564,62324,5606,60791,65358,2689,45813,49126
35234,2254,20256,33519,932,42828,52417,1322,10362,19648
35233,1431,42284,52234,190,0,84882,1241,0,47236
35229,0,0,0,0,0,0,0,0,0
35228,3937,39330,51316,2346,53206,67598,1591,18451,26374
35226,13214,108368,130400,9830,123951,149516,3384,55455,72909
35224,2079,47450,59473,1374,58971,70502,705,25868,36425
35223,4140,137400,231202,3146,172653,267507,994,86842,110863
35222,4081,62670,98995,2109,98281,137962,1972,49052,56709
35221,1764,32017,52159,998,45189,46332,766,27710,57198
35218,2868,29545,43550,1637,33433,43540,1231,19710,40992
35217,5124,36092,47891,2861,43694,59505,2263,19966,28856
35216,14781,66540,105782,9473,94344,132128,5308,41322,56829
35215,17816,41940,56661,11531,49077,67368,6285,30003,35292
35214,7259,54800,63301,4704,66628,73089,2555,35818,40461
35213,5756,128059,194700,3758,168214,256665,1998,80000,75184
35212,4430,28990,48221,2303,44316,58695,2127,18468,35923
35211,11493,31785,43860,5700,39668,54648,5793,21663,31536
35210,6025,60318,72691,3276,72378,87204,2749,44554,55161
35209,12445,64307,104012,6115,102949,136531,6330,40710,71928
35208,5585,31480,43154,3204,41591,51720,2381,21777,29717
35207,3506,26070,35674,1810,35375,45077,1696,17429,23635
35206,6757,33256,50922,3934,38553,53506,2823,22903,45837
35205,9978,42071,67980,2992,65907,114041,6986,31432,47615
35204,4615,26618,36318,2330,43359,47173,2285,19049,23723
35203,1595,25030,59130,282,0,79793,1313,22102,54576
35188,715,55568,63539,465,69153,79533,250,23000,33482
35187,2,0,0,2,0,0,0,0,0
35186,1988,73010,96408,1386,86549,113529,602,31400,56673
35184,1635,42642,58054,1144,58148,60452,491,23956,48189
35183,239,58317,67920,156,63333,84276,83,28264,37178
35180,5003,61037,74446,3705,74813,89875,1298,19958,29467
35179,3101,51921,63924,2292,61695,73488,809,29129,35726
35178,1277,33530,51120,810,52692,62478,467,19106,28207
35176,311,21425,45937,155,0,67234,156,0,24398
35175,2012,62667,76918,1487,66208,86324,525,44938,48042
35173,9574,101644,125576,7817,107645,136003,1757,62546,69543
35172,1155,37361,64159,785,56313,76304,370,24000,38313
35171,1399,65611,66026,1119,66824,71996,280,24688,38177
35160,10312,32986,47575,6267,47944,59154,4045,20608,28326
35151,2823,61507,76123,2321,67298,84168,502,24292,36233
35150,7104,34718,50810,4484,49126,59227,2620,19730,31389
35149,125,40964,44912,33,0,0,92,0,0
35148,972,53214,65738,618,62986,83793,354,33409,33952
35147,1970,76875,97306,1471,84583,110949,499,35568,51317
35146,3695,83002,83789,3015,84437,90354,680,39125,52122
35143,1201,76380,78022,891,87512,87676,310,28500,49426
35139,92,11429,14663,10,0,0,82,10833,14299
35136,785,36612,59499,494,50761,76162,291,30269,31211
35135,752,47083,64497,544,57361,74892,208,36136,36800
35133,1229,49764,63610,790,62010,82202,439,23767,25626
35131,1278,39375,61032,924,66094,74800,354,25395,24825
35130,1500,46786,50693,835,61743,62397,665,23911,35092
35128,4336,67101,79826,3182,81157,89973,1154,42773,48477
35127,3668,64087,81563,2734,67153,86020,934,55833,65518
35126,7533,67992,77837,5884,76397,87552,1649,31961,40464
35125,4412,52340,62898,2868,59605,74827,1544,31107,36916
35124,9645,78647,100239,6448,95599,122395,3197,48033,53452
35121,6365,45943,64680,4556,53728,71445,1809,22691,46535
35120,5583,64679,69416,4168,75446,78954,1415,29468,38639
35119,30,0,0,30,0,0,0,0,0
35118,1088,61900,69316,773,71369,78746,315,26375,34500
35117,1979,73750,88857,1492,98571,102758,487,47125,42473
35116,1896,73111,84505,1424,79141,90798,472,44091,63226
35115,6198,41585,52401,3696,55122,63658,2502,26054,34622
35114,2859,83458,97736,2113,105078,110498,746,45990,58632
35112,93,145739,122438,93,145739,119247,0,0,0
35111,6440,70897,84324,4517,85427,97475,1923,48721,52392
35098,415,64712,62069,238,66500,74312,177,0,45055
35097,695,41563,56678,530,46964,63782,165,21736,32830
35096,3113,59619,69883,2325,64240,77094,788,37980,44200
35094,5587,59772,77409,4122,68447,86265,1465,40286,49485
35091,1109,93042,90494,931,95338,94947,178,71389,63730
35089,691,52810,54610,442,52661,57908,249,53058,47979
35087,1069,31270,45343,659,52625,58183,410,25197,24466
35085,3216,53438,66340,2501,58624,74449,715,27930,34957
35083,1254,42188,58606,804,54107,69764,450,26250,32421
35082,0,0,0,0,0,0,0,0,0
35080,6416,93176,109226,4994,98739,115755,1422,50833,81779
35079,3124,69038,79738,2548,74211,80813,576,31204,56762
35078,787,62321,82954,548,69815,84300,239,60442,79064
35077,5624,41282,54566,3779,52340,66447,1845,22680,29552
35074,43,0,0,0,0,0,43,0,0
35073,1063,54464,64184,773,59175,70648,290,36731,43844
35072,1808,39118,48871,1276,48071,55895,532,16851,29916
35071,5996,73854,85480,4283,81303,96976,1713,37056,52652
35070,106,41429,55334,89,42292,59211,17,26875,25682
35068,3645,69543,80631,2169,86306,98582,1476,55682,50618
35064,4425,41540,48832,2732,42359,56349,1693,28297,30269
35063,1258,57829,59118,842,64195,69600,416,22727,36777
35062,3267,51657,71558,2560,58442,81529,707,31719,35445
35061,479,52989,76806,393,0,87446,86,0,28183
35060,84,33468,35846,39,0,0,45,33185,0
35058,3610,44514,66780,2526,58714,77693,1084,26340,30212
35057,5053,54335,66951,3687,69063,79475,1366,22900,31202
35055,8367,51479,63252,5463,64332,78142,2904,24893,32433
35054,1744,59688,102616,1275,79583,126649,469,0,37282
35053,854,72000,105537,679,83839,95269,175,22132,140210
35052,20,0,0,0,0,0,20,0,0
35051,3208,55021,78258,2047,75409,84963,1161,25573,62616
35049,1581,39750,48786,1028,52813,67128,553,25000,14498
35046,1953,56223,64433,1441,65547,72522,512,35665,41148
35045,5759,44842,72532,3553,63450,75548,2206,26725,65050
35044,3188,41098,58814,1844,49554,70783,1344,32073,41185
35043,4103,93731,99004,3446,105098,108839,657,45694,47420
35042,2185,55572,71539,1554,66658,86437,631,20605,33433
35040,6379,68620,78671,4627,79583,89647,1752,40461,48473
35036,121,0,42740,71,70353,49980,50,19643,32458
35035,457,53818,69762,371,54406,80588,86,26176,23055
35034,1702,33571,44310,1431,38799,45555,271,0,35397
35033,1145,39978,58802,822,58083,68913,323,26307,32162
35032,19,0,45247,4,31250,33200,15,0,48460
35031,2630,42121,70783,1783,54665,89943,847,26661,28514
35023,8410,55979,68533,6306,63786,77526,2104,32473,38358
35022,8492,63434,78013,5689,85779,93489,2803,40373,45628
35020,10438,28129,38398,5442,40944,49632,4996,20352,24235
35019,829,43563,53166,491,42375,62341,338,43816,38788
35016,6319,49046,70046,4465,61888,82501,1854,25714,36660
35014,1582,48284,62142,1178,60758,71247,404,16990,28466
35013,23,0,0,0,0,0,23,0,0
35010,8055,44690,59078,5433,60914,70315,2622,23369,34627
35007,9566,75372,87571,6974,84829,96718,2592,46111,59354
35006,1133,52788,70043,855,60521,71647,278,43750,65018
35005,3170,49702,60486,2257,57994,68310,913,25247,36173
35004,4677,64987,76108,3198,71159,85747,1479,41103,50749
34997,17886,61661,85218,11859,75221,99345,6027,38880,55052
34996,5783,69248,128840,3060,102550,174801,2723,41427,75536
34994,7445,52527,70895,3813,64589,85986,3632,32407,52067
34990,11834,99219,137393,8406,115340,152834,3428,54493,98465
34987,4311,71547,85346,3522,81505,91226,789,63859,56566
34986,11932,66782,82964,8414,73739,94887,3518,37517,51431
34984,5822,69143,80280,4521,72190,85631,1301,37140,47418
34983,14674,57495,77490,10749,62067,85216,3925,42449,49893
34982,10262,42971,58090,6247,51315,68391,4015,25747,40166
34981,1621,54692,67423,1095,72147,74576,526,36773,40906
34974,10109,46610,65568,6517,52286,69194,3592,24909,53562
34972,5994,43851,58220,4188,52014,65456,1806,24507,39719
34957,10713,55982,84978,5669,82328,112010,5044,35114,53676
34956,2393,43527,56035,1768,43065,58659,625,43206,40614
34953,23064,63483,82039,19076,64423,84743,3988,50378,56584
34952,17668,47419,63044,10617,58441,73430,7051,31572,43858
34951,7051,47965,59614,4103,57331,73572,2948,26813,39232
34950,5977,33839,40115,3566,44740,45835,2411,20802,28587
34949,4333,69954,94075,2620,101175,118213,1713,40348,56729
34947,4057,31398,45616,2676,36223,51146,1381,24188,31123
34946,2565,36383,47781,1289,47904,67937,1276,0,27170
34945,1466,53611,84005,1082,62283,97820,384,29868,38609
34797,602,88989,92748,526,89255,95768,76,0,50901
34788,8422,44703,61641,5294,51873,71353,3128,31412,41121
34787,24677,94038,111696,18950,107031,122855,5727,42119,66418
34786,14966,103163,166800,11901,117375,189446,3065,51976,72606
34785,15192,60267,83674,10323,77292,97152,4869,36207,54447
34773,1161,59205,68136,926,65427,71129,235,0,41781
34772,9105,73358,81026,7247,79326,83852,1858,44984,52487
34771,6618,77963,100259,5299,81104,108048,1319,20871,46848
34769,8603,47805,61741,5553,55793,68380,3050,33758,47462
34762,187,73021,75019,156,85484,86336,31,0,0
34761,14030,72069,87443,11055,78407,90884,2975,43068,62158
34760,255,80536,161575,169,105139,165968,86,20000,146181
34759,12142,49691,66020,9169,54193,69325,2973,35776,50027
34758,11315,55733,65626,9733,57123,67018,1582,37919,37991
34756,1167,86607,97905,951,92026,103723,216,44464,68106
34753,1675,55933,56785,1389,55929,58422,286,0,42242
34748,17561,44876,56655,11408,53955,65690,6153,28974,38413
34747,9160,70744,97198,5559,81462,117463,3601,52445,62937
34746,14223,58635,77970,10526,63421,88108,3697,30132,40359
34744,17975,53598,67057,14207,56451,70734,3768,25382,42904
34743,12257,53902,63235,9789,54947,65244,2468,31453,41610
34741,16278,39182,51218,9901,40661,54337,6377,30858,42710
34739,263,82361,73519,152,103550,94493,111,0,40875
34737,1200,75833,95110,878,78696,102797,322,53750,72443
34736,7531,62186,79212,5253,69985,85367,2278,44531,60962
34734,1304,79773,118105,1132,92536,125139,172,38654,66770
34731,6983,54005,71172,4743,59967,80788,2240,26829,44285
34715,6747,71117,83387,5640,72163,86185,1107,47743,62331
34714,7638,55406,67067,5438,63750,70605,2200,42154,46862
34711,21279,75015,88205,15739,85003,97781,5540,44201,55773
34705,1000,54135,63511,741,62832,70640,259,25417,34914
34698,18732,51432,68903,9836,69428,84664,8896,32876,49344
34695,7229,83020,115885,4941,102456,138269,2288,38605,63657
34691,8946,40537,51692,5033,49077,60907,3913,27088,38020
34690,5168,36809,50828,2788,43633,59232,2380,27257,38821
34689,11823,51753,88685,6697,68765,89787,5126,29895,86136
34688,3197,84017,142242,2171,116510,172251,1026,44375,73349
34685,7282,77020,113377,5224,93913,132499,2058,46910,62964
34684,13173,56682,76217,7407,73438,90735,5766,38138,56070
34683,13380,70375,92555,9040,86220,111095,4340,40313,51462
34681,298,48472,117870,203,0,149482,95,0,0
34679,22,0,0,10,0,0,12,0,0
34677,8566,69861,100486,5641,87649,122496,2925,42263,56072
34669,5439,47226,55447,3703,56400,63174,1736,21944,34252
34668,20119,37262,47830,11570,47587,56094,8549,25986,32748
34667,15736,43363,56397,8402,53862,71406,7334,27242,36877
34661,110,0,31585,56,0,50530,54,25000,0
34655,17882,71199,90561,12376,84332,102026,5506,41043,62676
34654,8980,51036,70194,6111,60028,79810,2869,31998,45684
34653,15210,40264,52937,8779,49185,64467,6431,25717,35588
34652,10982,42595,62973,6648,51826,72578,4334,26480,46197
34639,10195,88723,99266,7976,97296,107842,2219,62822,61762
34638,9524,97056,112340,7992,104266,121095,1532,47087,58658
34637,2521,88574,104136,2055,103088,111033,466,49205,61268
34614,2642,63596,78594,2102,69907,87356,540,32845,35769
34613,8451,46955,60821,5262,55707,66274,3189,32442,49048
34610,5216,54078,72114,3695,68295,78828,1521,41980,49401
34609,16170,57924,71711,11843,66130,79354,4327,31998,43809
34608,14076,50786,58826,9756,55853,64336,4320,28941,41048
34607,3841,45041,67338,2680,56092,81091,1161,19594,33996
34606,11854,45125,54773,7453,49655,60925,4401,32589,40836
34604,4311,69974,87495,3096,78235,98182,1215,36250,54295
34602,2904,61549,77536,2119,68605,83535,785,46292,53973
34601,10043,40996,54293,6042,49607,64554,4001,24101,34161
34498,249,37734,48148,177,33295,44163,72,39545,48388
34491,12738,48187,60620,8555,54181,66637,4183,32178,45491
34488,4680,34964,49243,2849,47014,57985,1831,22989,27328
34484,1614,39050,59176,685,71875,95246,929,19879,32579
34482,7091,52506,73284,4786,58750,82689,2305,34790,49299
34481,11414,44052,56976,6867,57968,69082,4547,29317,38382
34480,7864,58189,90892,5672,67652,102113,2192,43326,52852
34479,5280,42880,53176,3713,45768,54910,1567,33299,45303
34476,10605,52827,66499,7077,62979,78154,3528,33850,41854
34475,4770,24202,46020,2797,32564,53071,1973,18352,31780
34474,7270,51325,74562,4316,60719,88465,2954,33060,52244
34473,7158,57524,70613,5858,61206,77621,1300,30546,32680
34472,11106,49590,69936,7604,56183,73673,3502,24564,58479
34471,10279,51334,82015,5882,70667,110003,4397,31453,42354
34470,7989,41166,54713,4650,50000,64896,3339,27855,36372
34465,7555,47099,60967,4761,52909,70396,2794,30829,41875
34461,4542,45598,65364,3032,55917,79826,1510,26307,35203
34453,4282,38624,47598,2461,50859,58079,1821,26274,31642
34452,5197,46216,56740,3258,58037,67973,1939,31293,36224
34450,5218,38600,58913,2682,59531,79016,2536,26008,35676
34449,1532,30808,43517,842,45032,51788,690,19808,28272
34448,4625,45119,55546,2871,52254,64267,1754,28090,38667
34446,7861,48271,62753,5331,56011,74165,2530,28934,37313
34445,0,0,0,0,0,0,0,0,0
34442,7327,46275,68733,4706,65757,86872,2621,24327,33909
34436,3821,44164,66321,2187,60781,70578,1634,25015,58186
34434,3121,49769,55815,2016,53933,64033,1105,33917,36613
34433,2913,56232,67637,1778,65200,72607,1135,45593,59038
34432,5672,43798,56695,3736,51128,66866,1936,28750,35231
34431,3713,40582,49386,2207,51056,58134,1506,28162,34788
34429,3928,46808,78340,2308,63086,99991,1620,28475,45072
34428,4057,43417,56361,2594,55395,64070,1463,26709,38037
34420,7122,46383,56627,5223,50527,61313,1899,24842,34620
34293,20250,70357,94445,13955,82329,110484,6295,44169,56887
34292,7747,68765,90673,4980,85167,111524,2767,39727,53023
34291,2332,55615,72264,1767,56322,74428,565,49021,63646
34289,1238,100181,104028,1090,100851,104957,148,55925,52678
34288,4560,60990,108257,3191,88341,130059,1369,28770,54658
34287,11295,52793,70627,7773,62335,80898,3522,30173,44140
34286,6801,61246,82792,5592,64379,88558,1209,31808,51052
34285,9832,56234,89199,4938,81522,119849,4894,40340,57716
34275,9529,67063,132799,5908,81625,124725,3621,40032,145080
34269,2195,45015,55915,1339,47110,64875,856,29910,41765
34268,114,23077,24056,114,23077,24056,0,0,0
34266,10112,34770,45752,6853,40436,51761,3259,23239,30392
34251,2151,73119,92913,1799,78566,99573,352,39314,51979
34243,12873,64853,81244,7988,81405,94938,4885,44631,57696
34242,3939,111653,181125,2575,132529,212736,1364,73295,120220
34241,5870,83882,103543,4110,100308,120996,1760,42661,58617
34240,4393,94046,139913,3701,105805,149917,692,52292,85134
34239,6978,59010,94963,3780,83906,125557,3198,40372,57143
34238,10385,78912,113181,6411,108403,141623,3974,50511,66736
34237,7283,51502,67062,4002,58804,68975,3281,40641,61367
34236,7652,80761,138770,3044,146136,238104,4608,40446,72293
34235,6502,58879,84609,3984,70299,98134,2518,48140,60999
34234,8646,41933,57462,4867,53743,63294,3779,33201,44611
34233,8160,66469,86186,4844,82470,105782,3316,39602,52640
34232,14386,69075,88156,8542,79572,102422,5844,50156,61139
34231,15116,56096,85540,8064,75466,110787,7052,37656,54734
34229,3487,88542,128969,2663,93658,133986,824,50469,109688
34228,3939,108015,184056,2696,128659,203532,1243,62363,140560
34224,7631,43863,59174,4039,58598,73871,3592,30031,39154
34223,9666,55797,82707,5770,72147,99801,3896,37264,56913
34222,5286,57047,68342,3624,65071,82528,1662,27443,35142
34221,17455,57820,76593,11957,65434,85133,5498,37222,54606
34219,8600,85477,104136,6846,95114,112930,1754,49524,67533
34217,2875,62159,120929,1584,78462,159169,1291,34810,73184
34216,607,80865,107119,350,98152,119833,257,42708,89804
34215,299,27444,72132,279,27071,70344,20,0,0
34212,7735,92847,111624,6166,110199,119113,1569,47610,78627
34211,3972,127000,138759,3149,138420,149915,823,63011,93284
34210,7293,50621,78055,4236,60107,94894,3057,42945,52368
34209,14763,63629,96404,9101,79294,121548,5662,37987,53756
34208,13429,50050,67921,9556,53483,73878,3873,33504,46406
34207,14983,39549,50838,8236,51013,60997,6747,25863,35128
34205,12775,46190,60244,6691,57714,73358,6084,31478,41172
34203,15615,52186,82920,9873,73112,106222,5742,29338,40272
34202,8812,103226,147164,6756,120298,166090,2056,57045,82862
34201,1666,96824,149449,1145,112039,163461,521,73250,116839
34145,9056,84288,140015,6109,96729,159967,2947,53341,97427
34142,7532,38082,55095,5653,38061,54175,1879,26820,46544
34141,12,0,0,12,0,0,0,0,0
34140,70,0,0,39,0,0,31,0,0
34139,122,49750,78034,59,143170,120166,63,29740,36886
34138,367,81287,83301,367,81287,83301,0,0,0
34137,93,0,36967,60,0,0,33,0,0
34135,20275,68440,92304,13428,80109,104559,6847,46811,65693
34134,7772,100052,184431,4868,127071,228135,2904,57188,111106
34120,11617,67448,99886,8622,83890,115520,2995,31702,45097
34119,13192,94957,130076,9111,110795,145646,4081,52740,93517
34117,5396,74346,86566,4842,74154,86032,554,62907,63981
34116,9666,55488,70161,7518,57542,73094,2148,37664,43747
34114,7829,62694,91234,5473,72467,103204,2356,36700,60254
34113,8811,61682,90294,5378,73401,107157,3433,42145,61060
34112,12986,60313,81317,7904,76173,94170,5082,41285,59665
34110,11904,69858,129106,6976,96642,167285,4928,38096,72881
34109,11515,76144,120354,7166,93534,151759,4349,47173,67223
34108,8196,98681,175941,5031,138063,219614,3165,59037,105004
34105,7233,90011,156598,4548,117639,199225,2685,55841,79664
34104,10404,54957,73659,6514,70000,84186,3890,37299,53485
34103,5828,102632,209458,3672,144783,253653,2156,56050,133520
34102,5743,95654,194000,2988,138958,279796,2755,54037,98227
34101,0,0,0,0,0,0,0,0,0
33993,9249,78348,90599,7071,83023,98168,2178,48899,53833
33991,8620,66088,80135,6479,70688,86676,2141,38651,54986
33990,12337,61019,75102,8291,66918,83184,4046,44722,54741
33983,6232,61858,79599,4423,72480,90072,1809,32423,53244
33982,4187,46756,67113,2836,59592,72829,1351,27663,43725
33981,5027,55152,65483,3510,62692,72723,1517,35229,46869
33980,6101,50018,65373,3372,61348,82272,2729,34284,43590
33976,4541,52778,61557,3594,50929,58713,947,39632,51239
33974,4909,51669,61541,3855,52583,62297,1054,34394,44155
33973,4025,44116,51461,3207,44752,53669,818,34191,34464
33972,4423,64604,69137,3370,66425,72723,1053,39902,52187
33971,7446,55548,67366,5983,55829,69126,1463,33390,45772
33967,8494,73084,89911,6100,76914,90474,2394,51583,83455
33966,4263,67757,108472,2767,75320,119143,1496,49500,88566
33965,0,0,0,0,0,0,0,0,0
33960,278,39917,43781,165,52759,50185,113,34688,34429
33957,3919,92875,167697,2766,121724,193276,1153,41118,104926
33956,1737,53839,97188,1015,72417,97153,722,36295,95252
33955,4562,66239,90651,3222,80435,104612,1340,39331,54896
33954,3777,61683,83033,2586,66779,86848,1191,51938,58714
33953,2809,63020,84640,2030,72451,95083,779,48456,53309
33952,14495,44456,59248,8462,54104,71914,6033,27272,39480
33950,11367,58560,88253,7529,74719,102873,3838,40818,58602
33948,7315,50391,63949,4777,59583,75423,2538,31573,40228
33947,4401,55610,73148,2956,64853,82899,1445,35155,52833
33946,1256,57984,130824,1001,74464,146910,255,30673,67682
33945,6,0,0,0,0,0,6,0,0
33944,138,0,0,138,0,0,0,0,0
33936,8319,40129,53951,5772,47297,59241,2547,21147,35572
33935,7109,37155,57877,5253,38345,61740,1856,30101,37812
33931,5537,64742,102705,3262,78897,119574,2275,41269,77635
33930,288,0,70400,181,0,83561,107,0,42301
33928,11815,84092,110250,8253,95722,123615,3562,54075,76728
33924,31,0,49152,27,0,55000,4,0,0
33922,1674,50603,76232,1036,56859,83254,638,30139,59942
33921,416,100804,102991,276,117647,132044,140,0,45716
33920,2288,78654,96870,1843,83065,100907,445,46314,74918
33919,14049,58138,79442,7735,78181,100662,6314,39352,51955
33917,13204,47441,61795,7356,64599,78294,5848,28409,39364
33916,9000,37743,55854,5535,45155,64606,3465,24972,38588
33914,16168,66185,89483,11324,78474,103476,4844,41651,53400
33913,9244,86649,115281,6589,103456,130904,2655,59464,72581
33912,8628,86531,120127,5850,101803,143091,2778,47284,70028
33909,10678,57302,65890,7743,65793,73867,2935,27708,40525
33908,18163,58556,93172,10289,80721,120901,7874,36618,55989
33907,10115,45066,57735,5282,55496,70528,4833,32264,41355
33905,12616,56025,67670,8282,61473,74883,4334,35331,49008
33904,13958,50695,70620,8156,66946,89243,5802,32807,43236
33903,11394,48710,60691,5545,59709,78322,5849,34956,42953
33901,9036,41352,72115,4360,56630,95400,4676,29663,48234
33898,6479,45471,62707,3977,50208,71491,2502,29784,47162
33897,7246,56419,75722,5532,57523,80258,1714,44513,55056
33896,4245,60056,70259,3113,56908,68544,1132,65833,67402
33890,1636,38700,55669,1274,44479,53851,362,24375,60213
33884,12348,60359,82438,8374,68487,95042,3974,42685,54088
33881,12482,44281,61863,8168,50164,69965,4314,29544,43159
33880,13688,44615,59305,9379,50886,65322,4309,30410,40084
33877,87,0,0,87,0,0,0,0,0
33876,2282,51193,56883,1605,59670,65552,677,27118,36266
33875,4883,57410,72675,3116,65526,80885,1767,31705,56084
33873,4417,38375,65757,3035,47614,84272,1382,15460,23816
33872,7062,52003,65741,4851,58878,74989,2211,29979,45178
33870,8700,36619,51894,5246,45442,60624,3454,22766,36560
33868,3873,48882,69136,2956,54952,74388,917,42316,47540
33867,95,36250,36609,55,39911,46589,40,0,22888
33865,274,57813,57069,226,44412,56081,48,0,0
33860,8217,57110,67058,6091,59790,71731,2126,33592,41686
33859,4325,48345,54310,2800,57970,63153,1525,24674,34835
33857,901,31827,49168,452,33500,41297,449,29482,57092
33856,251,24443,29371,62,34013,40868,189,23666,25599
33855,0,0,0,0,0,0,0,0,0
33854,188,48929,51780,63,75139,58251,125,37375,48519
33853,4408,41031,53328,2511,59375,68311,1897,22142,29163
33852,8826,41713,84147,5223,47008,70188,3603,27070,99932
33851,342,50000,65842,268,53750,67151,74,30000,51149
33850,3440,41895,55087,2204,48256,65971,1236,26389,34844
33849,196,39375,56421,154,39286,59608,42,45278,44733
33848,172,59293,50682,151,59864,53750,21,0,0
33847,50,73125,73214,42,74375,78300,8,0,0
33844,13179,47050,64046,9230,49931,72589,3949,27819,39411
33843,3945,46776,53664,2661,52275,62120,1284,27397,34545
33841,3207,39663,61250,2069,56987,73218,1138,23841,35807
33839,1063,57204,86351,742,73056,104601,321,26250,38255
33838,1356,38889,44178,1164,45156,46996,192,18092,23637
33837,10313,60531,75255,7634,67386,83307,2679,31981,46890
33834,1728,48287,55013,1324,49528,57507,404,33254,38669
33830,9829,46112,66819,6801,60139,78268,3028,25631,33942
33827,955,63325,92026,714,72308,97598,241,23036,70025
33825,9629,40034,53389,6498,46117,61933,3131,25560,33061
33823,11571,53767,74787,8509,60082,84522,3062,30874,41678
33815,5693,32708,45722,3048,47753,60149,2645,21875,28487
33813,12939,85383,112678,9823,93384,127074,3116,48651,63908
33812,4216,79076,89762,3480,84088,95014,736,50200,57033
33811,8064,71224,85088,6035,77316,93587,2029,39991,52572
33810,17958,58100,69946,12452,64351,76931,5506,40124,48394
33809,11094,54919,70453,7792,63915,77975,3302,36114,49626
33805,9236,37952,55074,5477,42979,63375,3759,28941,37834
33803,11867,54263,83585,7079,63361,104497,4788,36437,48203
33801,11736,37848,46403,6842,46144,52877,4894,26878,33464
33786,731,94688,160761,479,132188,190729,252,49000,103314
33785,2874,73786,115454,1662,107759,148169,1212,47895,66147
33782,9273,57150,71525,5601,67616,84559,3672,36031,47454
33781,9974,43692,65307,5859,58319,79064,4115,23698,42878
33778,6218,50774,73156,3616,69250,89157,2602,29082,48378
33777,6956,76278,99788,4281,88988,113424,2675,46998,74382
33776,4805,78596,107765,3491,97618,122629,1314,48796,64681
33774,7988,63370,77122,4803,87975,96245,3185,35029,44681
33773,6831,59305,75018,4239,77904,90425,2592,34009,47721
33772,9801,60843,78049,5960,75012,89680,3841,36088,57106
33771,13316,47114,55452,6786,52393,64934,6530,36830,43385
33770,11561,47908,66174,5867,65320,84038,5694,32106,45606
33767,4049,87340,143679,2343,117996,184335,1706,50213,86685
33765,6372,48400,68728,3839,63904,85348,2533,33327,41309
33764,11852,53416,76715,6871,74877,97358,4981,37628,46389
33763,9403,46289,59538,4586,52887,73092,4817,35552,44935
33762,2633,67134,96260,1320,99397,134213,1313,46715,57841
33761,8736,57232,78079,5190,79531,96765,3546,34200,48429
33760,7162,50486,66350,3973,55099,74707,3189,41291,53131
33759,7820,53611,76453,4406,77156,97778,3414,34144,47322
33756,13230,45521,74826,6951,63809,100057,6279,28883,44850
33755,9977,42389,63559,5850,49253,70130,4127,29788,51765
33744,0,0,0,0,0,0,0,0,0
33716,9360,55063,68947,3241,78486,87146,6119,45670,57592
33715,3794,93877,134028,2417,108906,156876,1377,64583,92732
33714,7926,36130,46402,4489,42450,52874,3437,26250,34567
33713,13782,58830,73735,7245,73476,87227,6537,40453,56548
33712,9178,51569,66046,5374,64139,78435,3804,34844,47574
33711,6410,52902,70047,3947,69720,81506,2463,33033,50620
33710,14369,61970,83121,8901,80599,101688,5468,41773,49770
33709,10305,45276,56349,5365,59683,69421,4940,30692,39285
33708,7929,63351,92298,4267,79754,108143,3662,48158,73433
33707,12512,51861,74263,5941,71907,95053,6571,33324,54086
33706,8805,76277,114601,4861,116295,151624,3944,49830,68105
33705,11210,56914,73087,6017,75325,87026,5193,41910,54893
33704,8038,84295,145715,4473,146131,198219,3565,47484,73841
33703,11120,87032,119558,6927,108474,145130,4193,50355,72858
33702,14139,54196,76814,7537,77551,98969,6602,37445,49916
33701,9120,46786,87867,2749,103203,159469,6371,34339,56574
33647,25565,89270,120593,18122,106464,137163,7443,58092,76854
33637,7071,50518,59256,3731,51276,65526,3340,48560,50047
33635,7240,71768,90470,4915,86162,103063,2325,54196,60449
33634,7544,60237,83180,5122,67861,88572,2422,43167,66949
33629,10441,126363,178207,7180,158014,212476,3261,60552,100321
33626,11059,113550,139754,7983,128117,159653,3076,59152,79119
33625,11232,62539,81007,6922,70116,87505,4310,53965,66916
33624,15043,71668,89008,9973,84518,101841,5070,49972,58644
33621,538,85000,102195,538,85000,102195,0,0,0
33620,11,0,0,0,0,0,11,0,0
33619,13347,47677,59233,8145,50151,61770,5202,41359,51966
33618,12100,68245,106081,7376,86639,132283,4724,45429,61585
33617,19281,39830,59581,9571,49644,78116,9710,31878,39502
33616,6265,64274,91402,3700,80600,111890,2565,52190,59185
33615,18028,53516,73973,11390,56893,81350,6638,41996,56456
33614,18229,43951,55010,11008,47528,60735,7221,33229,40185
33613,14911,35755,55435,5848,47424,85239,9063,30137,34586
33612,19021,35746,47836,10018,42408,54954,9003,27722,35705
33611,16269,66495,103942,7785,98759,144824,8484,46523,64410
33610,16771,38733,49101,11047,44387,53180,5724,24129,36537
33609,8497,85174,140410,4175,123668,180235,4322,53696,96015
33607,10932,46587,63433,5234,57760,71606,5698,35912,52975
33606,8894,95799,154284,3739,139375,232385,5155,72920,96492
33605,7585,23632,39770,3462,34198,50568,4123,16989,27853
33604,15811,44192,58912,8853,54050,66911,6958,33267,42923
33603,8753,50607,71405,4695,61700,89250,4058,36012,47437
33602,8599,71894,109306,2968,115484,152194,5631,57874,85770
33598,6726,66709,82324,5673,68025,82986,1053,53984,66437
33597,2987,49242,66135,2118,61596,76849,869,27174,34194
33596,10047,102627,118010,8148,109201,124734,1899,58280,82621
33594,13214,68026,88471,9257,80317,98383,3957,39816,61241
33592,3963,45064,74191,2573,56380,87443,1390,24401,45018
33585,411,53977,70374,288,85357,88014,123,0,27710
33584,9440,54970,74278,6407,67306,84676,3033,37912,46484
33579,12030,86439,98559,9586,93730,106879,2444,53500,60369
33578,20742,65142,77903,13167,74153,87746,7575,51987,56229
33576,2212,62000,83067,1543,76688,97759,669,37255,47651
33573,13440,49368,65136,7237,64432,84867,6203,30564,41921
33572,8239,97058,127039,6262,107192,137898,1977,46788,84364
33570,9788,54977,71811,7291,65331,78077,2497,31802,45336
33569,10181,76560,88644,7164,90475,101062,3017,40645,52479
33567,3868,73403,83147,2896,80473,85640,972,41429,68982
33566,7342,65531,86264,5463,77586,95175,1879,42721,56049
33565,6187,55410,73656,4256,64206,81333,1931,36773,51933
33563,9967,44969,56756,6442,53976,63202,3525,30597,41783
33559,6871,71724,83335,4246,78660,101343,2625,38627,51324
33558,9168,85281,121853,6636,114298,144115,2532,38041,59524
33556,8310,112459,158971,6772,132022,179089,1538,44947,67486
33549,6883,71490,93450,4695,93858,111051,2188,39698,50945
33548,2718,125521,140668,2055,136086,163915,663,42250,64578
33547,7704,104513,135075,6587,114122,144303,1117,55439,72024
33545,6634,83757,100791,5300,87310,108150,1334,52150,65318
33544,9689,86707,109557,7580,91341,118983,2109,52625,68885
33543,9822,84375,99790,7515,92938,111557,2307,45770,54538
33542,10301,36239,45479,5781,45415,54756,4520,23755,30456
33541,9813,41521,55619,6383,47388,64064,3430,29632,38456
33540,4175,35601,51013,2516,47182,56394,1659,26107,38105
33538,2203,38231,60524,1342,53534,66435,861,23428,50993
33534,5058,66295,68926,3689,74036,74059,1369,38996,50501
33527,5037,57834,80356,3560,74138,95756,1477,23854,37922
33525,6875,56706,73003,5147,65368,83286,1728,27109,36312
33523,6460,51028,70787,4509,55565,78468,1951,32042,49597
33521,240,33438,44897,131,48672,53250,109,25438,34279
33514,808,41654,54163,574,57500,63378,234,0,28153
33513,4094,42304,67145,2979,46908,70414,1115,26636,54499
33511,22334,61149,79120,14379,71727,90105,7955,41984,54651
33510,10857,62259,77011,7494,67837,81334,3363,40773,62716
33503,58,0,82016,49,0,96676,9,0,0
33498,5555,106606,141666,4528,111488,146508,1027,73523,114586
33496,9994,93561,172691,6452,126500,210906,3542,54167,101069
33493,795,39432,63331,622,46389,72568,173,17674,21587
33487,9538,76073,127426,5245,100493,156657,4293,53996,89670
33486,9253,91883,114972,5859,117731,135083,3394,41490,73693
33484,14456,44362,71170,6550,70313,96991,7906,31016,49161
33483,6476,100500,187841,3560,130096,241271,2916,78923,120966
33480,6065,141328,300960,3184,196354,378352,2881,95302,214869
33478,4888,121275,142657,4107,126929,149293,781,47663,94596
33477,7188,89717,148509,3800,125263,194815,3388,56950,94922
33476,2366,21986,39372,1509,30405,47231,857,17595,25203
33473,4249,122069,136418,3688,123871,143148,561,0,90138
33472,7908,76749,110623,5615,86215,125272,2293,39245,59724
33471,2428,39243,46097,1478,45725,55020,950,23777,30255
33470,8669,92217,112126,7064,97554,115445,1605,53542,79988
33469,6689,83985,122776,4338,98245,143495,2351,48208,84467
33467,20539,70917,96935,14279,88011,114303,6260,37327,53472
33463,18935,55713,86866,14347,58190,79901,4588,38536,96704
33462,12838,55285,83061,7375,63786,96475,5463,43563,61373
33461,14629,48806,62597,9734,53931,68831,4895,37337,44119
33460,10887,41561,62458,5972,47447,69177,4915,33292,48701
33458,21850,85862,132592,14266,105768,161014,7584,56431,76232
33455,9574,59724,113292,5687,79401,131317,3887,40865,85054
33449,3765,128712,157394,3217,140579,167470,548,52123,88613
33446,13280,60607,121649,7482,91465,159436,5798,36440,72774
33445,13922,55945,85544,7074,73069,105314,6848,40337,62123
33444,8807,62621,84192,4947,64583,91815,3860,51290,72353
33442,13835,47437,63327,6679,68727,87244,7156,30759,40072
33441,11166,47746,66178,6007,58584,81941,5159,31937,44011
33440,6967,39792,57834,5122,48257,62110,1845,26486,38683
33438,87,0,85405,79,85938,91009,8,0,0
33437,18026,65117,85153,10764,80864,101546,7262,40749,59752
33436,18492,61388,88716,11047,73694,102684,7445,42319,61089
33435,13961,52785,80093,7912,62123,91676,6049,36071,61912
33434,10008,62047,105512,5517,93894,142406,4491,33138,58264
33433,18917,58788,91213,9700,84802,118462,9217,42699,61192
33432,10751,77952,153895,4705,116113,206403,6046,49746,112318
33431,8253,88430,125578,4707,101618,151768,3546,47905,89166
33430,7219,29682,45043,4694,40137,55765,2525,15069,22144
33428,15030,67202,101949,10675,80079,110669,4355,46665,75783
33426,9760,63061,71335,5408,66854,78254,4352,51439,58071
33418,17185,100590,155660,11823,122657,180404,5362,56905,97838
33417,15284,39498,54533,7968,52593,68997,7316,27191,37201
33415,17195,43561,58761,11571,51721,65194,5624,28918,39938
33414,19720,86716,114660,15327,94846,123299,4393,55918,78157
33413,4993,66977,89298,3733,74914,86846,1260,44117,85838
33412,5227,91875,130833,4214,104978,142275,1013,59321,76234
33411,25446,76804,92738,18106,86540,103443,7340,45461,58121
33410,14701,76488,133970,8785,104599,168861,5916,53650,77669
33409,10781,54391,68312,6522,54631,69573,4259,46468,60703
33408,9380,73427,126529,4960,119855,165969,4420,47705,81765
33407,11084,44042,61541,5905,49926,68984,5179,33074,51316
33406,8173,64608,85487,5573,69242,96957,2600,45985,56300
33405,7645,60199,81497,4576,80444,95543,3069,45140,57655
33404,10437,46436,72943,6298,58977,86360,4139,32519,50445
33403,4345,53410,65080,2672,66134,75316,1673,34877,45892
33401,12537,48958,81291,5540,61650,101334,6997,43142,63630
33351,11911,56937,73152,7939,69527,81565,3972,37428,51543
33334,12353,58346,82266,5774,67157,88464,6579,46695,74882
33332,3395,139317,200477,3005,148457,215998,390,51250,61187
33331,7357,126104,170376,6639,127796,177127,718,89107,98239
33330,4569,131222,168627,3912,139000,178027,657,70268,101966
33328,10179,101007,125048,7494,117735,140033,2685,60302,73344
33327,6681,131908,174748,6334,132199,176972,347,91750,128952
33326,10632,93333,118441,8603,99284,124682,2029,54696,84479
33325,9933,85789,107055,7688,89799,111975,2245,55647,73951
33324,19331,69996,93934,11935,75575,106654,7396,54030,70122
33323,7576,93586,115781,5302,106047,133115,2274,60833,72174
33322,17901,46994,72128,9699,71242,89703,8202,29000,49844
33321,19943,52263,65577,11106,59592,72974,8837,36250,52637
33319,19166,46312,65618,11574,56918,78627,7592,30648,43136
33317,12453,72163,89513,9043,82440,96398,3410,40885,63664
33316,5042,80694,162905,2414,115747,199358,2628,53918,128320
33315,5778,78367,91591,3045,81337,97457,2733,69821,79510
33314,9195,55562,69290,5690,62093,77277,3505,41728,50733
33313,20084,40781,54298,13232,46438,63431,6852,26891,32287
33312,18201,59810,82923,12001,62164,85484,6200,48367,71847
33311,24216,40684,49086,15037,44891,53543,9179,22024,36282
33309,13517,59045,71576,8376,61737,75385,5141,49276,57622
33308,14957,73818,122494,6549,102211,167291,8408,55809,85919
33306,1729,71159,159083,779,132026,233540,950,51250,97099
33305,6815,72451,115160,2710,113300,161560,4105,52894,81319
33304,8980,60665,99896,3154,100000,142300,5826,53771,75923
33301,8380,101321,158132,2827,161830,272642,5553,79375,99453
33196,15370,80915,94590,13247,85449,99156,2123,39252,52092
33194,1712,106402,120107,1525,115012,125167,187,0,68937
33193,15108,67779,76770,12232,70204,80040,2876,36932,51708
33190,5053,63938,75885,4301,63069,75670,752,35292,57237
33189,7813,56845,72759,5700,65275,79118,2113,34290,44778
33187,5224,87848,99537,4384,83571,98964,840,42867,53094
33186,21711,72109,85188,17275,75857,91354,4436,40690,54263
33185,8627,86366,102148,7216,89167,106187,1411,42796,57490
33184,6126,60146,72334,5108,66095,79472,1018,19758,27519
33183,12243,60616,77447,9577,66925,87081,2666,25000,40447
33182,3985,94386,103895,3581,99037,106988,404,30833,40852
33181,7768,47009,77054,4196,52034,88669,3572,38315,61536
33180,14121,78234,122742,8189,100990,152467,5932,43976,77998
33179,16919,47974,67383,10572,56402,79312,6347,31677,45669
33178,15834,75907,94374,13213,77102,96937,2621,58151,67469
33177,15423,61341,75938,13041,62132,78815,2382,31946,44120
33176,18160,74246,108922,12904,90289,128844,5256,40258,53320
33175,16670,60630,81014,12903,68164,87917,3767,31298,48796
33174,10902,50387,65234,7348,58301,75831,3554,23455,38238
33173,11056,70541,98009,7856,86932,112178,3200,42500,57442
33172,13754,52003,62986,10140,57692,67806,3614,35011,42529
33170,3680,51778,67320,2846,53821,71502,834,37321,40813
33169,11984,46656,59366,8576,53889,65328,3408,28089,36631
33168,6353,49381,61254,4845,52041,65199,1508,26798,34450
33167,6140,45879,58389,4858,56115,65185,1282,14638,23725
33166,8592,60645,80784,5518,65780,88931,3074,43710,59850
33165,16649,65005,84439,12888,68804,91698,3761,32594,44475
33162,13541,45996,64985,10179,49135,72492,3362,27163,33581
33161,16822,42846,57394,11607,46321,60818,5215,28398,42318
33160,19405,50660,92945,9631,72062,136477,9774,28731,48936
33158,1983,159219,225581,1724,164773,231023,259,74028,180993
33157,19184,68832,98313,15306,75945,107657,3878,24861,47940
33156,11004,126688,221675,8444,161636,254887,2560,56291,108442
33155,14375,66753,95716,10729,74484,101731,3646,41258,60802
33154,5800,75702,131299,3616,102455,155548,2184,50403,87758
33150,10221,30311,46731,6353,35464,53431,3868,19804,32791
33149,4079,162175,242022,3195,200313,269437,884,61786,129934
33147,13966,37619,53490,10055,40500,59650,3911,21047,29377
33146,4841,110596,194454,2558,209028,279103,2283,75598,98303
33145,11710,56239,77589,7202,61099,85042,4508,41292,60443
33144,9720,51341,67733,7311,55715,72857,2409,30345,42171
33143,12855,69992,131894,7433,104283,177029,5422,36627,67841
33142,20142,28105,39422,12676,35465,45780,7466,14410,24380
33141,17387,52913,83384,9113,60143,103288,8274,36111,58346
33140,9002,87384,165133,5176,115980,201488,3826,58509,111167
33139,20559,56227,108377,7336,72096,136671,13223,46990,92025
33138,12053,50863,87966,6866,54876,101471,5187,41158,68525
33137,9900,64106,92759,4334,65462,101870,5566,62514,83880
33136,6497,29897,40983,3156,34638,47403,3341,23395,33404
33135,14278,30112,45784,8457,35945,50479,5821,18068,36705
33134,16297,70983,110623,9873,97608,139530,6424,39049,62231
33133,14081,74398,146442,8105,97604,173615,5976,55905,103308
33132,7631,90759,114636,2755,112679,138335,4876,80878,100946
33131,11265,102862,157682,4245,140605,198728,7020,100039,132351
33130,15856,45040,71092,7647,45038,69571,8209,37148,70975
33129,6680,86922,117739,3264,122759,146871,3416,64131,87158
33128,3461,21332,34231,1797,29458,42949,1664,12167,22580
33127,9800,32688,43245,6192,37917,47072,3608,16042,32059
33126,18035,42589,52737,12073,45594,55578,5962,25935,40347
33125,21716,31371,53094,13286,37476,60514,8430,16679,36776
33122,166,94318,90031,91,0,91923,75,93750,87736
33109,213,228304,329835,147,0,343137,66,228750,300209
33101,0,0,0,0,0,0,0,0,0
33076,12372,138816,173046,10590,144631,182211,1782,73676,105001
33073,11776,81727,92690,8520,87832,98912,3256,53523,66084
33071,12985,90849,111238,10041,103482,122404,2944,52241,61346
33070,2238,65286,108019,1517,92294,128240,721,40507,64496
33069,10500,50975,65582,5965,56883,75493,4535,37070,49369
33068,17013,47536,61153,11309,55215,65207,5704,31378,46765
33067,8269,106890,148001,6693,126038,161500,1576,62132,81023
33066,8697,52493,113653,3845,68154,78835,4852,37679,138346
33065,18697,57287,77036,13709,64154,84595,4988,38506,48962
33064,21303,52740,77145,12736,60156,86729,8567,37909,56814
33063,24451,47800,64083,13756,63610,77473,10695,32390,44319
33062,12839,68526,100429,5957,93982,138348,6882,49084,65939
33060,13531,47957,64751,8183,54226,70978,5348,32404,50298
33056,10161,48204,61239,7945,52397,66135,2216,26484,38495
33055,10985,46914,57578,8248,52065,62631,2737,27542,33954
33054,9518,31508,43967,6749,38768,50316,2769,20189,24150
33051,321,91899,142599,180,113929,145938,141,90528,138337
33050,4183,58120,91631,2330,67469,104245,1853,43707,72140
33043,2063,75957,88409,1361,97250,103367,702,34405,57313
33042,2971,91352,128755,1931,96193,152198,1040,65887,81176
33040,14487,73982,103409,8245,84462,118071,6242,53150,76771
33039,138,66571,60724,56,90705,87452,82,0,0
33037,4758,68164,111594,3009,75753,128444,1749,51222,79484
33036,1592,75439,118508,847,86250,153324,745,39866,76072
33035,4533,65907,76059,3745,56808,79268,788,41683,51381
33034,5056,36250,47845,3996,34269,49655,1060,19110,26451
33033,15906,55174,66126,13253,52512,66252,2653,35742,49013
33032,14559,59878,67469,11699,58866,68897,2860,32813,44719
33031,2490,89450,137469,2150,89283,142108,340,85357,94886
33030,9091,38730,53980,7450,36750,53928,1641,21772,38246
33029,12870,112537,135728,11339,121771,143013,1531,68379,72843
33028,8407,101439,118987,6897,109406,126952,1510,59933,72335
33027,24319,58063,81685,16671,84405,98657,7648,30016,41565
33026,11956,79741,94799,8216,95385,110472,3740,41727,53304
33025,26049,58595,67871,16022,65317,74228,10027,47962,52950
33024,23519,61959,83002,17453,69611,91382,6066,38822,50585
33023,20634,54759,68306,16197,57803,71757,4437,36291,43299
33021,18677,57849,84948,11788,73067,102303,6889,36077,51524
33020,18655,48504,60748,9505,53838,69621,9150,35541,48623
33019,6444,76793,121607,4089,98191,139721,2355,52960,85936
33018,15539,70226,82315,13180,70506,82905,2359,41144,53706
33016,15816,47929,73735,12484,54063,78338,3332,24323,37338
33015,22066,58972,69838,16829,60234,72935,5237,32432,48799
33014,14076,48450,67610,10123,55501,73103,3953,27148,49533
33013,9293,41177,55108,6745,49944,62676,2548,15920,27520
33012,25596,34175,49101,18385,40035,54280,7211,15595,25162
33010,15885,32642,45727,10467,40169,52452,5418,15574,26795
33009,18988,39834,61009,9768,46777,70280,9220,31981,49170
33004,6716,42780,75961,3657,63363,100191,3059,33012,45839
33001,167,44297,45903,89,51528,49589,78,43438,41697
32976,5165,40992,54948,2799,50285,71323,2366,27994,34231
32970,69,0,23003,33,0,0,36,0,0
32968,4904,79811,91296,3485,87986,106523,1419,39694,52486
32967,8009,51777,78169,5379,64298,93435,2630,34663,45949
32966,8559,53750,71516,4882,71387,93324,3677,32100,41900
32963,7574,126643,214993,5082,162055,261481,2492,67857,119949
32962,8723,52537,67777,5634,59970,74068,3089,34821,49212
32960,9148,44648,67742,4312,63008,76873,4836,31182,58021
32958,12414,53395,69796,7641,67710,79992,4773,35127,52033
32955,15284,72969,89241,10600,82562,94150,4684,53293,74847
32953,9507,66834,88555,6145,87306,107916,3362,36937,50505
32952,8273,79720,110519,5285,106761,140447,2988,46346,56967
32951,5928,68544,107389,3679,95266,136989,2249,47061,57395
32950,1788,83400,90039,1298,94615,103300,490,41250,52437
32949,954,87250,110833,736,105469,124386,218,0,63738
32948,1559,42312,55266,1199,45273,61570,360,25153,31029
32940,17828,73601,104517,11867,98602,123847,5961,47551,63899
32937,10881,76548,104501,7267,89001,123151,3614,45799,65305
32935,16797,53207,66098,9600,62793,77949,7197,37553,47343
32934,7159,81106,102615,5168,103305,118146,1991,30680,58765
32931,7451,67894,96500,3887,103528,123165,3564,43832,66734
32927,10005,64940,84145,6669,72259,86872,3336,48500,72727
32926,8923,54366,74780,5977,66427,86937,2946,33145,48136
32925,487,51513,74307,388,50658,76615,99,59531,65226
32922,6982,36397,54030,3555,45143,58031,3427,21780,47193
32920,5939,52948,72760,2621,67344,87228,3318,44485,59545
32909,10655,53651,75164,7703,61894,79009,2952,30688,58812
32908,3785,53174,64823,3084,53895,67548,701,45852,46382
32907,15617,55322,65779,11513,62720,71388,4104,31461,45119
32905,9379,44056,52962,4821,53867,65054,4558,30931,37521
32904,12791,72981,84645,7901,88487,97669,4890,46768,59196
32903,6165,81488,113906,3811,113885,142222,2354,57278,66584
32901,10658,42822,57117,5287,56241,68230,5371,27599,39990
32839,17392,42124,53207,9629,42752,55956,7763,36507,45621
32837,16191,63143,78268,12421,63984,80070,3770,55873,67283
32836,7117,111271,173903,4885,125475,209732,2232,71458,94031
32835,17323,57480,84268,10908,64205,96925,6415,44209,59125
32833,3154,74340,89428,2631,78708,94212,523,38008,45338
32832,10108,94718,116323,7570,109658,125840,2538,62121,79939
32831,28,36250,37082,0,0,0,28,36250,37082
32830,0,0,0,0,0,0,0,0,0
32829,6428,76103,88235,5147,80954,92035,1281,49107,66219
32828,23465,80746,92517,16889,92338,103718,6576,58800,59928
32827,3561,81545,116706,2697,101620,128179,864,52571,75653
32826,8672,57023,74248,4588,75217,85560,4084,39938,53375
32825,19123,64400,78656,13766,68367,84419,5357,47193,56981
32824,13767,64216,81227,11444,62133,78051,2323,61167,71011
32822,22655,43930,51894,14709,45419,53959,7946,35310,43959
32821,8111,51993,65040,3739,56457,68125,4372,47937,59388
32820,2992,87054,111967,2678,87325,106836,314,67202,125346
32819,9814,76118,106777,6690,86555,116966,3124,55513,80851
32818,17456,48478,58197,13653,49363,61305,3803,27761,34745
32817,11083,64043,80883,7150,75214,93420,3933,37041,51802
32814,3417,98750,143004,1907,153566,183063,1510,68100,89556
32812,13889,58665,81887,8623,70764,96844,5266,42304,54864
32811,14402,40594,52865,8368,43011,53455,6034,32601,45903
32810,13410,53551,66215,8617,54829,68607,4793,42290,57347
32809,9457,45205,70276,6313,52910,80453,3144,32945,41049
32808,18603,39187,54089,12403,40400,60141,6200,27516,35821
32807,12012,48469,57740,7284,52176,62407,4728,36250,43473
32806,10922,72533,103667,6314,97845,131025,4608,49023,64462
32805,7385,33433,48607,3882,38240,55262,3503,24634,38109
32804,8201,84471,126239,4123,118661,174483,4078,57713,76603
32803,9764,82111,109092,4242,99268,136454,5522,68654,84163
32801,7967,66350,102943,1809,86534,134728,6158,61949,93406
32798,1329,51399,59753,730,73214,71724,599,41100,43558
32796,8208,52135,67253,5261,66504,80751,2947,29721,40402
32792,21236,57214,74607,11118,80030,96771,10118,39741,47948
32789,11187,79907,157455,6012,131111,225610,5175,48785,75774
32784,3962,56250,75394,2907,71694,89864,1055,18430,30609
32780,15211,51665,67934,8908,64926,81107,6303,35236,47290
32779,11209,95005,134614,8591,102416,147293,2618,53958,87185
32778,9974,46451,70273,6002,66500,88635,3972,29028,40990
32776,4183,73424,95013,3166,81875,106587,1017,49507,52527
32773,11327,48089,66783,7263,53441,72092,4064,34787,47067
32771,20486,67453,87199,13815,82606,98811,6671,45925,58648
32767,1064,56250,77042,702,64485,97578,362,34537,34248
32766,4925,118395,132687,4551,120816,136595,374,51888,73854
32765,21663,84643,101251,15319,99977,116269,6344,38823,58968
32764,1150,75882,87852,863,84792,99886,287,31563,43039
32763,9473,49566,66407,6142,61362,78998,3331,29906,38047
32759,1226,48722,62625,822,51161,68718,404,28750,47116
32757,11765,59987,82627,7559,80226,99434,4206,33583,49201
32754,4402,53338,68162,3220,60651,77868,1182,28333,39572
32751,8731,78337,108187,5711,100275,134481,3020,45687,55150
32750,9469,75089,92654,6738,83821,104844,2731,43732,55524
32746,19018,89609,117703,13692,105383,137699,5326,45882,61509
32744,1241,55446,77862,863,70050,91928,378,30208,38477
32738,14966,59548,69327,11639,62488,72186,3327,36875,50323
32736,3690,69083,97200,2833,88318,110741,857,41510,49892
32735,1779,55861,60402,1175,69818,72129,604,28906,35244
32732,1868,86277,100379,1426,91250,111867,442,43611,63213
32730,2809,41662,61813,1508,45029,58162,1301,37279,60356
32726,9101,50439,61803,6171,58582,68573,2930,30851,42264
32725,16823,55888,65296,12352,62751,72278,4471,31860,41647
32724,14929,54234,71730,9364,69392,88017,5565,26604,42018
32720,12430,56118,72676,8190,68453,83799,4240,29900,44298
32714,15224,54611,71809,9084,67224,83459,6140,43399,50488
32713,8366,70421,85353,5572,82872,99828,2794,39878,54581
32712,15684,80336,97066,12152,88315,107014,3532,37759,55468
32709,661,57150,105671,561,57361,116425,100,18859,29632
32708,18514,76542,96815,12885,95217,113321,5629,51415,55406
32707,15680,55387,66902,9444,65987,77945,6236,40062,46976
32703,19623,53762,71996,13492,63181,82370,6131,36980,45146
32702,1099,49327,60166,784,58561,69752,315,32607,35380
32701,10808,57778,71326,5746,62816,79932,5062,51480,58987
32697,87,42031,56156,70,0,54253,17,59125,63994
32696,5139,44328,66211,3328,58792,83941,1811,26940,32147
32694,1082,32125,50995,394,65000,78794,688,23653,34853
32693,4305,40060,56347,2780,54167,67739,1525,22308,32549
32692,42,0,0,27,0,0,15,0,0
32686,2301,36212,69809,1354,50389,97182,947,17995,30292
32683,103,47083,40540,92,50625,43271,11,13750,17700
32681,15,0,0,15,0,0,0,0,0
32680,4361,41935,55315,3008,44412,63127,1353,31896,35486
32669,4854,71880,100139,3357,83181,117284,1497,38613,59512
32668,2017,48530,63680,1485,55461,71213,532,26328,35563
32667,1728,64683,74841,1004,76250,94521,724,21923,43369
32666,2737,56544,68765,1819,63924,82859,918,34500,38219
32664,166,51196,56394,104,52283,62958,62,38214,45384
32658,92,51429,60515,76,65417,65342,16,47778,36781
32656,5423,54631,67330,3827,63027,78065,1596,30339,38050
32653,6106,63333,81408,3704,88222,101392,2402,35307,49757
32648,114,54545,66096,95,54659,70711,19,27083,27911
32643,4094,57404,69385,2841,74067,81941,1253,27533,37108
32641,5130,36126,47933,3307,37382,54397,1823,25661,32194
32640,4141,43610,52316,2672,51185,56391,1469,20337,39808
32639,129,34353,34503,62,47717,44095,67,0,25627
32631,169,59013,76985,107,0,86099,62,65286,61256
32628,1524,38500,53143,1056,49605,63064,468,15482,29119
32626,3686,35345,45617,2309,41049,51951,1377,22345,31420
32625,625,53281,67614,411,62639,81958,214,31154,38573
32622,462,49444,53614,305,73304,73738,157,0,14521
32621,2061,38217,44324,1228,45375,51859,833,21414,29672
32619,2032,47233,56342,1453,49006,60154,579,41012,39664
32618,3383,63601,89507,1868,77321,103583,1515,44526,67466
32617,1662,42377,63013,1111,54617,78081,551,22311,28605
32616,352,0,44990,200,0,70671,152,0,11205
32615,5430,63580,84018,3593,75132,91808,1837,50529,65633
32612,26,25000,13196,0,0,0,26,25000,13196
32609,7160,37725,47911,3404,43007,56414,3756,27100,39243
32608,19909,50786,78832,8911,88951,122136,10998,28347,42188
32607,12236,41656,66238,4936,67532,96182,7300,30547,45038
32606,10012,61177,84946,5596,91368,110055,4416,42820,52057
32605,10815,70517,95914,5743,94866,126532,5072,43927,58446
32603,1753,18116,52170,334,43750,80552,1419,12625,45461
32601,8200,24916,42307,1977,61119,88822,6223,18059,26621
32583,9608,66200,78730,6519,72972,84075,3089,45030,64420
32580,1808,69702,91025,1335,73616,92209,473,62109,80535
32579,4382,84375,106869,2939,102485,126501,1443,50196,63567
32578,12684,90964,108381,9515,105305,123789,3169,43482,57383
32577,1942,71600,69992,1373,80476,77851,569,45434,48971
32571,12965,69451,82073,10111,77148,90126,2854,36979,47614
32570,12776,60933,69832,8562,67507,78125,4214,45150,49491
32569,5001,58832,81050,3251,70487,94426,1750,45938,52741
32568,1101,58295,77857,843,82829,92174,258,25909,28585
32567,1398,53125,66184,903,67306,78563,495,22127,38053
32566,14623,83848,90586,11166,90919,96420,3457,47073,61181
32565,2010,57436,73520,1358,72254,78114,652,35500,61430
32564,1100,69643,83030,868,77963,91925,232,0,49749
32563,10520,79157,98233,8186,91880,107400,2334,43333,62873
32561,4543,95906,147097,2792,132192,198108,1751,50402,64603
32550,3915,70842,106297,2700,100722,127049,1215,37382,57967
32548,9826,55062,76273,5359,72845,88865,4467,37543,58692
32547,14232,53236,66146,7794,64360,80544,6438,38483,46548
32544,379,35899,56049,379,35899,56049,0,0,0
32542,842,47250,62513,656,55192,62777,186,25263,61583
32541,8317,84865,120431,4843,98586,145313,3474,57314,83620
32539,10096,56597,67692,7398,63304,76635,2698,26174,39935
32536,8134,72985,84639,5964,83367,95065,2170,36575,48366
32535,1700,36855,56664,1024,56667,70511,676,19468,26728
32534,6321,50690,64130,3562,64632,75944,2759,36260,43693
32533,10553,75985,88116,7695,85245,100196,2858,40565,52793
32531,2404,52378,72924,1485,69946,89841,919,33223,45588
32530,4,0,0,4,0,0,0,0,0
32526,14676,60917,73150,9993,69870,81326,4683,38792,51985
32514,17294,53275,66291,9546,60355,77148,7748,40150,49118
32511,0,0,0,0,0,0,0,0,0
32509,0,0,0,0,0,0,0,0,0
32508,543,50625,65596,326,67857,80089,217,36676,43824
32507,13631,51842,83316,8437,59530,93024,5194,37048,56069
32506,14283,51477,64409,9088,61382,74015,5195,33538,44450
32505,11025,37673,46990,6263,44024,55794,4762,25762,33109
32504,8985,62254,77810,5180,73839,94275,3805,44688,53729
32503,12484,54708,80202,6953,66174,100055,5531,42861,53315
32502,1555,52737,82453,660,92731,125118,895,31741,50030
32501,4516,28479,57480,2157,39914,86103,2359,19130,29808
32466,1808,56219,71323,1217,60417,79452,591,26047,47785
32465,2516,41571,53391,1598,52574,64423,918,23364,32212
32464,1609,47536,52793,1041,49501,62858,568,25366,29262
32463,82,46875,49351,39,62969,65931,43,31042,34316
32462,1462,31421,39639,926,43333,44932,536,22000,26460
32461,16,0,0,0,0,0,16,0,0
32460,1747,39712,55630,1113,48750,62533,634,28931,38503
32459,7730,85652,111023,5475,101250,132219,2255,50063,58400
32456,3619,57872,84551,2474,69800,92997,1145,41866,64859
32455,1663,41637,52543,1252,47574,55660,411,24125,36308
32449,218,0,38467,149,51927,50564,69,0,0
32448,3473,30853,45312,2118,42408,60934,1355,12070,19199
32447,0,0,0,0,0,0,0,0,0
32446,4063,47554,65076,2679,57443,81304,1384,23845,32035
32445,472,44643,50008,238,51310,58887,234,35714,38835
32444,7936,73258,87529,6117,81808,97260,1819,41536,50705
32443,1236,34318,50564,967,40579,55944,269,22417,26257
32442,1513,40717,46165,981,50989,55181,532,20278,28449
32440,2106,40612,58780,1403,51658,72393,703,25836,28521
32439,4024,68076,77832,2749,77788,90107,1275,41102,47621
32438,1613,38878,48598,932,49286,61660,681,17303,28900
32437,310,31618,49917,217,31484,57514,93,32917,32008
32435,2772,45650,61342,1732,51000,63522,1040,36341,53290
32433,6875,47311,60604,5009,57479,69063,1866,25828,33060
32432,0,0,0,0,0,0,0,0,0
32431,1816,45234,60279,1285,64115,73908,531,18657,26931
32430,364,33548,46775,190,65536,64018,174,0,27946
32428,6066,40084,50717,4032,51780,58541,2034,25941,32955
32427,403,30625,39700,190,38636,47364,213,0,32533
32426,332,30745,42664,276,31383,46915,56,17250,21154
32425,4958,36866,49047,3513,50306,57775,1445,17736,25086
32424,2216,39102,60661,1328,56944,79100,888,23430,32161
32423,471,47656,55250,322,61774,66464,149,21661,31017
32421,1592,37377,50514,1042,48146,61554,550,17349,25461
32420,1162,40909,55399,618,51739,67757,544,29145,39422
32413,6558,72275,98681,4416,79826,111297,2142,48438,68587
32410,507,52607,68615,283,71188,76488,224,48393,58304
32409,3791,56789,69214,2748,73294,83581,1043,19812,29489
32408,8702,57202,82502,4989,73788,103065,3713,42008,52900
32407,4976,61450,81862,3147,65142,88389,1829,49471,67350
32405,13232,58520,73363,8448,70136,85229,4784,35088,49652
32404,15098,55363,70455,10388,68083,79656,4710,36537,47655
32403,441,66116,76278,399,66295,76232,42,0,76721
32401,9662,40217,54529,4953,49253,66311,4709,30391,39449
32399,0,0,0,0,0,0,0,0,0
32361,169,0,76041,107,0,45584,62,0,0
32359,558,34106,38176,348,34873,43807,210,33401,28845
32358,658,62850,68747,438,64900,71847,220,37442,60205
32356,0,0,0,0,0,0,0,0,0
32355,167,60404,52071,140,60923,56062,27,22188,24944
32352,2415,41250,53499,1517,57348,69523,898,19406,26256
32351,5934,36950,50593,3940,40938,58107,1994,31279,34175
32350,693,39125,53894,410,49038,65324,283,36250,32291
32348,3761,38963,59920,2544,53525,75502,1217,20417,26653
32347,2583,53344,63103,1971,61685,71298,612,22279,30990
32346,776,44097,66935,449,58652,81281,327,32292,47238
32344,4963,46168,65956,3304,62348,81987,1659,26204,31982
32343,1147,51397,70902,834,71600,81903,313,33603,34353
32340,3923,29057,45965,2148,52500,58397,1775,16520,29922
32336,463,32005,46010,293,38750,50775,170,25417,35025
32334,792,45758,53847,453,52422,72540,339,23633,28194
32333,5116,49583,59666,3196,59819,73161,1920,27154,35818
32332,505,26220,33265,275,33958,40349,230,0,24794
32331,1757,39542,59909,1338,41299,69333,419,24821,28439
32330,272,41429,40850,227,44044,43878,45,32554,25580
32328,1553,48478,79305,1026,58929,95565,527,36976,43792
32327,10018,70660,83705,7435,79008,92557,2583,42360,47466
32324,1918,32500,46186,1279,44792,52516,639,24604,33515
32323,71,0,43207,42,0,0,29,0,0
32322,998,38727,60472,629,43320,72614,369,30179,36821
32321,1721,36461,51899,1149,56156,63443,572,23512,28015
32320,1832,52665,56786,1129,53735,63636,703,33990,44657
32317,5402,91574,109860,4185,104070,121847,1217,42220,61136
32312,12466,102480,135219,9634,117738,155352,2832,55787,63879
32311,8232,74273,97632,5331,89431,111565,2901,46975,69533
32310,5797,37804,52704,3271,46530,62592,2526,22072,35895
32309,13089,83744,103593,9074,105278,122560,4015,43135,57935
32308,10547,63018,94796,4968,91344,130319,5579,47964,60334
32305,7802,43876,59543,5387,47425,65244,2415,29191,37733
32304,19099,23704,31333,3835,32119,42865,15264,20314,27179
32303,20933,52992,71639,10576,66620,86450,10357,40269,54359
32301,13163,45890,54972,5700,56596,67202,7463,36997,44012
32277,12259,48818,62292,7467,60319,71104,4792,34102,45548
32266,3143,95819,121650,1943,107744,146318,1200,59364,81619
32259,17407,121868,140100,15163,130806,147259,2244,53173,76880
32258,13967,84146,112137,10419,93237,124774,3548,59202,67162
32257,16015,65440,88306,10027,81010,99017,5988,40335,65099
32256,21791,65549,91477,11608,82644,111851,10183,51561,65213
32254,5022,31425,42149,2930,41467,52635,2092,19657,26284
32250,12469,94219,129586,6925,112159,159491,5544,63549,88590
32246,21387,61730,76508,12646,68576,86533,8741,50655,58931
32244,22539,54770,62696,14744,62239,68683,7795,34578,45131
32234,2382,70420,78689,1793,74315,88692,589,29018,43216
32233,10003,65873,98404,5858,79660,118534,4145,53484,66477
32228,0,0,0,0,0,0,0,0,0
32227,481,69984,75084,477,69918,74990,4,0,0
32226,5730,85000,99517,4417,93513,112204,1313,36922,47311
32225,19878,74712,92970,13505,87163,105415,6373,43842,61844
32224,14907,76428,109353,8390,106525,142589,6517,51933,64817
32223,9979,83782,108501,7277,93892,122927,2702,43706,61675
32222,4725,67289,75478,3576,77440,82377,1149,33960,50486
32221,10169,66485,82335,7169,73246,89509,3000,45000,59788
32220,4554,68526,75472,3452,77000,85747,1102,38945,40202
32219,4367,53469,61003,3286,53218,62777,1081,52083,52880
32218,22441,57327,72693,15942,68534,82789,6499,35129,44501
32217,8595,50442,79905,4841,69945,104092,3754,36360,47763
32216,16152,52915,74670,8845,66257,94606,7307,36616,47808
32212,222,39628,49073,195,46625,53407,27,0,17778
32211,13606,44186,55244,8493,49140,62211,5113,30595,38997
32210,24886,48756,69323,14929,58818,77509,9957,33496,54223
32209,13824,26568,39500,7694,29163,40424,6130,22233,35454
32208,12550,35296,49230,7445,39899,56115,5105,22890,36773
32207,15566,51030,77891,7787,62492,101825,7779,38210,52732
32206,6587,31526,46091,3218,40847,54995,3369,23215,34722
32205,13859,48292,75222,6728,60768,92905,7131,40736,56311
32204,4123,47513,62087,1079,57297,77947,3044,46100,56175
32202,2265,35947,55015,613,52880,69934,1652,35155,48518
32195,1433,39007,58784,998,68750,72768,435,19432,23581
32193,514,29054,40895,191,52434,69995,323,27925,23687
32190,443,52462,66545,335,60574,82712,108,0,16397
32189,2674,38828,44717,1393,45417,50629,1281,34275,37580
32187,659,36318,51650,400,54389,68205,259,0,24724
32181,1088,41000,42609,533,46625,49346,555,34688,35483
32180,1364,54612,68101,1034,60507,71091,330,45625,55653
32179,3571,31463,44530,1815,44677,56040,1756,23762,32279
32177,11092,40800,56152,6717,50357,66884,4375,22515,35848
32176,7165,50196,92481,3991,69623,125272,3174,32488,49666
32174,23090,56383,77325,14220,68214,92781,8870,32446,51212
32169,5840,81164,103561,2986,94194,131149,2854,52756,73198
32168,12310,54692,79836,7852,72313,93194,4458,34814,52669
32164,18365,57835,78979,13604,60483,87728,4761,37043,48631
32162,31260,64578,77197,21186,76838,86447,10074,41926,57503
32159,15819,46163,61693,9320,58169,71004,6499,32028,46679
32157,148,53000,51180,118,53389,54064,30,0,39837
32148,4343,36224,44963,2846,38523,49380,1497,22179,29594
32147,150,103564,72096,150,68542,59686,0,0,0
32145,2016,47180,80040,1358,60122,99623,658,29329,34793
32141,8633,51875,65581,5505,62773,74304,3128,34792,46374
32140,599,48036,88027,483,41782,92141,116,33333,44572
32139,367,39760,48552,243,36458,50337,124,51122,45055
32137,17568,65573,84240,12939,74520,93091,4629,42990,56525
32136,3981,52708,83419,2538,68102,98862,1443,31964,55392
32134,3277,36716,51007,2051,56127,60730,1226,22328,32545
32133,0,0,0,0,0,0,0,0,0
32132,3887,41724,51920,1937,61536,68714,1950,25271,33124
32131,1832,50000,84828,1060,71406,114101,772,31304,43446
32130,1793,51250,78322,1342,57353,86460,451,31701,50147
32129,10088,51834,60190,5431,62161,72340,4657,34077,41231
32128,8695,76814,91346,6493,102849,107818,2202,35087,40945
32127,12582,52438,75233,7605,69953,91847,4977,29870,47432
32124,1934,71042,79442,1291,76947,87458,643,49180,61146
32119,10033,43038,55559,5515,52078,64552,4518,32305,42410
32118,9111,43385,70083,4341,60480,85791,4770,31945,54574
32117,11249,40659,53408,6049,50008,63547,5200,30350,39071
32114,13290,33474,44966,6152,41608,54142,7138,22984,34360
32113,2036,39967,54052,1189,48978,53889,847,26502,47474
32112,2809,33038,43944,1725,38932,50886,1084,17092,28940
32110,3123,37599,51925,1832,47371,66353,1291,18654,25630
32102,980,45395,67222,511,49159,87697,469,31733,44914
32097,6890,69980,76087,5189,78935,81680,1701,41875,54196
32096,1189,41629,52581,837,43885,63077,352,21568,26001
32095,4483,76846,119118,3327,89721,136781,1156,37463,60319
32094,693,73825,96763,599,76728,104674,94,0,37966
32092,13656,90668,108754,11190,92486,110169,2466,58375,95430
32091,5900,41633,57380,3551,52731,70333,2349,19549,36750
32087,1386,65211,71829,976,72143,74382,410,63400,61186
32086,11575,58714,77175,7566,70742,86568,4009,38832,53963
32084,13011,54519,73214,8492,68924,85281,4519,36405,46101
32083,574,58750,62460,412,65385,59852,162,54048,67503
32082,11719,111746,178335,8133,139350,216437,3586,59286,89752
32081,5476,124821,148539,4677,132835,163406,799,48412,58427
32080,9976,78678,106136,6256,98182,129581,3720,51333,64063
32079,196,55313,62023,109,69821,78698,87,31875,41132
32073,15094,62688,77194,11051,74147,83696,4043,41504,48432
32072,59,94728,100890,50,133056,116386,9,0,0
32071,1167,47540,61752,835,56399,70242,332,19071,37254
32068,19078,67247,83168,15094,68871,82023,3984,37348,70298
32066,1963,51886,58195,1479,55101,63140,484,25375,42580
32065,12482,74406,91896,9694,84641,97220,2788,39693,69619
32064,2450,44505,52423,1401,50212,57219,1049,33593,45727
32063,4417,63728,79027,3173,75838,90815,1244,39107,45973
32062,582,52917,54678,425,67898,68725,157,11334,15154
32061,116,87273,83103,116,87273,83103,0,0,0
32060,8456,46662,66865,6286,57412,78535,2170,21188,27897
32059,1028,41831,48361,659,50463,55432,369,35025,32265
32058,1292,42382,56762,918,46300,62414,374,36944,38396
32055,5914,40838,64447,3473,57520,85606,2441,24507,31283
32054,3497,54931,75378,2495,58528,83246,1002,35076,53428
32053,1463,29688,50794,1138,36775,56003,325,28038,28708
32052,2147,42523,47534,1516,44778,50924,631,25685,35229
32046,3550,59302,70525,2847,63540,76792,703,32008,39389
32044,822,39000,43496,508,39253,45773,314,0,39094
32043,10382,61295,75798,7182,75483,86586,3200,46429,47135
32040,2920,60155,70047,2212,71865,76788,708,31494,43352
32038,3973,37896,54844,2529,46526,63053,1444,25000,38280
32034,16291,85854,116439,11020,109127,138464,5271,47011,67536
32033,1924,67031,82780,1386,80000,93888,538,53156,51294
32026,0,0,0,0,0,0,0,0,0
32025,7959,42848,61113,4393,59782,72778,3566,29066,43459
32024,7016,56216,75984,4890,68454,86866,2126,35795,48918
32011,5318,63203,73333,4190,67390,77447,1128,37400,54261
32009,1384,65250,78698,1086,83828,90964,298,29211,33032
32008,2123,34864,47901,1188,42407,61612,935,16533,29266
32003,11093,101685,119164,9111,114742,130473,1982,51408,64305
31909,14794,60711,70347,9650,75641,80489,5144,41661,48056
31907,21633,45966,59144,13460,57420,68450,8173,32968,41666
31906,8187,30926,56610,4355,45565,78132,3832,21480,31248
31905,3563,57882,71855,3036,60086,73684,527,54653,61072
31904,12847,55334,84856,7746,76571,109896,5101,31305,41677
31903,6788,23750,33231,3518,30273,37271,3270,18267,27842
31901,3155,28825,47869,985,49312,82471,2170,23281,31966
31836,521,36750,53451,360,53654,69495,161,16068,16441
31833,2633,50873,65782,1869,58843,72629,764,27214,47882
31832,107,31776,42447,60,71429,63227,47,0,15917
31831,1159,59632,67582,752,70833,80921,407,34708,40855
31830,758,44265,60519,562,53816,74726,196,0,16359
31829,470,116125,124265,409,116719,128869,61,103603,93395
31827,1001,40506,53181,660,43409,51648,341,18854,55010
31826,879,58633,67404,591,67899,77361,288,32111,42314
31825,1005,34398,62300,610,46829,71007,395,14982,48852
31824,634,26061,40631,369,40096,53854,265,22050,22218
31823,346,68906,69332,202,71318,90769,144,0,39259
31822,2354,47500,69906,1707,65268,82761,647,18984,33759
31821,68,0,45628,60,0,0,8,0,0
31820,3978,101310,126836,3319,108219,131497,659,54714,96115
31816,2285,36937,56771,1539,43264,64445,746,17619,36870
31815,845,24612,45511,429,45647,52666,416,18906,28115
31814,44,57885,56434,5,0,0,39,0,0
31812,292,35682,86178,242,0,99789,50,23462,20298
31811,2030,85521,99724,1626,93864,108786,404,41875,39941
31810,104,38500,43825,82,55789,48410,22,0,11945
31808,3115,91957,128849,2487,107014,145516,628,53886,57454
31807,918,98241,97384,774,103991,103383,144,64737,65140
31806,1813,49297,57219,1458,54881,63167,355,16414,29668
31805,1198,37069,44873,855,37567,48784,343,20927,32525
31804,2170,91719,116534,1929,108475,124059,241,0,43494
31803,2202,50663,60997,1513,59271,72288,689,18433,34622
31801,1288,57381,59952,1074,58237,61820,214,33906,44513
31798,295,38616,35178,187,46612,44782,108,0,18549
31796,549,54375,67733,422,68182,69339,127,41528,62394
31795,681,31414,47465,505,32480,55372,176,22643,20204
31794,10457,40671,54264,6692,49178,63706,3765,27220,35679
31793,3075,65184,84738,2151,79941,98409,924,27222,45555
31792,9190,38156,64323,6234,52191,75092,2956,27892,33564
31791,4565,51869,69780,3533,54844,75366,1032,37394,45575
31790,759,45469,52024,624,56042,58697,135,19306,19721
31789,511,41816,51641,269,48750,59692,242,40450,41683
31788,3219,38710,55564,2312,40227,61303,907,25625,38040
31787,622,43782,67652,419,70547,83307,203,28560,35339
31784,319,32986,54419,229,47841,66325,90,21515,23663
31783,453,39375,44425,319,44688,46251,134,37614,36263
31781,686,33750,50817,486,48636,62067,200,25000,23450
31780,737,33888,47800,481,36979,60173,256,14826,21138
31779,3239,39852,51083,2191,42844,55579,1048,26467,35953
31778,948,41970,64268,594,72500,84004,354,20714,29949
31775,1015,35587,64746,819,39327,74097,196,17955,22093
31774,2385,34583,53009,1450,56111,70367,935,19720,25957
31773,1671,54609,73246,1199,72188,83828,472,40321,41071
31772,215,47083,62541,178,47348,65016,37,0,50635
31771,2192,46264,60857,1657,45807,61191,535,22411,52340
31768,8158,34280,51573,4798,50488,65100,3360,20088,29023
31765,1109,28422,38053,692,42773,47550,417,16669,22169
31764,735,81513,64191,566,83051,73829,169,0,28186
31763,8507,62278,75181,6664,73325,83221,1843,44066,43940
31757,4096,61982,76778,3059,73078,87362,1037,35182,41925
31756,423,0,76511,178,103500,143883,245,0,27563
31750,7063,33406,47204,4495,42054,56683,2568,20464,29794
31749,1006,39881,48833,769,44917,57028,237,10884,20603
31747,77,40625,47881,56,47500,60727,21,8125,13624
31744,1162,58536,72771,745,61641,82382,417,33250,54196
31743,109,70205,60405,99,70432,64898,10,12500,15910
31738,1010,52898,60486,603,71359,77810,407,0,34467
31735,321,33398,37304,191,54261,47680,130,0,22059
31733,507,70515,147233,404,90833,175515,103,17066,35752
31730,3170,37295,50505,1969,34917,54898,1201,40030,42295
31722,190,43015,45636,155,44095,49658,35,23125,27823
31721,8202,68844,89306,5836,78981,99568,2366,45874,61243
31720,153,31750,44405,78,42188,56951,75,21797,31357
31719,3127,35411,52052,1910,47816,62682,1217,22896,34233
31716,1105,43355,61757,728,54940,75030,377,15691,34238
31714,2383,34439,49560,1559,42886,56431,824,28368,33653
31712,445,49034,59026,343,56845,66261,102,0,31975
31711,293,46875,48380,192,45000,49599,101,53977,46062
31709,6153,37360,57747,3719,58358,73471,2434,23701,31443
31707,10432,42646,57024,5528,51627,66530,4904,39684,43372
31705,10873,31071,43766,6790,39120,52655,4083,21059,27182
31701,7366,28949,44577,4075,42783,52941,3291,17263,31897
31699,0,0,0,0,0,0,0,0,0
31698,0,0,0,0,0,0,0,0,0
31650,1484,43276,69602,1173,59653,77523,311,26615,38246
31649,486,29434,57621,303,54306,81133,183,21964,18690
31648,382,37206,63737,249,56250,84310,133,0,24295
31647,1115,33301,46268,861,34647,51225,254,15897,24707
31645,1881,48438,56944,1306,60921,67467,575,25650,29270
31643,3580,34277,54703,2182,43125,69699,1398,17023,31038
31642,1501,43958,56699,1090,51128,66225,411,25156,27489
31641,577,46953,70897,431,61875,70187,146,27578,37208
31639,4097,41566,49717,2690,50344,57407,1407,18588,30689
31638,605,27266,43613,471,42031,46565,134,21250,33240
31637,1093,43977,57663,740,62881,72640,353,18827,25414
31636,4082,47907,65768,2855,65156,79922,1227,21588,31756
31635,2558,27309,46158,1637,48015,59060,921,18267,21935
31634,1881,38420,47535,1346,49839,57848,535,18469,21285
31632,4601,74083,85513,3524,80402,94931,1077,40398,52343
31631,243,54375,56637,162,61087,70343,81,0,29227
31630,235,20393,34824,169,21679,38944,66,16875,24273
31629,365,0,160058,304,87969,184625,61,29375,36951
31627,102,29500,36941,65,0,38060,37,0,31116
31626,1428,42688,73272,965,60799,90724,463,23679,31287
31625,477,67525,70481,374,70417,82714,103,22813,26060
31624,503,31715,53431,329,48264,66250,174,15648,22039
31623,33,24306,27736,30,24063,27807,3,0,0
31622,812,44510,52648,515,54784,58540,297,32039,41378
31620,4091,47669,58280,2682,49433,69585,1409,22640,30654
31606,1219,41659,54991,803,67042,68840,416,25611,27216
31605,8666,61887,78965,6466,70921,86165,2200,42500,52898
31602,13648,42997,64422,7807,55757,83248,5841,24230,34748
31601,11999,26427,41672,6475,38033,52142,5524,18084,26813
31569,2145,63542,72222,1527,74682,86527,618,25881,33634
31568,249,56250,78628,188,59286,84188,61,0,61493
31567,398,29878,46411,331,45159,51571,67,11611,13984
31566,1363,38299,45991,920,51181,53540,443,19750,22886
31565,999,69886,69555,824,75712,77525,175,24485,30305
31563,433,34554,50984,313,50046,57056,120,26111,35073
31562,784,43900,58045,515,54554,65663,269,35091,38920
31561,59,0,0,42,0,0,17,0,0
31560,1075,39938,52367,850,53301,58671,225,23345,28040
31558,8507,63982,75475,5875,70990,79657,2632,52446,64135
31557,1088,51750,66072,780,52727,75399,308,0,42212
31556,52,23125,27860,29,23958,34790,23,0,19117
31555,917,47485,59690,673,57326,70525,244,30250,28359
31554,1735,47375,50850,1287,58229,58053,448,15800,26533
31553,1746,32016,42643,1120,31939,45742,626,25333,35465
31552,332,34076,45189,213,43664,58482,119,9566,19945
31551,345,37628,51658,242,0,56923,103,38342,39288
31550,306,41977,71857,250,45536,81810,56,0,24189
31549,822,30246,72887,498,42266,104086,324,16734,23976
31548,7766,54799,74175,5789,62338,81870,1977,37142,42745
31547,54,87000,85948,54,87000,85948,0,0,0
31546,2569,53491,63606,1855,59272,76875,714,16098,25782
31545,5891,41624,60159,3846,52724,75750,2045,20205,29257
31544,261,34517,50028,187,33185,44477,74,0,41415
31543,1793,0,50163,1085,54625,66875,708,14691,22292
31542,855,41599,57529,608,59000,73126,247,17132,17380
31539,4924,36845,48787,3697,42739,54003,1227,25231,28545
31537,3068,42596,52320,2126,49464,58628,942,23750,36307
31535,4103,46403,55537,2874,56556,65204,1229,23125,30887
31533,6400,38611,52945,3927,48395,66376,2473,20952,30247
31532,267,45469,60767,195,47734,59428,72,0,59529
31527,636,59820,76958,363,65511,94540,273,46858,52428
31525,11240,58514,69273,7383,68903,77414,3857,39368,49183
31524,0,0,0,0,0,0,0,0,0
31523,5386,61485,89557,3891,84331,102291,1495,34542,52277
31522,7763,91825,126398,5319,123253,154141,2444,52451,65743
31520,9107,32150,55835,5562,34472,56395,3545,24164,48875
31519,1472,39692,50886,990,55577,64865,482,21892,20061
31518,277,57396,66335,210,67321,75783,67,21161,34815
31516,5734,48088,64801,3868,53783,78164,1866,25341,32051
31513,5899,37264,54112,4283,47957,62699,1616,19141,28471
31512,756,46875,68257,608,47143,69964,148,0,61241
31510,3179,38417,54926,2086,52672,66024,1093,21838,29523
31503,7525,43361,55963,4761,57674,66689,2764,23570,35278
31501,6404,32023,45697,3555,42564,55485,2849,20712,31303
31419,22670,57244,76181,14308,68113,88620,8362,43003,51637
31415,4054,31417,48543,2521,38480,51593,1533,23188,34433
31411,4332,101008,164775,3057,138180,193167,1275,60125,95051
31410,9744,82622,106843,6549,97027,126633,3195,52316,63075
31409,44,0,0,44,0,0,0,0,0
31408,3238,41873,52771,1809,48109,56401,1429,40425,46075
31407,5401,80865,90669,3605,90092,99020,1796,44902,68209
31406,13361,56268,89059,8231,67815,107537,5130,43697,57457
31405,13815,47980,76544,8261,63009,93565,5554,34420,49786
31404,12328,40973,58509,7300,42593,60435,5028,32635,52519
31401,7751,40862,67758,2990,57851,91710,4761,30466,50551
31331,3267,71328,71728,2317,78342,82789,950,19327,36722
31329,3698,52252,97659,2635,64601,122886,1063,31275,35127
31328,1498,96250,107571,997,118204,126637,501,46806,68025
31327,54,0,0,0,0,0,54,0,0
31326,8399,66953,86576,5670,85801,97265,2729,42734,56686
31324,9491,91018,103183,7383,99891,111970,2108,50141,63934
31323,652,37237,51111,370,46471,67929,282,26745,28650
31322,10017,79858,97874,6246,92860,102541,3771,65828,88054
31321,2696,53613,67617,2210,54816,72188,486,41051,36485
31320,3244,57835,73301,2115,63224,80545,1129,32250,52389
31318,110,84706,87101,75,0,68688,35,0,0
31316,4300,56638,64650,3066,61098,70751,1234,26992,42266
31315,2542,45341,55269,2308,45341,55388,234,41071,50598
31314,0,0,0,0,0,0,0,0,0
31313,16329,50823,61242,11340,54570,64515,4989,41528,49051
31312,6893,79780,91317,5442,90130,103324,1451,33048,43224
31309,301,44306,42843,233,46734,50794,68,0,15600
31308,2919,59736,111074,2172,75209,135826,747,30298,31815
31307,404,71424,82683,378,71630,84208,26,0,0
31305,2979,45958,56827,2004,57872,68825,975,22883,31441
31304,41,0,0,0,0,0,41,0,0
31303,884,68981,70367,686,69758,72852,198,0,58230
31302,3019,47868,63224,1939,61057,73563,1080,30952,43431
31301,2014,39412,51488,1026,53013,63834,988,29397,38529
31220,6015,62132,82782,4036,76974,98029,1979,37879,46061
31217,6057,38559,46931,4130,41250,53080,1927,26423,31667
31216,6121,56750,72391,4657,69038,78807,1464,33804,44381
31213,0,0,0,0,0,0,0,0,0
31211,6286,38141,52119,3376,59104,67225,2910,25822,33626
31210,13459,64067,101278,8218,87992,126744,5241,38202,59686
31207,0,0,0,0,0,0,0,0,0
31206,8730,27667,39957,5467,33496,45755,3263,20674,28311
31204,12124,33729,49275,6623,46331,61187,5501,18041,33507
31201,3542,17670,41976,864,39231,82887,2678,12558,28273
31098,1110,73264,81615,853,73946,83438,257,72618,71504
31097,583,56517,69796,456,57426,79940,127,33802,30947
31096,2628,39813,48712,1758,51493,54604,870,21121,34332
31094,321,47734,51143,241,51012,53786,80,0,38978
31093,11106,38012,50480,6649,50828,61829,4457,26523,32747
31092,2417,46705,63939,1699,52146,66358,718,21613,52873
31091,1475,44659,70631,958,64167,83989,517,31698,45878
31090,458,37000,70694,330,53750,57083,128,20690,28693
31089,1704,33224,56410,1217,42337,69552,487,15165,21746
31088,20968,71903,84481,14243,88278,97497,6725,46104,53797
31087,3140,32574,54258,1959,45804,69934,1181,23078,28144
31085,352,51071,68906,239,58542,78296,113,26875,41247
31084,26,24000,34127,19,0,39326,7,0,0
31083,117,45446,43217,80,50278,51431,37,16083,23978
31082,4178,36881,51572,2832,47614,62725,1346,17017,25920
31081,11,0,0,0,0,0,11,0,0
31079,1097,41949,54639,729,60954,67253,368,20694,29649
31078,1256,30217,48429,770,43306,61312,486,17689,26903
31077,541,42321,46194,345,49154,55850,196,20000,28868
31076,1192,36194,48995,721,47165,60844,471,25871,29649
31075,929,38396,45752,705,39852,52445,224,12500,20667
31072,421,53655,59541,336,54747,67336,85,14280,19373
31071,376,35313,45423,225,30375,49379,151,30729,30989
31070,618,90242,74107,462,91813,84009,156,26711,39312
31069,7860,60735,74014,5339,72419,90130,2521,24213,34738
31068,1442,25925,37516,787,34375,48421,655,18125,23263
31067,109,0,61537,89,78011,72028,20,25000,14845
31066,433,65182,68694,278,61824,81386,155,28194,37145
31065,495,58992,68812,310,63235,84401,185,0,40579
31064,3648,48736,62718,2840,55421,68390,808,26364,38909
31063,1853,43691,70213,1373,47945,59936,480,12391,99611
31062,0,0,0,0,0,0,0,0,0
31061,16091,46458,70164,9704,61471,90755,6387,27900,37348
31060,843,50659,56526,521,58150,63646,322,29375,34830
31058,770,28864,35746,460,32500,42466,310,0,20336
31057,891,22179,54344,479,59875,79477,412,11020,25075
31055,2086,28923,49703,1578,36100,45311,508,13664,54137
31054,491,45078,57562,274,61818,72877,217,30720,38224
31052,3019,71107,81833,2252,84211,91814,767,34676,48144
31051,92,40185,42905,79,40787,47266,13,20536,16408
31050,472,41497,53864,392,41336,56114,80,48039,42839
31049,628,48958,60628,426,51094,64939,202,32917,37763
31047,5394,98333,108618,4455,101180,117570,939,54028,59415
31046,1443,67479,82999,884,98600,89817,559,41332,71735
31045,62,0,0,0,0,0,62,0,0
31044,997,46953,70130,632,75313,96899,365,16202,23522
31042,548,37841,51740,347,48958,66496,201,25795,25978
31041,306,22500,37735,187,26250,44209,119,15987,27287
31039,0,0,0,0,0,0,0,0,0
31038,327,0,65567,265,0,69060,62,37813,41644
31037,902,31346,43092,628,46875,51348,274,12199,16474
31036,4111,43482,65262,2605,65590,82759,1506,27204,31937
31035,455,45125,59830,301,48224,69182,154,32361,38997
31033,890,76543,67214,660,77554,76689,230,0,39113
31032,5513,68488,77806,4293,78157,85864,1220,32417,44675
31031,2557,44736,58623,1693,69228,71621,864,21736,30108
31030,6219,42217,62201,4032,60295,73877,2187,23656,38454
31029,6014,56675,80852,3997,76360,99804,2017,24987,41539
31028,2197,61726,73615,1612,68246,82643,585,43623,44949
31027,3396,37023,55104,2244,43692,61053,1152,18302,35788
31025,541,138584,150879,476,139123,165775,65,0,41794
31024,8850,52682,79609,5885,63163,82763,2965,32627,69844
31023,5554,39843,57285,3894,52206,69015,1660,20053,27939
31022,603,42530,55518,460,45714,62821,143,19375,28252
31021,10062,39844,64898,6577,52383,81042,3485,19174,31227
31020,674,25705,37749,355,0,48526,319,0,25754
31019,962,37417,65762,707,57083,80108,255,15583,25987
31018,589,32072,44950,290,42024,51481,299,19954,37422
31017,602,57500,61223,480,64559,68199,122,20577,24852
31016,595,50125,72643,399,66339,94064,196,20000,27825
31015,7954,37313,64392,5553,43641,68179,2401,20087,51956
31014,4432,43921,54444,3156,49593,61704,1276,25076,34807
31012,436,43654,55396,348,50000,63206,88,13125,20709
31011,316,65455,64605,248,66053,68767,68,57000,48837
31009,451,27417,45445,292,31447,50834,159,21146,29716
31008,7776,60794,69570,5405,75048,80711,2371,26181,40304
31007,399,44250,64309,272,73750,71923,127,17216,47569
31006,2086,27264,42714,1405,28622,47822,681,22768,30933
31005,6327,91195,103480,5334,89804,106948,993,52578,68773
31003,47,26964,35323,27,39688,44004,20,0,0
31002,1089,44219,48699,754,57768,56724,335,18594,27611
31001,819,33938,51343,593,41648,50777,226,17170,51453
30912,0,0,0,0,0,0,0,0,0
30909,16981,56825,76267,9106,73878,96620,7875,46430,51322
30907,18398,70506,92635,11634,84117,110293,6764,50432,60652
30906,19849,36177,50154,13187,41848,56448,6662,26456,35093
30905,851,49960,79706,738,48952,81653,113,57404,66995
30904,10297,35912,58117,5754,50183,73199,4543,27927,37221
30903,277,33598,43324,198,34200,49117,79,0,0
30901,6744,19854,30851,2947,30679,38099,3797,13516,24292
30833,1409,35904,50926,979,48474,58644,430,30645,30484
30830,4412,47653,72557,3268,60217,81955,1144,29167,43219
30828,1652,36786,52213,1124,43769,56510,528,22300,42258
30824,6680,46670,58857,4582,51833,66960,2098,27435,38807
30823,499,52305,64401,384,57792,70821,115,22096,40117
30822,201,0,33629,86,63304,60617,115,0,0
30821,357,42270,76740,276,54063,79064,81,41250,62904
30820,475,35496,41269,222,59457,61321,253,19421,22743
30818,170,48438,65541,86,41154,47562,84,108056,83948
30817,3196,41829,57132,2173,53605,68742,1023,21339,29596
30816,860,52500,62754,533,81250,84824,327,14963,25516
30815,13850,54610,66071,9924,62294,72916,3926,34695,42903
30814,2960,64677,75070,2013,68684,86308,947,28653,38300
30813,13707,75372,88692,10558,81371,93646,3149,55407,70174
30812,0,0,0,0,0,0,0,0,0
30810,742,53500,63108,512,67500,79343,230,16250,26941
30809,15279,112591,127818,12259,121725,137351,3020,61956,82718
30808,1538,48457,55972,1190,50307,61510,348,21149,35646
30807,80,54750,47520,67,55430,50212,13,11625,12254
30805,881,42939,66624,599,45417,63382,282,38750,71809
30803,291,57596,59234,200,59792,68111,91,0,37686
30802,1843,52980,70556,1225,71713,85465,618,25556,40461
30757,968,36477,57582,710,36944,65830,258,31154,34885
30756,25,0,27024,18,0,0,7,0,0
30755,3611,53638,70981,2617,60170,76502,994,26217,54252
30753,2444,40023,49924,1616,51607,61978,828,17939,24890
30752,3478,37361,59358,2383,54337,70556,1095,25883,33858
30751,40,0,28680,40,0,28680,0,0,0
30750,1159,72524,117118,908,87143,132249,251,38438,56504
30747,5851,37160,46539,3611,47458,54790,2240,21236,30106
30746,335,56908,63534,244,58000,69680,91,0,40403
30742,3210,39295,48292,1913,47923,56283,1297,28560,35418
30741,11645,42584,56335,7357,54639,64768,4288,25032,38913
30740,3361,57560,81088,2271,65304,92082,1090,43468,56576
30739,2104,63494,74209,1690,70061,79107,414,24848,39996
30738,1448,50208,69412,995,70353,86601,453,23996,31082
30736,15830,70750,82926,12424,78083,91713,3406,33931,46775
30735,2180,48832,80749,1681,49785,86700,499,27429,59376
30734,1273,47551,62562,944,51855,74939,329,0,26317
30733,771,46211,49465,498,48478,61411,273,12153,23081
30731,970,41413,66815,680,71486,83674,290,24286,27031
30730,662,50286,74751,505,56726,87127,157,21442,31341
30728,7702,41058,50898,5264,50417,60815,2438,18760,26297
30726,0,0,0,0,0,0,0,0,0
30725,1494,57500,67096,1243,63750,73921,251,28750,31465
30721,18206,42296,55083,12792,51833,62662,5414,23879,34240
30720,9749,54639,78239,6851,62069,92419,2898,31885,40156
30711,1497,49193,56043,991,65192,67094,506,30556,33336
30710,2507,63189,78499,2095,70795,86438,412,17768,34000
30708,82,118000,105695,47,0,95619,35,0,0
30707,6598,55047,78633,4767,62667,90529,1831,32475,45332
30705,12208,52472,65410,9399,57884,70491,2809,25879,41560
30701,14547,49960,67523,10645,58464,77632,3902,24283,35814
30683,2691,60020,70268,1755,81274,89515,936,24583,31464
30680,15312,62100,71588,11607,71654,78972,3705,33065,41351
30678,471,52750,81629,392,66000,86895,79,16705,50866
30677,6612,87573,126482,5329,105506,141548,1283,43614,60075
30673,2995,35109,56251,1697,54783,76280,1298,20226,28446
30669,1114,34167,47229,736,45600,55002,378,26061,31011
30668,830,49934,53398,572,70020,66687,258,18200,23635
30667,380,51000,68124,227,72946,86133,153,26845,35170
30666,3199,58784,81947,2577,63839,89582,622,44141,46286
30665,54,0,63263,27,0,110781,27,18015,15744
30664,11,0,0,0,0,0,11,0,0
30663,1161,53563,64324,901,65089,71955,260,19615,32367
30662,3288,41170,52884,1994,47382,60078,1294,25000,39004
30660,428,27000,47318,369,0,49907,59,15250,28836
30656,5755,65379,81362,4267,75318,94386,1488,32321,40046
30655,8582,52587,67770,6304,58820,76653,2278,30267,38545
30650,4521,68013,93488,3315,90022,108131,1206,40116,51101
30648,1086,47429,70645,801,65625,80768,285,40130,39301
30646,2708,52905,60076,2304,63165,63222,404,30000,38946
30643,6229,43645,59515,3865,65593,78709,2364,20979,26534
30642,5689,68156,111550,3848,85593,130768,1841,26996,71010
30641,882,43659,60542,515,76758,84031,367,0,25263
30635,6258,37429,55143,4154,47439,66057,2104,21201,30751
30634,847,34531,44032,630,41250,50778,217,0,18088
30633,2906,50698,65983,2054,60367,78159,852,30313,34896
30631,639,38060,46396,445,36964,51583,194,21250,27373
30630,953,44892,65725,635,64775,84721,318,16200,26902
30629,1893,48295,58615,1130,71081,74716,763,30456,32523
30628,2217,54416,79551,1762,68828,85096,455,48281,55692
30627,886,51818,62651,676,63571,70742,210,17500,34434
30625,1128,64375,81690,939,72332,89921,189,36074,35742
30624,1069,43902,57480,790,60727,66921,279,12169,24727
30623,19,0,54574,14,80417,68050,5,0,0
30622,5193,73663,96385,3893,94621,108581,1300,37900,49367
30621,2116,96957,130480,1842,108700,137825,274,50833,81087
30620,4517,70725,79508,3348,76265,84805,1169,52375,60539
30619,686,56484,62834,499,61811,71793,187,24250,38436
30609,0,0,0,0,0,0,0,0,0
30607,3963,44750,71936,2705,51695,84223,1258,32088,39616
30606,19002,50482,88538,9847,79681,128778,9155,30857,42790
30605,16639,39179,57082,7377,68314,84015,9262,23723,34278
30602,0,0,0,0,0,0,0,0,0
30601,9764,29476,43979,4003,39760,62686,5761,17469,28916
30582,1690,49325,64430,1216,54198,73795,474,31563,38578
30581,38,0,0,9,0,0,29,0,0
30577,8355,44938,56967,5544,57733,69789,2811,18932,28934
30576,1028,51059,74565,733,72951,93019,295,26557,28413
30575,467,55417,72348,408,71190,77256,59,0,38414
30573,66,0,49424,32,67750,85166,34,14018,15788
30572,428,46333,53078,282,56875,67261,146,21711,25683
30571,2010,47286,74949,1477,52981,83442,533,42639,49898
30568,635,46467,92329,251,75766,71855,384,0,105114
30567,1173,55694,73326,948,65000,80223,225,0,40554
30566,2703,49920,77929,1843,61984,82988,860,27431,58364
30565,1767,50904,72141,1167,65865,85029,600,42795,45019
30564,1400,63431,74738,1146,71167,81655,254,44688,40806
30563,1940,64676,72475,1564,71402,79362,376,31087,39174
30562,433,45938,43620,284,57688,52735,149,25078,26012
30560,1980,41179,64684,1399,53806,79626,581,25393,28346
30559,2011,44798,61045,1535,43384,63101,476,37381,49122
30558,1839,49980,60060,1426,54359,64374,413,25313,35369
30557,1976,61860,67700,1457,75625,79616,519,21896,32192
30555,1201,31913,50346,605,48240,73851,596,20833,26017
30554,3006,54660,64455,2197,65160,70970,809,34153,43924
30553,3371,54359,74149,2446,59038,78510,925,28857,59725
30552,694,46111,72167,491,0,82735,203,35417,44109
30549,9056,76742,93196,7640,85426,101673,1416,31613,43310
30548,6839,89766,108016,5454,108188,119983,1385,46394,57998
30547,1185,66875,76055,895,76528,82985,290,48125,52553
30546,3536,52635,66526,2361,60816,80333,1175,32823,38444
30545,433,60469,74970,236,85000,100847,197,33472,43242
30543,1589,66273,80224,1377,68078,86301,212,0,35944
30542,12254,81407,105593,9771,90565,114881,2483,52614,63101
30541,658,60893,95010,438,63661,64895,220,49565,154967
30540,7945,58930,65734,5460,67855,74449,2485,27679,45345
30538,1114,43500,55130,841,55481,68268,273,25000,12121
30537,845,0,53391,402,71786,87207,443,11739,22192
30536,3566,57459,74724,2415,65543,82869,1151,36169,56094
30535,2736,43125,61895,1938,55488,71839,798,21596,35964
30534,11368,68920,91261,8393,85118,103473,2975,40452,51751
30533,9993,54727,79281,6277,69655,92821,3716,24320,53320
30531,3746,58036,70129,2531,64690,82588,1215,26512,40679
30530,2780,55500,65255,2001,67128,75977,779,17218,32439
30529,4606,51539,58030,3214,60149,64875,1392,37870,38108
30528,9343,56448,71697,7108,72837,81044,2235,30561,38834
30527,1412,63438,79157,1147,78882,86742,265,26625,38702
30525,3198,43695,74710,2178,51204,89829,1020,28605,41159
30523,5069,57286,71511,2956,73611,93446,2113,32448,40590
30522,660,33869,47151,432,0,54510,228,34231,33206
30521,1551,56314,74318,1174,65662,84147,377,19777,42778
30520,1737,46563,59039,1331,67540,64938,406,28750,35741
30519,15147,90608,122277,12736,94944,118656,2411,50958,130151
30518,17214,79460,97640,13487,92060,106155,3727,44504,60941
30517,5483,98653,136920,4639,106697,153109,844,42379,46455
30516,943,51123,56341,802,44824,57798,141,44181,43564
30513,5300,51364,70816,3629,60848,85272,1671,27750,38327
30512,9533,50451,72454,6541,65763,88334,2992,21943,33225
30511,1171,55729,71570,867,73217,82347,304,22566,39002
30510,2613,41587,50258,1931,48906,58101,682,25377,26780
30507,8361,53293,67877,6959,59680,70894,1402,26940,38112
30506,15768,80538,107378,11930,91970,118350,3838,42090,66842
30504,8440,54727,79306,6181,59763,82997,2259,35988,62370
30501,10735,53473,70985,6610,60876,79324,4125,34642,54199
30477,1013,32841,53332,579,55030,73352,434,21429,25943
30475,0,0,0,0,0,0,0,0,0
30474,6089,47313,75136,3998,59000,93579,2091,28672,38939
30473,1002,52143,70709,736,64615,83778,266,24083,28581
30471,1616,32218,40876,1042,38036,49960,574,18750,22616
30470,112,33000,49352,74,41500,61042,38,0,15579
30467,4120,38718,58766,2609,56028,72896,1511,21750,33098
30464,31,40625,67352,19,0,40721,12,0,0
30461,6111,61587,71428,4194,76094,84793,1917,30604,38381
30460,0,0,0,0,0,0,0,0,0
30458,16023,43052,60611,8671,58490,80195,7352,24605,35725
30457,2078,29545,57994,1308,53900,75884,770,11698,24784
30456,930,37500,47618,491,64097,61063,439,22417,30563
30455,299,39896,53278,172,60750,76140,127,0,22187
30454,210,33452,44023,132,0,57265,78,0,21614
30453,2697,37862,51166,1861,42321,57834,836,25608,31068
30452,584,43611,61433,400,65192,71854,184,32500,34302
30451,9,0,57111,6,0,0,3,0,0
30450,772,36731,41094,445,49057,48186,327,15494,22111
30449,33,0,64273,27,48750,63833,6,0,0
30448,23,83036,68713,13,84821,89338,10,52917,41900
30446,496,54911,58591,380,60974,65837,116,21667,34194
30445,1075,27340,47453,778,38654,55629,297,14160,25088
30442,3178,25833,35832,1959,38538,45744,1219,14594,19324
30441,720,39167,70926,423,62404,101269,297,21964,26010
30439,4026,37273,54217,2715,44771,57497,1311,18997,42882
30438,25,149306,122780,20,152500,148695,5,0,0
30436,4400,35513,56122,2972,46509,69111,1428,22551,27886
30434,1803,28216,46416,1256,40906,56547,547,14814,21205
30429,34,0,37791,28,0,0,6,0,0
30428,589,33047,48938,379,65679,63523,210,12246,21789
30427,4235,50201,68240,2997,59433,80677,1238,24800,36207
30426,314,55417,60975,173,44638,64377,141,68009,52860
30425,467,53942,59327,360,59444,64005,107,41858,43591
30423,91,24356,32681,70,24773,39196,21,0,10971
30421,1293,46362,63493,864,68813,77290,429,24139,32848
30420,555,34180,46552,349,53661,65310,206,17687,14773
30417,4035,47031,56571,2786,53000,63498,1249,29067,35359
30415,2677,53874,67281,1796,82948,80515,881,34125,38110
30413,646,56389,71382,420,94038,90256,226,28333,35792
30412,34,0,49615,18,0,70078,16,0,26600
30411,1210,41058,43657,663,52898,55837,547,0,28698
30410,761,57008,70128,528,73333,85161,233,26792,35815
30401,5043,39634,47469,3526,43301,52068,1517,17775,31181
30363,2411,60250,115654,641,171875,249703,1770,43640,66518
30360,5331,79255,95581,3795,82244,102903,1536,61083,69825
30354,6592,44547,56779,3704,45323,56234,2888,43707,53255
30350,18441,71996,115575,8858,92081,164939,9583,57464,68069
30349,28684,51010,66035,16770,58565,78093,11914,38515,45903
30346,3197,77125,89815,1061,102135,110035,2136,73163,79772
30345,10912,82072,118927,5616,120983,151507,5296,59035,81526
30344,13566,45095,59057,6497,54728,69702,7069,37415,47440
30342,13580,97154,184846,7324,174179,259804,6256,68201,96121
30341,12707,67726,102195,6939,86250,127272,5768,51402,68727
30340,10047,49679,71777,6004,57746,82231,4043,40726,53335
30339,13502,85878,125366,5121,126821,188888,8381,70805,85232
30338,14751,105810,142210,9174,151772,182807,5577,57200,73868
30337,5490,41638,66615,2824,48988,88440,2666,36706,42131
30336,346,0,0,346,0,0,0,0,0
30334,0,0,0,0,0,0,0,0,0
30332,0,0,0,0,0,0,0,0,0
30331,24959,50613,66875,13812,63790,81408,11147,36421,44311
30329,11079,59786,88005,4654,71719,111504,6425,51150,67904
30328,17663,88917,136288,9259,132801,182542,8404,64513,81959
30327,9904,153549,278577,6284,"250,000+",371838,3620,55972,113274
30326,4409,89476,135598,1164,116250,186117,3245,84323,117147
30324,15412,76205,114641,4535,132917,189484,10877,64226,82526
30322,0,0,0,0,0,0,0,0,0
30319,20604,115597,171253,10631,171703,226339,9973,75140,111471
30318,22893,57409,90768,9766,75842,123211,13127,47233,65008
30317,5951,88046,108772,3409,116232,136740,2542,37254,68061
30316,13867,81013,109366,7133,102007,119016,6734,61176,95398
30315,13265,29197,49662,6569,35865,58220,6696,21219,38791
30314,8136,28114,41498,3552,35870,49072,4584,24305,33884
30313,2640,67147,85791,611,84821,139986,2029,63698,69470
30312,12704,58509,87070,4225,83944,119833,8479,51690,69995
30311,14780,38163,59096,7706,50160,68680,7074,25753,47213
30310,11733,35848,56922,5778,42398,59500,5955,30387,52287
30309,15622,96245,155264,5043,154359,265207,10579,77749,102613
30308,13182,66365,87529,2264,140042,144991,10918,61198,75567
30307,8993,123453,171444,4870,172925,222365,4123,80667,105345
30306,11453,108443,178625,5196,199091,276317,6257,71250,95120
30305,13088,101106,191699,5260,224031,320015,7828,57500,101785
30303,1379,26959,47861,134,75227,104131,1245,26132,41774
30297,9701,36837,46617,6055,36447,49078,3646,29562,38697
30296,9393,55101,67845,6618,61779,75031,2775,37373,45452
30295,1557,66250,74444,1092,86268,85244,465,27946,49014
30294,14660,63646,77856,9808,78911,85525,4852,42976,57622
30293,1123,34960,45849,681,60247,61512,442,16125,21277
30292,1862,56528,73664,1461,68125,82518,401,40568,41159
30291,9722,38606,48479,5342,52930,55210,4380,32477,38506
30290,3066,100938,124932,2623,122991,136941,443,50195,50768
30289,13,76875,71808,10,0,75130,3,0,0
30288,3561,57993,57374,2060,73204,74885,1501,0,32658
30286,8914,38195,52786,5024,54881,67487,3890,23545,31291
30285,219,48508,64685,111,65265,71292,108,33333,57894
30284,29,21736,30769,16,0,39031,13,0,0
30281,26514,58577,71537,18410,68009,79940,8104,45749,48153
30277,8226,100604,120121,6956,106500,128288,1270,52900,62566
30276,6253,86131,104691,5185,95362,115037,1068,44781,48429
30275,29,0,0,29,0,0,0,0,0
30274,12260,45588,54681,7855,54455,62716,4405,29493,35708
30273,5263,56597,64551,3924,65107,71467,1339,33330,38632
30269,13883,97983,132789,10146,125706,153705,3737,54341,75653
30268,3679,55400,70128,2493,65496,81300,1186,40553,44998
30265,13190,92889,109773,9772,106349,119749,3418,55342,78430
30263,22126,65537,86009,15306,81748,97452,6820,37559,47479
30260,7815,50092,57868,5432,55621,63199,2383,31242,38884
30259,1322,85625,108009,1070,101477,121721,252,41250,48581
30258,1151,44494,60329,794,55750,73806,357,26693,27576
30257,1508,55521,76762,866,74953,106652,642,27389,36369
30256,825,78819,81466,693,87132,85919,132,42000,54944
30253,19586,70971,88950,14405,79656,98323,5181,44904,55482
30252,14771,88864,113286,11933,97243,121093,2838,58388,74952
30251,716,46806,61608,551,50292,66372,165,41563,37139
30250,0,0,0,0,0,0,0,0,0
30248,8821,72316,88780,7449,72254,90015,1372,45658,57816
30241,8323,46789,59005,5436,58409,68242,2887,30573,37956
30240,11033,49688,73644,7573,63304,89723,3460,25229,35808
30238,12606,53278,61750,9269,53995,63325,3337,39401,46624
30236,17112,56289,76295,12457,54629,82287,4655,43428,48910
30234,658,47386,61582,448,49063,70360,210,0,41654
30233,8167,51278,72077,5832,63846,78486,2335,35881,49671
30230,3510,40000,55027,2400,57500,65754,1110,17257,30292
30228,13754,70228,81091,10667,77265,89142,3087,33778,46080
30224,10214,59082,110127,7062,62544,137532,3152,31447,45661
30223,14614,44076,57193,9967,52904,65134,4647,26421,36629
30222,1693,34664,48898,1106,45595,62062,587,16957,23326
30220,2083,72243,75223,1557,75825,81224,526,36611,49076
30218,742,82555,79323,658,83157,82278,84,59318,56179
30217,3821,48205,56615,2662,64196,67347,1159,21250,29713
30216,811,39299,54522,596,42000,61439,215,32036,33990
30215,12373,102276,127628,10235,112690,141310,2138,42818,53363
30214,11166,75640,97240,8316,85815,106903,2850,51929,59749
30213,11825,69348,77725,8447,84678,87191,3378,43184,47842
30206,1211,71517,88434,864,82981,106554,347,33882,39790
30205,1167,106131,120245,903,120170,136651,264,42625,63080
30204,4957,49128,59745,2742,63603,79157,2215,29583,34702
30189,14639,92438,113519,11486,105453,123159,3153,61953,71163
30188,24135,83514,101727,17084,100271,117444,7051,47056,60450
30187,2689,66342,90864,2031,74548,93062,658,50750,78535
30185,1514,53429,61436,1183,60562,69240,331,19972,28238
30184,2252,77866,88714,1689,90332,97184,563,28661,57544
30183,2280,71500,100784,1658,104821,119217,622,46528,51627
30182,1319,35759,47552,1050,36715,51828,269,0,28826
30180,12893,75450,84557,9791,82752,91167,3102,42679,54090
30179,5879,68347,75849,4605,74707,75818,1274,42335,50756
30178,1230,55404,68687,868,60000,84404,362,15375,29277
30177,599,56797,64067,443,76250,75066,156,21929,32496
30176,2967,48750,62296,2120,62708,72419,847,22250,35571
30175,2025,67529,72846,1464,65379,79263,561,28244,44091
30173,2165,34895,49440,1521,45019,56236,644,20865,31686
30171,1048,61810,79808,812,69091,82151,236,51453,68326
30170,1073,72610,81928,765,84229,94129,308,29167,46628
30168,8772,48196,60652,5850,53770,67790,2922,36265,42348
30165,14835,57129,76259,10684,65018,86058,4151,31783,45770
30164,0,0,0,0,0,0,0,0,0
30161,13618,46196,70543,8964,63527,86781,4654,26715,36655
30157,16677,68429,82858,12870,75925,92318,3807,40304,47238
30153,6683,48916,65509,4691,56233,75841,1992,27143,35746
30152,15475,101304,126039,12419,114635,139191,3056,48386,65563
30149,38,123750,114482,29,156250,142214,9,0,0
30148,174,44261,51796,130,70431,54616,44,0,0
30147,2171,51024,59506,1747,52781,65226,424,25045,31753
30145,3224,64632,72050,2393,68368,81608,831,37188,41657
30144,21262,72491,91486,13495,89677,105822,7767,46362,64613
30143,8945,71001,84256,6545,79995,97419,2400,33710,45547
30141,9033,75100,88403,6555,77217,89489,2478,53125,59029
30139,1558,56885,60426,1104,64861,70916,454,24611,34437
30137,743,58068,73520,519,70350,82480,224,37763,40763
30135,22235,79409,96177,16920,93542,108145,5315,44030,51802
30134,14360,56713,70247,10577,66604,76752,3783,36240,44653
30132,15671,76722,88316,12346,84311,95483,3325,39131,51934
30127,23344,83532,102202,18563,89501,107360,4781,53580,77592
30126,15856,82244,108499,11303,96827,119292,4553,53119,77904
30125,8749,42728,59969,5989,53681,66961,2760,24936,38594
30124,1283,57344,69812,818,68684,78549,465,31736,51932
30122,10564,52650,67927,6545,63959,79254,4019,37555,45306
30121,9507,60178,73654,6427,74420,85848,3080,35659,43151
30120,14015,65160,79774,10582,71635,88073,3433,36301,49794
30118,0,0,0,0,0,0,0,0,0
30117,13053,48746,67923,8734,63679,82091,4319,30231,38040
30116,9064,62252,77183,6491,75554,90890,2573,32883,36050
30115,14534,96483,112947,12202,102636,121576,2332,47917,62299
30114,20236,81659,101847,15098,91102,114823,5138,42784,59741
30113,2248,58125,65198,1751,72707,73594,497,20069,28885
30110,5454,54357,79785,3776,71425,98878,1678,28021,34773
30108,3175,47393,61780,2245,63816,72834,930,29219,34273
30107,5005,76381,96999,3706,89094,110307,1299,40684,57852
30106,8267,52532,66098,5687,60901,75335,2580,35194,43954
30105,787,49225,65220,587,63203,78168,200,18864,27218
30104,1728,60671,77505,1462,66409,83207,266,27418,33799
30103,5426,50409,65781,4246,64844,74035,1180,25833,32213
30102,14542,67581,84912,10783,78668,93763,3759,39400,53014
30101,19448,92038,113278,15100,105962,127266,4348,44617,59685
30097,16577,103835,146240,13046,125079,164058,3531,52696,75650
30096,25874,59775,81231,16347,70563,94475,9527,45482,54776
30094,11179,75634,86366,8617,83201,90584,2562,54955,65753
30093,18837,44392,55152,11030,51776,59453,7807,36180,45408
30092,15265,60603,97702,9015,88689,125882,6250,38443,54993
30088,10527,51561,66707,6169,64111,81204,4358,37697,43508
30087,13925,78895,102139,9557,91950,114040,4368,57310,71837
30084,13865,72556,87073,8622,85721,97687,5243,54430,65765
30083,20950,42764,55648,12129,50135,62042,8821,32727,43777
30082,11156,80830,104986,6658,103893,122045,4498,59934,76941
30080,26436,75253,103724,13760,87185,120934,12676,66214,82690
30079,1379,55151,68436,827,56746,75056,552,51122,57677
30078,11890,75431,98286,9649,81597,105468,2241,41451,55571
30076,16461,92715,120147,11368,109728,135939,5093,53521,79603
30075,20979,127863,167699,15646,148826,190534,5333,68896,95958
30072,395,57708,71058,245,77679,75723,150,46667,63172
30071,8044,58472,77108,6014,63899,83954,2030,40395,52431
30070,148,17813,26218,54,0,35541,94,15000,19394
30068,12547,125520,158531,9562,154695,186563,2985,48829,65216
30067,19776,61718,101700,10593,80182,134197,9183,48343,61161
30066,21317,94846,119065,15432,113876,140511,5885,50526,57838
30064,18157,97286,122742,13254,117584,144720,4903,41276,59763
30062,23259,106283,128162,17335,127412,146956,5924,53112,68013
30060,13922,50611,69384,8422,57295,76672,5500,38338,54453
30058,20630,55444,68228,13775,65231,77303,6855,32579,44987
30056,802,54103,73615,667,60096,76593,135,23958,53545
30055,1470,75181,84119,1260,75453,86288,210,56250,68381
30054,4181,64354,84953,2719,75234,94188,1462,34742,61411
30052,22797,74875,87922,18208,82227,93440,4589,43533,58468
30047,20946,74671,93860,16486,84925,103168,4460,40709,53764
30046,12872,55050,69747,8873,60831,75664,3999,36293,50334
30045,13580,78093,95289,11602,80771,99337,1978,54945,62373
30044,27771,67764,83611,21782,72929,88798,5989,48935,56653
30043,27655,77437,96301,20961,89286,106944,6694,48798,56447
30041,24438,117605,140429,19890,136919,154201,4548,53994,75163
30040,25317,105387,124531,19820,117413,139120,5497,54509,67722
30039,15238,78311,88345,11764,81331,91567,3474,58878,65024
30038,14190,52435,70789,8413,68413,79897,5777,41021,54026
30035,7746,42620,61554,4634,53727,74971,3112,33743,37999
30034,17239,52806,67506,10574,59958,79497,6665,34659,44344
30033,13607,89178,116568,6752,119808,142002,6855,62876,90669
30032,17202,42404,57872,9532,46186,65963,7670,32899,43984
30030,12359,103083,139157,7390,145032,180184,4969,44914,76988
30028,9972,106673,117869,8549,111385,124113,1423,56118,64745
30025,3704,83947,95283,3166,90106,102246,538,50063,50654
30024,25938,120878,144142,21356,130057,151523,4582,63242,106870
30022,24092,120776,164348,18414,137599,181763,5678,72760,99619
30021,6415,37473,50340,4480,37750,51411,1935,35139,45217
30019,14770,98237,118876,13014,100074,124732,1756,55735,64681
30017,7267,102131,128263,5607,112509,141688,1660,46250,58605
30016,18736,59730,69057,14013,61736,73863,4723,32446,50944
30014,14140,52888,68011,10327,61313,76695,3813,35216,42166
30013,9289,67216,82232,6449,71774,91489,2840,42881,56215
30012,10714,47507,70507,7196,55000,82342,3518,31381,42535
30011,5418,70250,81697,4144,75156,87742,1274,46071,60690
30009,7142,113562,152685,4753,143578,182974,2389,65673,90275
30008,11441,56496,68852,7633,63688,74630,3808,36344,49590
30005,13492,136870,163691,10604,159392,185317,2888,80417,80090
30004,23681,124396,172784,18709,144025,194199,4972,72834,89081
30002,2871,66339,99128,1333,101277,137031,1538,33258,64429
29945,2360,40752,53979,1435,48516,64107,925,27723,34597
29944,1382,37670,49471,975,52452,59528,407,20750,23452
29943,155,33466,40037,104,0,0,51,0,0
29941,242,28311,31953,136,29865,38503,106,25625,19659
29940,1659,43701,67529,1089,58594,85754,570,26646,31195
29939,111,28542,34367,54,0,49961,57,0,19593
29936,5433,38403,52394,3432,41185,61998,2001,20614,30799
29935,1806,50295,61535,903,50125,66051,903,49899,54344
29934,227,38301,35061,132,38205,33211,95,47577,35955
29932,64,18917,79517,48,18796,33644,16,0,217138
29929,350,43000,47728,221,54792,59286,129,21989,26691
29928,7945,85879,150107,4629,121007,198604,3316,60761,81419
29927,3270,53500,65692,2074,61000,81333,1196,30676,33785
29926,11376,88531,118624,7605,107577,134106,3771,54069,84077
29924,1999,41250,51906,1128,55179,67495,871,26508,30492
29923,99,26563,26226,43,30750,31402,56,25294,21463
29922,330,30773,35752,180,30591,40297,150,0,30297
29921,148,95189,74836,105,96203,93479,43,31406,29314
29920,4352,63082,80173,2939,72059,96072,1413,33113,45434
29918,1546,34455,49804,1050,41351,58838,496,20500,25186
29916,773,59973,76530,612,78977,88633,161,0,22917
29915,228,129667,205787,218,129667,209192,10,0,0
29912,0,0,0,0,0,0,0,0,0
29911,504,51250,61935,354,62813,71659,150,30000,33700
29910,16386,77253,102051,11392,84060,114511,4994,55050,71141
29909,9675,75194,99910,7328,82102,114304,2347,35602,53598
29907,5464,74872,101029,4110,86250,112944,1354,35117,54103
29906,9492,52546,66369,6909,60888,72301,2583,32660,48154
29905,9,0,0,9,0,0,0,0,0
29904,0,0,0,0,0,0,0,0,0
29902,5766,60421,84392,3782,75757,94975,1984,43450,62601
29899,0,0,0,0,0,0,0,0,0
29860,6337,76819,93563,5066,82976,102270,1271,41646,54252
29856,1160,45517,55666,995,48310,57678,165,0,43141
29853,2711,33078,47013,1372,44896,58608,1339,28355,34616
29851,2831,53847,69996,2130,62431,78841,701,31350,41505
29850,48,0,14050,0,0,0,48,0,14050
29849,122,42708,39838,98,43438,44000,24,15000,22842
29848,322,38625,52552,219,48125,64859,103,0,26383
29847,1613,53250,82184,1109,76813,102506,504,22868,35918
29845,389,40208,78017,275,48155,99435,114,17440,26352
29844,76,54130,57079,47,53967,56128,29,0,57431
29843,536,47615,52365,382,48654,53552,154,23500,43979
29842,2951,34864,48208,1818,48323,58924,1133,15692,28263
29841,13623,54614,69173,8711,66255,81067,4912,35998,45217
29840,172,36367,38033,86,36233,36551,86,0,39514
29838,191,0,136266,169,100733,144464,22,36875,41427
29836,130,0,51628,80,95069,70574,50,0,21316
29835,2936,50212,57470,1947,66083,68635,989,33681,34345
29834,716,36786,41916,394,44773,47684,322,16759,26143
29832,2168,39346,58947,1353,59223,75757,815,16762,30498
29831,2060,32421,45628,1186,37870,55022,874,28904,31670
29829,4146,58340,74212,2895,78135,87867,1251,35402,41316
29828,274,36346,40642,150,43571,57461,124,0,18871
29827,1257,34441,48587,719,64570,68323,538,14556,22043
29826,148,0,31542,53,33750,42723,95,16453,24417
29824,2661,45750,55080,1645,56956,65447,1016,21649,35839
29821,557,42191,68062,389,58598,73473,168,33404,49954
29819,634,48377,52544,387,49978,62391,247,24496,33913
29817,1745,42785,50140,1103,50746,60165,642,17174,31889
29816,415,32851,30650,239,34750,34391,176,28690,25569
29812,4354,36642,55341,2855,55625,67149,1499,21884,29030
29810,1917,22351,39082,1146,38245,48133,771,18011,24739
29809,1223,46492,61227,842,52292,60964,381,26592,47725
29805,2159,66811,78111,1723,73631,82096,436,28214,58020
29803,15950,67740,87789,11349,83942,100499,4601,40023,53366
29801,11294,43023,60749,6619,56871,77447,4675,23512,35592
29745,12786,59827,78331,9468,67113,89362,3318,30939,42505
29743,560,58700,69954,432,85333,82528,128,21198,24091
29742,1085,41099,52017,668,66944,68750,417,14696,22597
29741,966,52500,56156,779,55156,61673,187,15156,23533
29733,0,0,0,0,0,0,0,0,0
29732,23042,67037,87736,15084,88971,106465,7958,40324,48674
29730,22798,49258,66915,13759,64345,80930,9039,31577,43529
29729,872,39836,62313,658,49000,71403,214,18816,33988
29728,3618,33886,46267,2337,38067,51941,1281,24975,32916
29727,896,40486,48195,581,41302,58699,315,14931,25393
29726,653,52470,73656,386,78500,88159,267,35417,50655
29724,0,0,0,0,0,0,0,0,0
29720,17980,47971,66036,12583,60596,77053,5397,25159,38334
29718,1412,53108,63168,1200,56500,66463,212,25000,36820
29717,560,61333,82729,401,69861,101937,159,24911,30145
29715,12693,86378,106391,9894,97763,117360,2799,49863,63918
29714,1168,52807,57826,870,58625,65932,298,25833,33206
29712,887,50114,82169,604,53289,80822,283,18496,85043
29710,13934,71280,91307,10239,89909,104529,3695,39931,51902
29709,2760,45800,56783,1743,59336,65263,1017,34893,42041
29708,14227,112368,136901,11001,125459,152363,3226,65229,81392
29707,13427,98626,118207,9591,116391,130903,3836,75379,84346
29706,7932,43268,54277,5119,53574,64666,2813,25283,32200
29704,1208,63021,75064,768,72097,82300,440,48100,53498
29702,3520,34561,52029,2200,51467,64981,1320,17926,28340
29697,5425,55673,66006,4228,63278,70051,1197,32872,42451
29696,2042,59853,75238,1597,69047,82635,445,30339,47883
29693,5770,42716,57806,3781,56223,64565,1989,25950,42703
29692,2193,36083,54862,1295,50938,59306,898,24318,46307
29691,4614,41708,54209,3185,48517,61985,1429,23422,34111
29690,8468,55374,74322,6095,71762,85557,2373,24744,42678
29689,1720,52119,78229,1089,65521,90305,631,0,51749
29687,15711,62894,78178,11333,76899,87985,4378,33195,49723
29686,395,0,79852,266,0,101325,129,0,32521
29685,785,63854,124523,609,87375,150740,176,23013,33805
29684,1939,47775,59872,1404,60833,68316,535,30011,32181
29683,173,45677,51535,143,0,53773,30,0,0
29682,1561,53102,69029,1044,72813,89260,517,0,26643
29681,21813,88217,108166,17012,99503,120641,4801,44740,57471
29680,11209,80109,96994,8548,86573,107412,2661,48719,60312
29678,9739,45685,58653,5981,59368,71056,3758,27633,37360
29676,2420,78556,154563,1991,94408,174972,429,25493,59841
29673,11070,59183,79076,8051,65743,88119,3019,40169,51587
29672,5331,57943,93154,3398,91394,122655,1933,25306,40360
29671,6890,55826,68168,5272,63557,77839,1618,22065,34536
29670,4168,65293,80287,2779,86070,100589,1389,25690,36414
29669,5101,50676,60624,3698,55373,65813,1403,31960,38256
29667,93,49375,53030,74,56250,58300,19,0,32505
29666,2526,51122,69483,1934,60455,79123,592,31063,35259
29665,49,0,26824,16,0,0,33,0,0
29664,848,50962,86136,614,56900,99417,234,40625,49134
29662,6495,66055,76172,4351,74250,85781,2144,45750,52948
29661,2260,60100,61872,1436,65676,70422,824,0,46183
29659,73,0,175599,57,"250,000+",219516,16,16000,19144
29658,184,0,82882,119,57938,113343,65,0,27112
29657,5977,57315,78545,4484,73359,80823,1493,29475,69735
29655,2844,42181,55856,2127,50250,66092,717,15744,24147
29654,3679,53048,64862,2741,67832,71806,938,22750,41768
29653,1783,38220,56736,1238,49352,64524,545,30040,37857
29651,18774,64051,87979,13925,77643,101166,4849,29879,46646
29650,13365,81352,104833,9445,96038,120686,3920,50034,64546
29649,10782,48093,76339,6282,70485,96990,4500,34315,46856
29646,11045,34075,50635,6749,45703,63405,4296,19444,29487
29645,4310,46698,59444,2967,53811,68876,1343,28361,34865
29644,7723,58578,73374,5861,68079,79181,1862,28843,45383
29643,1008,77188,94581,780,100523,113119,228,20588,29169
29642,12988,68980,83934,9097,86970,96671,3891,36403,51611
29640,11876,50918,78088,8212,63000,93658,3664,25114,38519
29639,538,42877,51491,376,0,53083,162,40000,35228
29638,1298,51128,64338,889,56544,72092,409,21250,43640
29635,473,56887,75435,381,57426,79030,92,28889,52167
29634,24,0,0,0,0,0,24,0,0
29631,6261,46497,80560,2527,106338,139085,3734,32410,40852
29630,7137,40065,52405,3415,58655,75936,3722,20545,29839
29628,1104,25132,50559,560,50750,45035,544,18114,37391
29627,6641,49715,64080,4454,64073,75888,2187,28435,36698
29626,5314,51021,72819,3985,51482,82633,1329,30191,37144
29625,12034,48269,62856,7392,63374,78015,4642,25403,34717
29624,6272,26961,38922,3720,35888,46829,2552,15129,21899
29621,16706,63047,83009,10874,81147,98362,5832,32699,51683
29620,4841,44448,65627,3300,65417,72026,1541,21504,51396
29617,10823,43936,60893,7191,56869,70932,3632,28455,38790
29615,17148,63135,89131,9533,94119,117604,7615,39536,50503
29614,4,0,0,4,0,0,0,0,0
29613,0,0,0,0,0,0,0,0,0
29611,11699,40047,53555,6986,45873,63189,4713,26009,36140
29609,13024,56055,93817,8426,73476,115983,4598,30805,50901
29607,18134,59053,87959,10184,80266,112374,7950,41784,55582
29605,15074,56175,98993,9849,70397,122438,5225,29761,49919
29601,6093,60692,105882,2284,117206,172848,3809,37140,65525
29596,1010,32143,42102,548,32738,47032,462,24700,32864
29594,109,0,19489,28,36250,37054,81,11282,12707
29593,816,31667,43152,507,46920,56257,309,18125,19817
29592,242,21786,32176,179,35329,37071,63,17969,18268
29591,1873,37481,51474,1251,55406,62794,622,22610,25427
29590,986,30985,43314,687,53734,52045,299,19792,21924
29588,18732,52218,67546,12842,62918,76672,5890,37775,43348
29585,7435,72827,102202,5046,95915,119895,2389,55146,63377
29584,867,48472,49915,448,66154,64389,419,17188,29505
29583,2073,38115,62131,1355,60786,77953,718,19733,31269
29582,8137,59854,86159,4879,75614,102168,3258,42357,61127
29581,1637,37392,49560,1091,47361,58130,546,18106,24792
29580,533,40197,39460,360,41173,48465,173,10048,20721
29579,16891,60234,73765,11432,66092,81883,5459,42969,53482
29577,13712,41452,64515,7605,50188,82383,6107,28026,40056
29576,15774,60363,80078,9950,77423,100847,5824,36707,43878
29575,8387,57561,74102,5093,68633,88292,3294,35289,50825
29574,3850,32392,41726,2414,43185,53094,1436,14590,20362
29572,4827,59724,106948,2631,87871,141225,2196,36308,65306
29571,5263,28264,46466,3456,37161,52986,1807,15425,32063
29570,1193,26924,40430,799,40919,49560,394,16017,21305
29569,6433,39544,52426,4050,46007,61923,2383,22954,32798
29568,6651,48426,59878,4758,49252,66359,1893,33259,38143
29567,154,25000,96608,89,45938,147919,65,20990,24935
29566,8566,51673,65225,4886,64838,74725,3680,34347,51015
29565,2774,37321,53322,1962,54500,65786,812,16033,22765
29564,431,24708,48608,250,68021,70913,181,13920,16840
29563,912,34375,50475,533,45057,63078,379,16335,30798
29560,5471,39653,52142,3085,46840,61310,2386,20408,34953
29556,4889,39320,50763,3076,53340,66020,1813,15612,24493
29555,1964,43333,56990,1387,50750,61584,577,16370,38207
29554,3829,29546,48298,2600,42676,58177,1229,16560,25241
29550,12476,44831,60388,7896,59307,72080,4580,24312,38851
29547,958,36566,55600,547,60547,80259,411,16458,21637
29546,1049,32938,43738,768,43958,53251,281,14487,16541
29545,645,31563,40343,398,42188,43228,247,23917,27432
29544,2063,43149,60331,1410,55667,68959,653,21607,39884
29543,202,0,55279,151,0,55095,51,0,55824
29541,3285,47767,79706,2399,64092,91639,886,22836,27627
29540,1699,27764,39168,1075,32288,48615,624,18883,22417
29536,6128,38082,49206,4017,46534,57927,2111,24875,29568
29532,7918,32813,53500,4791,44037,65331,3127,23502,31694
29530,898,47407,57873,600,57500,64016,298,23846,44496
29527,9693,42126,53389,6641,52067,60788,3052,24841,33088
29526,17088,49082,62476,11139,58727,73772,5949,30545,38767
29525,766,30746,42972,478,47857,53235,288,15735,25144
29520,5675,39041,54074,3656,50952,63176,2019,21395,36231
29519,144,22143,27959,80,48250,39093,64,0,14041
29518,512,28426,37026,290,46354,52984,222,15476,16179
29516,244,33194,38156,193,34097,40778,51,14276,18971
29512,6050,33308,42173,3684,40753,49333,2366,19364,25543
29511,2130,59179,71777,1593,84637,86615,537,17933,24259
29510,3702,37273,61957,2605,49172,75646,1097,16038,25084
29506,6863,40170,50374,4290,49023,61285,2573,20924,29856
29505,9887,55832,73272,6732,68200,82120,3155,31047,50972
29501,18599,56159,79254,11860,71782,97752,6739,35907,45340
29493,55,61250,84285,37,68438,105749,18,0,40167
29492,5756,106803,146753,3623,126101,178375,2133,83084,89302
29488,8437,35507,51362,5032,45698,64106,3405,25230,32082
29487,1030,70000,110878,748,88676,129186,282,0,58702
29485,21548,65042,80151,14619,83546,95089,6929,43020,45957
29483,31909,65764,80866,22867,79308,92789,9042,38781,46050
29482,780,150000,247172,539,166442,302343,241,102109,121332
29481,595,34050,44052,338,42969,53199,257,26563,31866
29479,2622,33301,45332,1770,40946,53499,852,19155,26768
29477,3027,46151,54680,2069,52625,62577,958,25680,36948
29475,1069,30641,42006,645,36705,52121,424,27308,26619
29474,915,40764,47633,599,47125,52162,316,33611,37084
29472,2918,62936,71088,2223,74110,79226,695,28958,37843
29471,571,34872,49193,370,43182,58777,201,30924,31525
29470,1664,59652,72433,1107,70771,82629,557,38869,50931
29469,458,93621,90581,250,120887,127178,208,0,46594
29468,934,30536,39105,698,30119,35911,236,0,47551
29466,14632,110414,154320,11282,137867,178300,3350,50119,72217
29464,23516,95652,126704,13639,125669,159334,9877,61901,80145
29461,14573,66938,80315,10819,79683,89776,3754,37632,49387
29458,1007,41719,68073,511,58858,77845,496,27905,57461
29456,11910,63671,84329,7532,66821,77550,4378,48333,90427
29455,9615,89846,129656,6660,100377,150030,2955,60741,81759
29453,449,29009,44457,353,28843,44432,96,37700,32890
29452,92,38750,39500,36,52500,61333,56,28804,25464
29451,1945,129148,213164,1381,146488,202017,564,105000,239946
29450,1108,40682,56862,734,60857,67145,374,33962,33077
29449,2923,51587,96039,2028,69000,121239,895,23896,38011
29448,792,34918,72357,530,39648,84736,262,29500,45993
29446,423,38625,77195,296,26523,80812,127,45938,65008
29445,20533,65039,80495,14838,76015,89847,5695,45041,51812
29440,10345,42532,62058,7013,53100,74239,3332,27595,34279
29439,1126,83871,105779,603,110826,119877,523,0,63602
29438,1213,63393,98154,911,73656,102090,302,33000,85914
29437,934,51196,57972,537,62928,73355,397,38250,37166
29436,1806,44444,55605,1121,42214,55077,685,45347,54075
29435,1548,34375,54483,1027,40214,66717,521,23688,26299
29434,307,24511,30449,149,35984,42236,158,0,19333
29432,1199,31785,46013,754,53692,61041,445,15804,19361
29431,2634,47368,58589,1951,56093,68299,683,16881,28540
29429,1484,71178,92054,1192,76159,107996,292,17621,25602
29426,535,40306,55208,418,38056,55782,117,0,31309
29424,30,0,0,30,0,0,0,0,0
29423,0,0,0,0,0,0,0,0,0
29420,8537,64149,79126,5887,72477,87822,2650,38921,55477
29418,10353,42015,60085,4770,58951,80987,5583,31540,40077
29414,17198,71875,92343,9334,96676,117300,7864,48514,60994
29412,16315,81358,106914,9889,96646,132772,6426,52839,64208
29410,9537,71291,82313,6386,83608,92915,3151,44929,55551
29409,9,0,0,9,0,0,0,0,0
29407,15654,64641,99927,7997,89495,112792,7657,45602,85316
29406,12722,36624,53377,6662,40353,54723,6060,31982,49836
29405,10735,41739,59519,5404,56197,68958,5331,31077,47760
29404,495,57109,64039,384,53629,63945,111,58939,64361
29403,8811,50569,81620,3683,68665,106623,5128,39002,62408
29401,3936,83701,169820,1758,176765,282182,2178,44655,79017
29388,6808,63505,68133,3910,67040,82421,2898,44130,46504
29385,2818,48989,58734,2112,49443,63364,706,30781,38865
29384,1628,44315,54093,1068,49894,61919,560,25789,35910
29379,7661,40306,56512,4939,52655,65654,2722,22281,31947
29378,17,0,0,0,0,0,17,0,0
29377,223,37348,43942,189,45684,51561,34,0,0
29376,2644,66959,90424,2138,79412,97734,506,26951,46026
29375,35,42813,68094,23,0,53378,12,0,96300
29374,1280,45656,60244,926,48782,69527,354,25192,31723
29373,119,63250,69149,91,97917,88463,28,25000,6382
29372,1845,47110,53620,1241,59571,64332,604,23713,30544
29370,310,56429,57454,182,64063,74571,128,0,30947
29369,5627,77586,89690,3890,90050,107415,1737,37935,46038
29368,56,0,0,56,0,0,0,0,0
29365,3833,60578,72259,2897,71321,81620,936,31219,39360
29364,236,30000,35568,146,37500,40149,90,20156,26901
29360,8055,42183,57763,5498,50195,67083,2557,25504,32949
29356,3534,48514,76831,2149,68160,90183,1385,16728,54928
29355,270,51284,95246,146,75577,80636,124,29286,111615
29353,1715,50673,61844,1198,67173,74604,517,17307,28083
29351,456,62188,68273,335,67993,75636,121,31544,35505
29349,12725,63811,80810,9348,71863,91137,3377,31385,48863
29346,120,39333,60477,77,0,66568,43,33250,37907
29341,7885,37561,52600,3973,56413,69666,3912,24957,33758
29340,7539,36304,49396,4123,53671,66035,3416,20243,26194
29338,16,0,0,16,0,0,0,0,0
29335,2064,37216,46673,1235,55919,61339,829,0,22647
29334,5067,63858,82249,3907,67460,91811,1160,40152,47263
29333,207,44350,79270,118,0,101440,89,57554,49875
29332,1078,38844,54872,787,39626,55783,291,30694,42141
29331,82,25000,13365,12,0,0,70,0,0
29330,3307,46750,59489,2419,53497,66481,888,32833,37665
29329,89,0,31144,53,60709,47300,36,25000,0
29325,5310,38974,60948,3169,58125,79387,2141,22386,32231
29324,79,31125,30868,72,31417,32110,7,0,0
29323,5392,52014,75869,3789,69984,77644,1603,26684,69882
29322,3502,50905,75398,2466,63702,94058,1036,25784,28383
29321,1135,32981,39767,783,32338,42498,352,17011,29120
29320,168,37794,39449,90,0,0,78,0,0
29316,10237,64543,79570,7395,76464,92123,2842,34087,45564
29307,8057,51384,66251,4921,63212,77874,3136,34892,43761
29306,7175,33324,49730,4265,42587,61344,2910,19199,30622
29303,9078,37181,48156,5266,50407,58732,3812,24916,31129
29302,6901,58513,88321,4433,78829,110557,2468,36346,45717
29301,13277,46956,67126,8991,54627,78346,4286,31670,39141
29229,18444,68559,80106,14117,74144,86474,4327,46250,52799
29225,0,0,0,0,0,0,0,0,0
29223,21404,50993,76549,13403,61414,92522,8001,32673,46841
29212,11969,63145,86197,7379,84284,103184,4590,46026,56247
29210,16332,43998,57042,7948,55248,64082,8384,35532,48244
29209,13981,56187,81444,8407,75945,100672,5574,36150,50498
29208,0,0,0,0,0,0,0,0,0
29207,5,0,0,0,0,0,5,0,0
29206,8046,77694,116378,4933,107091,148559,3113,47254,65131
29205,10679,54184,90014,4597,86601,137523,6082,38269,53483
29204,6745,42677,63808,3606,60278,82415,3139,26047,40297
29203,15589,33616,46933,8686,38015,53569,6903,30331,36906
29202,236,100500,122597,26,209500,373781,210,100233,91499
29201,8308,32500,53572,1806,61667,96603,6502,23011,41137
29180,5442,41885,57824,3524,51344,68789,1918,20368,34651
29178,1422,41958,54172,993,56563,62536,429,20944,28278
29175,165,37396,45015,86,0,57013,79,0,25625
29172,4190,50276,60637,2872,57548,67366,1318,37212,41727
29170,8656,60270,70747,5957,68225,79158,2699,43063,48256
29169,10884,43543,61984,4911,62780,77803,5973,34441,47089
29168,1499,36919,49701,1309,40057,52224,190,19907,30936
29166,268,54118,55315,239,53309,55438,29,0,47383
29164,2098,39867,52832,1262,55588,60964,836,20449,40081
29163,485,0,51920,340,51949,68501,145,13976,13041
29162,1152,44771,66654,814,59091,80932,338,16181,29201
29161,4539,40709,54266,3080,48071,61726,1459,29375,36523
29160,3028,49646,63251,1708,63971,77973,1320,30032,42243
29154,11050,52209,64213,7572,57711,70487,3478,36159,47772
29153,6424,49123,64295,3929,68884,78776,2495,21081,37365
29152,780,35675,55186,569,46375,68170,211,17060,20173
29150,15187,40880,59692,9648,52028,74726,5539,22097,31296
29148,2746,40670,51920,1685,58021,61961,1061,21082,35447
29147,0,0,0,0,0,0,0,0,0
29146,511,37303,71307,345,56012,95076,166,14706,20651
29145,241,46205,65842,154,51071,90703,87,20903,21834
29142,1995,32242,42598,1125,52930,54977,870,16950,26076
29138,3870,37009,55488,2854,39806,63114,1016,17441,27815
29137,873,37295,64086,511,47118,60297,362,27237,67815
29135,3588,48244,58183,2415,62317,74143,1173,0,24754
29133,411,26285,35237,184,47500,53464,227,14210,19315
29130,3087,56646,80093,2046,83649,101843,1041,28365,37345
29129,1726,50391,58910,954,56612,77749,772,31071,35482
29128,1903,36095,49226,1034,55956,69867,869,20036,21525
29127,3375,56181,72039,2311,67630,84063,1064,34221,42092
29126,858,54167,90661,644,68250,105703,214,34375,45287
29125,1173,42101,64389,800,60397,61778,373,19049,67675
29123,2601,47876,60331,1910,49481,65512,691,38665,43081
29122,26,60455,53158,16,60833,67519,10,0,0
29118,6117,46397,69567,3936,58803,87645,2181,24890,35126
29117,0,0,0,0,0,0,0,0,0
29115,10469,29176,41631,5871,40691,54464,4598,16175,23119
29114,722,39750,55321,485,54226,66319,237,27375,27876
29113,613,42375,59655,439,70260,72628,174,16146,22014
29112,1740,36591,58170,1083,53375,77394,657,15494,25823
29111,542,66983,82365,443,76681,95901,99,12604,21792
29108,8300,41523,56753,5342,52986,67193,2958,23020,37221
29107,1091,46250,53298,707,44954,58952,384,38214,36887
29105,461,46016,56240,323,54375,65934,138,25500,31535
29104,576,43000,47803,343,49926,58608,233,0,28446
29102,6690,43377,58705,4500,55671,71182,2190,21914,29303
29101,1118,45192,88814,764,52386,65682,354,32692,135021
29082,241,29764,48762,185,41719,54364,56,28448,30021
29081,530,34261,57930,321,34858,65665,209,28942,44814
29080,972,39563,44932,679,47303,53440,293,12554,21139
29079,10,0,0,0,0,0,10,0,0
29078,6122,57409,65090,4155,66658,74060,1967,33606,43761
29075,1082,66029,70563,783,73986,82537,299,19816,36698
29074,113,51151,58176,62,0,69245,51,50885,44720
29073,17813,63602,73282,12748,68561,79838,5065,40027,52270
29072,23028,88585,108667,17260,105108,123448,5768,48758,62660
29070,6006,56884,68399,4517,68768,74878,1489,31215,40390
29069,2041,30542,50957,1263,39408,64215,778,21667,25718
29067,3551,39932,55929,2314,54481,65621,1237,24691,35262
29065,167,46750,40193,87,48533,43399,80,0,36708
29063,14600,82062,99738,11070,90000,109704,3530,47426,60349
29062,61,71542,72275,31,0,72206,30,0,0
29061,5007,53368,67662,3633,62057,73830,1374,32478,41814
29059,2293,34733,46615,1304,52321,57792,989,33198,30490
29058,1481,51010,63568,1108,63676,74043,373,18250,30933
29056,901,38207,53706,567,58586,72387,334,17697,21703
29055,1567,35313,47016,967,48657,61872,600,15192,22280
29054,3726,75294,93771,2805,82196,101150,921,45625,69129
29053,7430,40719,50758,5019,50139,59113,2411,25981,30478
29052,565,50728,66836,495,52034,74312,70,11635,13973
29051,199,45156,49196,148,63289,52101,51,18295,40765
29048,2261,38424,51833,1124,64038,66197,1137,23843,36556
29047,1593,24517,38981,986,32083,42269,607,18359,31323
29046,60,34375,35583,60,34375,35583,0,0,0
29045,10199,60819,80907,7422,72266,92444,2777,34607,45950
29044,2274,50388,59887,1268,76667,79359,1006,24865,33578
29042,1273,35966,49315,833,49375,60288,440,21912,28541
29040,4049,58076,66547,2680,62126,73703,1369,34675,47497
29039,1636,49615,63153,1004,83104,77547,632,37212,39708
29038,1029,36696,47918,616,60600,64297,413,0,22503
29037,307,32417,85870,200,37279,120254,107,13622,21603
29036,9248,97486,126187,7143,112193,142539,2105,43710,65453
29033,5703,53292,62761,2933,73562,78031,2770,37953,44882
29032,1987,45859,56866,1559,49209,62969,428,13661,22950
29031,606,50208,58552,459,49856,60335,147,15813,38020
29030,738,56848,74871,441,78914,93359,297,25893,47419
29020,8739,46602,62169,5612,58617,72818,3127,27218,41224
29018,1313,32981,51996,798,51011,71503,515,12025,20950
29016,9202,85092,96556,6320,113828,120471,2882,41395,42871
29015,722,57813,57102,445,73190,73997,277,16847,28083
29014,577,63803,71623,361,74205,82637,216,48125,51998
29010,4371,29334,46744,2458,48095,63841,1913,16237,23746
29009,838,45242,45805,573,53897,53580,265,28015,28294
29006,3784,48556,57686,2713,57151,62657,1071,34077,42348
29003,2487,45625,53478,1659,55406,64443,828,19375,27524
29001,703,42292,55490,486,58235,67995,217,19432,24100
28909,426,38535,42846,221,39013,51248,205,37887,33789
28906,8837,40962,55010,5749,57953,67259,3088,23607,30975
28905,1198,42075,49814,746,52451,55220,452,25417,40059
28904,4580,46667,70496,2767,60519,84376,1813,27449,47575
28902,449,39063,52000,323,47348,65203,126,14300,16960
28901,2330,40083,48851,1506,38769,51943,824,32266,40104
28806,17280,48111,71646,9363,60868,80863,7917,32741,58498
28805,9110,52059,72768,4233,77400,92292,4877,30173,54203
28804,8994,67759,101955,5072,100900,130427,3922,47730,64250
28803,14866,55658,86223,7222,78320,116005,7644,43714,55521
28801,6466,37475,67482,2228,86000,110913,4238,28093,43912
28792,14801,50137,63615,9543,60507,71730,5258,32775,43688
28791,6646,63827,83201,4361,76775,102333,2285,35497,45579
28790,1447,83026,95285,1147,83208,95545,300,50729,86435
28789,2203,36707,60929,1469,52841,68779,734,25585,44724
28787,8448,59446,77282,6048,72159,87828,2400,41224,46873
28786,9568,48638,67869,5766,67261,81054,3802,31169,47107
28785,3037,58212,76388,2129,71161,85708,908,29375,52928
28783,516,45698,52577,354,47250,58127,162,30577,28381
28782,3384,54949,74230,1958,71369,94046,1426,32643,44821
28781,422,24363,63633,204,43000,54300,218,16776,72367
28779,8292,50649,65189,5093,66932,78491,3199,35397,41312
28778,3851,47895,59206,2311,52728,69065,1540,36607,44209
28777,3614,49713,65145,2186,67529,84397,1428,26434,35133
28775,118,0,62067,104,0,67574,14,0,0
28774,598,107639,127739,362,130250,141208,236,0,107079
28773,1269,58750,71261,879,67595,77555,390,33816,50217
28772,552,55855,62032,349,49479,57968,203,0,69019
28771,3358,41301,52600,2152,50215,60694,1206,21926,37842
28768,3324,54235,70051,2258,82765,88638,1066,19808,29013
28766,433,68798,72125,309,77083,89083,124,0,29360
28763,1012,70851,105030,686,71489,128963,326,37759,51476
28762,2973,42648,58935,2003,55039,71443,970,26367,29512
28761,2913,41156,66065,2029,53598,73167,884,23154,46722
28759,3236,65978,82990,2100,79868,99811,1136,36418,49503
28757,11,0,0,11,0,0,0,0,0
28756,1642,49706,78957,1188,57982,91343,454,30893,41670
28754,3935,45351,72724,2471,69570,94321,1464,23881,33439
28753,3791,43615,56578,2282,67819,74782,1509,17243,27664
28752,12428,48878,61517,9333,54792,68275,3095,25594,35195
28751,1822,51017,64141,1216,59205,72576,606,37981,46277
28749,53,0,0,53,0,0,0,0,0
28748,4526,45096,57321,3160,52042,62663,1366,27794,40357
28747,845,37350,64765,658,39103,61659,187,31602,75224
28746,1187,55875,87438,765,67297,113423,422,24485,39021
28745,211,65027,85245,128,49306,103834,83,65293,56576
28743,914,47083,55735,625,57275,66323,289,20737,30251
28742,1186,67727,83453,935,77123,93999,251,35439,38535
28741,2025,57636,103764,1058,100667,146978,967,31607,56096
28740,414,34408,43650,273,44509,52440,141,16250,26631
28739,9575,59471,78292,6369,74258,93200,3206,30771,47789
28736,318,43939,96392,165,68438,162806,153,26354,24769
28735,145,0,64023,80,82500,93270,65,0,17502
28734,12606,43211,55435,7988,57598,67835,4618,21199,31227
28733,19,65625,60068,11,0,0,8,0,0
28732,7442,67327,85778,5262,79469,97088,2180,41309,56624
28731,3654,59214,74135,2550,74091,86866,1104,28148,39865
28730,3583,61688,88214,2511,81367,96969,1072,29344,62870
28729,1727,72356,87842,1291,87896,98530,436,42391,56013
28726,1377,46141,53374,978,55586,61486,399,31881,31523
28725,9,0,0,4,0,0,5,0,0
28723,3316,36625,45457,1248,67273,69794,2068,24939,30659
28722,2947,46957,66995,1572,70000,83281,1375,28854,46377
28721,4599,53478,64003,2974,70453,77701,1625,24693,34842
28720,83,56250,80711,57,0,99409,26,28125,39596
28719,2822,43490,52897,1926,54534,62017,896,27177,29353
28718,192,60934,64566,162,61386,70123,30,0,0
28717,952,56519,82737,621,67782,99613,331,43029,48713
28716,7637,51233,64430,4999,63462,73506,2638,26900,44367
28715,10100,58686,74974,6940,69952,88290,3160,28098,42358
28714,6967,46019,60752,4783,60815,72501,2184,22711,33939
28713,3769,45486,60219,2580,63672,70502,1189,20158,35927
28712,8748,50891,68211,5685,63856,79808,3063,33982,44455
28711,5750,54808,71794,3309,77386,91240,2441,22229,44505
28709,1128,56328,71970,757,68897,88926,371,28818,33790
28708,87,35469,27469,47,0,20613,40,0,0
28707,79,61827,65516,60,86154,80593,19,0,0
28705,2839,47409,59481,1938,58827,71575,901,25711,32527
28704,7819,67217,96154,4945,84647,116789,2874,42745,59032
28702,188,54643,57980,176,53571,58117,12,0,0
28701,1567,75638,84178,1266,86273,95846,301,25707,31882
28698,1058,37237,57681,612,51111,78614,446,30870,28632
28697,6216,47212,64562,3917,67177,79060,2299,25235,38229
28694,3306,44473,60320,2049,56505,67740,1257,27545,46737
28693,697,38203,54409,448,64167,72899,249,18706,20360
28692,1875,44904,64623,1108,73409,79509,767,26347,42460
28690,4032,49846,64759,2470,58929,79091,1562,25145,40025
28689,854,62125,68302,734,65919,71058,120,39063,51375
28685,824,35474,43891,593,39135,45956,231,21283,29674
28684,945,44858,52725,582,56700,64055,363,26531,34558
28683,479,35156,66086,326,57857,85609,153,20365,24489
28682,499,81935,110533,442,97778,122558,57,0,0
28681,10326,51114,68292,7368,62484,78297,2958,25474,39750
28679,923,46059,65128,597,76250,84248,326,27755,28682
28678,2096,62519,86831,1745,66537,97949,351,22479,28704
28677,13629,45587,59595,9214,57783,68733,4415,27668,37736
28676,1435,50665,91844,1014,64338,94228,421,35428,85630
28675,3182,35984,57597,2098,46955,70647,1084,25977,30303
28673,2898,79219,112780,2130,81167,125225,768,50761,75213
28672,63,0,0,46,0,0,17,0,0
28671,125,37188,44749,78,50833,58391,47,19327,21553
28670,1061,52926,67957,840,74643,77536,221,23828,28713
28669,1219,52076,69616,995,56639,73519,224,22857,52282
28668,149,0,148937,140,0,154826,9,0,0
28667,156,35714,47663,89,0,64761,67,21406,23127
28666,141,0,39994,114,0,47287,27,0,0
28665,1039,35669,52589,696,67500,65858,343,23125,24226
28663,275,44792,57316,171,75927,78011,104,0,23290
28662,116,48793,71285,44,0,0,72,44079,38769
28660,807,53942,62362,652,59113,67599,155,30625,39303
28659,9118,44904,56968,5777,57681,65754,3341,19535,38545
28658,10786,55442,67272,7164,63222,75696,3622,32268,47484
28657,3987,39309,56841,2574,49204,66319,1413,24649,38256
28655,21523,42283,59199,14005,55384,71713,7518,28343,33864
28654,1586,41950,58565,914,48544,68761,672,35794,41464
28652,0,0,0,0,0,0,0,0,0
28651,2776,39077,52432,1826,56176,64899,950,21884,26149
28650,4259,54470,66332,3108,59607,71236,1151,28045,46143
28649,446,39031,97420,437,39172,98844,9,0,0
28647,8,0,0,8,0,0,0,0,0
28646,171,67163,151150,167,67163,149525,4,0,73775
28645,18785,42690,56134,12747,49874,66689,6038,23589,30734
28644,556,27292,40878,415,36055,47376,141,10625,21752
28643,1634,42351,57990,1332,47877,57370,302,20694,59765
28642,2387,42863,57729,1406,61875,73794,981,25018,33914
28640,1992,41014,50789,1308,60714,63015,684,21415,23606
28638,4720,50741,57473,3332,61381,64398,1388,23564,37570
28637,647,40994,58196,416,50966,74749,231,18750,27285
28636,1651,44661,57450,1227,58068,65972,424,19433,26902
28635,1450,36736,50352,1019,55521,61446,431,17708,24122
28634,1864,55200,63352,1388,64331,67596,476,21700,48257
28631,424,33532,48267,354,34884,52091,70,28750,28927
28630,8074,53787,66657,5698,63548,73845,2376,28235,47129
28629,0,0,0,0,0,0,0,0,0
28628,210,39857,54008,164,39286,56518,46,55288,45059
28627,532,39063,42827,293,47440,55035,239,20625,27472
28626,1387,56736,64959,1035,66125,76723,352,25547,30370
28625,15867,52641,71321,11387,62822,81377,4480,30559,40669
28624,705,45448,64407,400,80694,95589,305,18603,23514
28623,545,36420,47335,394,44306,52378,151,32031,34175
28622,1041,36679,45395,743,45781,54593,298,12054,21270
28621,3829,50031,60082,2619,55861,69826,1210,19447,32725
28619,570,55781,60299,323,72396,74603,247,31875,38265
28618,968,54167,69049,597,68750,87658,371,29676,38526
28617,725,33244,43120,491,46875,49654,234,14130,28314
28616,43,88958,90037,43,88958,90037,0,0,0
28615,815,40164,40387,474,43908,44910,341,27933,33498
28613,8888,52624,67820,6281,62542,77923,2607,29304,40064
28612,4851,43417,64646,3440,56709,72742,1411,17141,43037
28611,317,28699,54210,201,0,61447,116,20139,39289
28610,4135,62539,68534,3250,62986,72791,885,42712,47456
28609,2495,59531,69169,1706,79216,86951,789,20417,28465
28607,12966,44736,68918,6049,81151,103228,6917,22080,37984
28606,565,31607,52827,379,48523,66614,186,14487,24506
28605,1673,72734,97105,970,98235,118596,703,47679,67024
28604,3027,53018,80064,1837,71726,101063,1190,32844,45159
28602,11560,47015,60708,7671,57490,69945,3889,25319,38850
28601,20473,55856,79248,13169,73419,97532,7304,31413,43234
28594,1708,84457,110890,1226,96196,126118,482,53158,71732
28590,10225,69489,87587,7407,77418,98340,2818,46853,55172
28589,70,0,95004,53,0,0,17,0,0
28587,144,32292,58688,70,63750,78091,74,15625,40327
28586,2981,39044,48678,1967,46250,56968,1014,21728,32342
28585,1639,35560,52073,1104,60121,64437,535,21563,24764
28584,5526,64889,81734,3890,79030,92889,1636,37898,53002
28583,143,0,61129,55,71750,114485,88,15000,27781
28582,806,65250,81039,639,72137,91273,167,24688,41151
28581,116,103750,110733,116,103750,110733,0,0,0
28580,4173,40463,55179,2782,52762,64750,1391,21406,31773
28579,262,71136,77000,226,81250,82488,36,0,33308
28578,2060,43029,60951,1546,45714,68735,514,30069,34218
28577,82,60417,62620,58,64375,78831,24,18000,23442
28575,172,110417,119767,135,119732,135661,37,37750,48611
28574,6531,48806,60659,4833,52708,63841,1698,34352,48577
28573,757,43490,54162,434,61250,72435,323,16477,28865
28572,2722,52333,65972,1959,63551,73390,763,25926,45051
28571,1265,63350,83593,913,74601,98399,352,30122,44102
28570,8512,57154,72793,5968,69522,85035,2544,27049,41175
28562,16290,61943,85856,10658,85770,104222,5632,31560,49005
28560,11348,53676,65246,7196,62288,76642,4152,28586,43902
28557,7076,56909,78642,3949,81469,101891,3127,33778,45611
28556,474,0,67504,367,82396,79363,107,16086,26832
28555,2059,53569,60135,1455,68393,70434,604,22500,32489
28554,82,30750,44249,34,90263,76065,48,20978,21671
28553,180,112778,91381,135,120417,116383,45,0,0
28552,91,0,32701,70,0,31464,21,0,0
28551,5493,50936,65858,3647,62002,77673,1846,29814,41133
28547,1980,56429,67977,1854,58824,70175,126,0,35639
28546,17429,49773,60970,12064,54726,68851,5365,34692,39799
28544,2218,47845,56355,1658,46048,53849,560,68409,58932
28543,1732,37315,42366,1689,37037,42685,43,4886,12756
28540,18072,49363,63072,13037,57460,68315,5035,37027,46752
28539,6657,54317,63968,4134,66188,76518,2523,30424,41719
28538,973,45405,51887,507,69083,70220,466,24257,31929
28537,29,26726,32324,29,26726,32324,0,0,0
28533,0,0,0,0,0,0,0,0,0
28532,8188,53834,63979,6000,57268,70816,2188,36842,40909
28531,538,53125,60442,372,60968,69379,166,0,34837
28530,2978,33803,48592,1694,47557,61488,1284,26265,30888
28529,896,50395,63036,541,59489,81077,355,19535,34512
28528,222,43478,47669,161,57723,54643,61,29583,29262
28527,519,37022,49679,272,61464,68057,247,21344,29440
28526,1176,41447,43581,552,35761,45244,624,48042,42000
28525,1152,38200,46840,687,50972,60533,465,20740,25543
28524,105,39583,65880,75,48646,79083,30,22813,32873
28523,1047,54732,66282,867,59575,71956,180,30833,38698
28521,852,49357,58342,599,57278,64811,253,32470,37723
28520,159,41042,46162,78,77679,69905,81,21650,23299
28519,145,45750,62388,52,75000,88758,93,32083,47643
28518,3333,53052,61013,2362,63300,69955,971,31195,38836
28516,5287,47577,60663,3019,65256,78019,2268,24101,33692
28515,1015,27566,40267,537,48419,58866,478,12186,18865
28513,3850,53328,58950,2437,61337,68763,1413,33168,39717
28512,1648,67935,93859,926,88846,120320,722,40417,58898
28511,262,48625,82978,201,48188,56572,61,41250,164811
28510,694,55500,91702,470,76081,114930,224,38929,41872
28508,850,55357,70095,653,67785,74743,197,35781,42766
28504,8958,46138,60428,5204,62426,74723,3754,28933,38125
28501,7933,29958,49510,4589,44809,67592,3344,16085,22965
28480,1191,104972,149648,522,158333,214603,669,61125,98890
28479,2566,66133,87581,1775,80134,95615,791,42832,67617
28478,1879,52277,57601,1271,64938,66894,608,27778,36932
28472,7192,36064,51847,4888,43393,61170,2304,21434,28829
28470,5111,49028,61337,3607,60475,70163,1504,29833,35050
28469,3351,75148,91440,2345,83206,106553,1006,35852,54386
28468,2208,59883,81133,1371,77091,104952,837,22708,41914
28467,5930,60982,70276,4185,70379,79561,1745,36612,47481
28466,3880,51362,61047,2547,63405,74901,1333,22007,34463
28465,3711,70646,98592,2271,88565,108861,1440,51250,79919
28464,1003,23098,33577,600,33088,43010,403,12574,19282
28463,2979,30053,56974,2026,44474,71840,953,17726,24783
28462,5634,44616,59610,3618,58415,72028,2016,23143,34634
28461,9851,69291,93102,7442,82227,104143,2409,32781,58069
28460,4687,65316,80006,2844,82000,93682,1843,44609,54004
28458,2216,41183,52325,1545,53203,62639,671,15448,24804
28457,4257,50208,64202,2475,73358,85619,1782,22408,32229
28456,1561,36756,46249,1092,47802,50935,469,30316,33008
28455,983,50083,77550,611,47241,96611,372,57875,46243
28454,1010,53929,65064,611,52465,63242,399,97827,67853
28453,1330,41227,53748,1039,43898,56525,291,30903,40012
28452,271,26719,35374,172,41917,43461,99,25281,21324
28451,15753,60637,73360,10743,73297,85186,5010,32701,46595
28450,914,51316,69457,617,64083,84984,297,27898,36273
28449,881,90250,130933,673,97313,145947,208,60167,81061
28448,310,22969,39688,130,0,59697,180,23594,25237
28447,544,41466,102545,396,43750,86279,148,25882,138123
28445,3008,74297,88175,1901,80083,94791,1107,42865,76282
28444,1053,52154,90441,632,66250,129523,421,24551,31771
28443,8731,72089,98929,6311,87235,113465,2420,42376,55908
28442,637,50491,51762,464,52113,58953,173,21568,30001
28441,1154,31908,53063,746,58333,69277,408,11948,21214
28439,400,27819,38808,276,29333,44759,124,18056,25245
28438,701,42679,46603,556,49583,52600,145,12401,19869
28436,670,59000,64044,482,62639,75587,188,28750,32197
28435,828,35106,48279,490,50500,62546,338,20909,24860
28434,390,56786,74295,249,77902,95123,141,34712,37513
28433,1746,35270,47600,1230,41538,52718,516,23393,33887
28432,524,57750,55038,348,59875,70084,176,12984,22602
28431,3210,29375,52352,1798,51455,58968,1412,19969,43927
28430,919,62974,60329,453,77232,78434,466,0,42331
28429,3250,51472,55870,1998,55984,62973,1252,36333,42960
28428,2923,68542,95644,1745,102120,122844,1178,41358,53269
28425,4138,54303,58856,2771,63047,67104,1367,26281,39395
28424,26,0,35777,17,0,38324,9,0,30967
28423,992,40610,55316,751,46023,58220,241,21397,41173
28422,3385,54869,68768,2662,60399,77177,723,35373,35682
28421,547,54632,85058,394,71970,106842,153,24866,28945
28420,1505,49106,59385,1026,55313,67103,479,37713,42766
28412,17548,55254,80681,9272,79448,108001,8276,41250,48928
28411,15106,74777,101589,10256,92430,119988,4850,45734,59752
28409,13657,88266,119699,9689,103444,144852,3968,43839,55345
28405,14597,54711,77987,8221,78422,98147,6376,38489,50848
28403,18482,42700,65330,7245,71270,97967,11237,33210,43347
28401,10944,39146,51695,4910,46716,60486,6034,28775,42381
28399,815,41504,47615,528,49271,56688,287,27679,29987
28398,2922,32585,43635,1665,42562,52418,1257,25154,30976
28396,1070,46531,59715,726,53306,70885,344,31630,32821
28395,872,55233,59825,566,64531,76575,306,22049,28462
28394,2202,75444,98880,1610,80909,112311,592,32200,57094
28393,728,43636,70343,517,45708,79721,211,0,39935
28392,685,32654,75819,373,61354,113103,312,17679,30344
28391,2252,65528,85556,1499,65884,79616,753,39886,88927
28390,8675,47256,63110,5657,54207,71071,3018,31187,45888
28387,6985,63051,93199,3680,91854,125008,3305,36755,56516
28386,2089,31095,47601,1289,38007,59207,800,18558,26215
28385,824,57174,61169,616,65962,71309,208,0,26163
28384,3831,33382,52612,2375,47238,65609,1456,22188,28308
28383,2870,32174,42007,2028,37952,47899,842,15933,26122
28382,2896,55929,65736,2102,64773,78280,794,21769,28510
28379,10836,41429,53778,7314,53178,64354,3522,19372,29370
28377,4477,32452,47515,2823,39569,56425,1654,19821,28986
28376,15314,53299,67737,10287,65106,80255,5027,28692,38695
28375,94,19550,31693,32,44167,50047,62,18936,22010
28374,8034,90133,120703,5510,101384,140385,2524,52222,76053
28373,1156,62969,64475,841,74018,71489,315,29792,42859
28372,4128,28318,44610,2714,38696,54836,1414,17045,23146
28371,2131,50432,62130,1382,66636,74988,749,26936,34255
28369,926,34149,52687,606,44886,65733,320,18629,24358
28367,58,38333,35847,45,36875,31260,13,0,11646
28366,2041,45121,61906,1312,55833,77442,729,19123,33204
28365,6278,47808,65272,3829,62506,77332,2449,29936,44040
28364,5046,34441,46793,3393,49527,56898,1653,14752,25038
28363,490,43600,56857,279,48938,62203,211,38274,49787
28360,4984,40878,51903,3634,44698,57358,1350,21111,32103
28358,13713,39857,59682,9181,48640,70999,4532,20370,32970
28357,1028,41633,74810,627,55750,99261,401,27022,33641
28356,2016,54198,70066,1331,80551,86461,685,32467,37737
28352,9015,33579,52400,5505,46963,64156,3510,21055,32430
28351,1802,37651,46555,1326,40444,49813,476,20750,27852
28350,48,0,0,48,0,0,0,0,0
28349,1314,39888,54022,903,55875,64869,411,21209,26738
28348,12850,56201,68681,9258,67581,75785,3592,27372,40315
28347,440,31367,47392,295,36827,57690,145,30684,26088
28345,4756,34091,45994,3061,48445,54366,1695,22215,27844
28344,1527,41729,56832,1317,41710,59310,210,37639,36258
28343,572,37065,59946,422,56346,71388,150,20208,24617
28342,56,60625,70038,32,88333,86163,24,0,48538
28341,1369,44410,50517,1082,44434,53394,287,27422,30714
28340,3973,30198,40909,2669,36699,47330,1304,18693,24741
28339,2690,42589,54908,1711,54359,64585,979,22757,36449
28338,1654,49914,61508,1074,66172,79958,580,18944,26855
28337,4241,33011,47073,2740,32692,52000,1501,32691,36685
28334,9139,41114,59769,5632,53482,72815,3507,25304,35541
28333,3837,36088,52295,2717,42250,59678,1120,27038,31417
28332,176,46111,64048,146,67841,68743,30,30938,41203
28330,135,0,28617,13,0,0,122,0,29999
28328,9987,38494,57346,6522,50101,67055,3465,21708,35971
28327,6876,68193,76016,4567,84910,92798,2309,29729,41774
28326,7627,65944,74375,5948,68149,79460,1679,50511,50726
28325,273,41850,52274,208,35789,49671,65,47321,54914
28323,1425,53859,64855,1023,61426,72075,402,33500,44500
28320,4000,46872,61904,2522,57652,79012,1478,25192,31244
28318,1501,49578,74545,1122,68846,86745,379,32188,32978
28315,5202,52359,63805,3074,63594,80074,2128,36228,39917
28314,23273,49643,61674,14116,54842,67384,9157,41542,49646
28312,7833,49019,63886,4902,66146,78382,2931,31119,37949
28311,14503,48131,64173,8400,64964,77518,6103,32237,42946
28310,0,0,0,0,0,0,0,0,0
28308,16,0,0,14,0,0,2,0,0
28307,4641,43654,53257,3976,43256,52605,665,43068,55752
28306,15738,55029,69849,10864,64505,79446,4874,32666,44198
28305,2875,54875,78944,1533,77491,110939,1342,26892,41516
28304,14400,49987,61055,9182,55335,68454,5218,36043,44102
28303,14063,42226,62171,7308,53068,76673,6755,31491,44579
28301,7332,28023,38865,3487,41755,47761,3845,18739,29804
28282,0,0,0,0,0,0,0,0,0
28280,0,0,0,0,0,0,0,0,0
28278,10072,101432,115428,7790,109245,124381,2282,61743,79121
28277,26780,105672,146869,18994,129139,170637,7786,60246,80435
28273,15571,72986,82833,9712,78304,87427,5859,55865,68882
28270,12654,103175,144099,9331,127638,172159,3323,51137,64019
28269,29836,68636,83115,19437,83221,97968,10399,44455,53351
28262,18277,57371,72711,8325,80236,100772,9952,43854,47617
28244,0,0,0,0,0,0,0,0,0
28227,21163,63529,79152,14987,76201,89253,6176,42023,51490
28226,15646,103103,164009,10494,141476,204492,5152,53745,78923
28217,11373,53177,66371,6347,52174,65916,5026,51935,63956
28216,20795,50347,66922,11554,62062,78310,9241,39004,49624
28215,21575,51236,66267,14651,56983,71486,6924,38403,51032
28214,13789,67398,80902,9540,73618,88265,4249,46493,58856
28213,17146,48570,65788,9681,69443,81025,7465,34425,44032
28212,16322,42859,54494,10112,44828,59055,6210,34286,41991
28211,12897,93236,168428,8084,128454,219052,4813,52160,82700
28210,20613,75703,111063,11347,99830,140860,9266,55784,72010
28209,11670,82942,128279,4911,119799,179020,6759,66087,87401
28208,15189,41030,56814,8593,48384,65051,6596,30283,43188
28207,4166,177898,323223,2494,"250,000+",479236,1672,65729,90171
28206,5265,33718,47998,2381,39640,48435,2884,28395,46411
28205,21075,56196,82355,10110,62564,94330,10965,50164,68074
28204,4516,70000,104908,1038,135682,185258,3478,63030,80810
28203,9680,87725,125976,2776,156288,213626,6904,73976,90372
28202,7528,100709,129714,2358,132414,172089,5170,86408,110093
28174,2880,53521,66341,2124,59808,76496,756,22225,34235
28173,18077,130705,170349,15905,141563,181603,2172,51741,67056
28170,4872,32658,49768,2747,44743,60305,2125,25583,35972
28169,61,42750,39477,50,47778,44850,11,25000,0
28168,4126,54747,62944,3372,58914,67707,754,28500,38217
28167,906,50722,63474,688,56034,69782,218,0,34800
28166,3807,65344,84152,2870,77500,94623,937,30760,45013
28164,6214,65511,82912,4844,75994,89469,1370,37604,54749
28163,1893,63890,84793,1466,76667,96151,427,34479,39700
28160,1614,30943,44142,948,46528,58273,666,18556,22476
28159,1088,53495,61801,744,51842,51621,344,52708,79600
28152,8802,44880,58783,5969,57041,70366,2833,26650,32795
28150,10888,38492,54120,6907,51758,66723,3981,20966,30549
28147,8426,52268,67472,5958,61585,77309,2468,33041,41318
28146,11941,56553,73409,8272,66590,84183,3669,32833,44850
28144,9750,45161,69432,6024,56914,88945,3726,23489,35175
28139,8840,46270,59425,5613,52169,68922,3227,24307,39228
28138,3840,48214,63638,2638,65139,77310,1202,22468,32647
28137,1080,65902,67879,782,69841,77911,298,25357,40126
28135,1619,50075,58172,1037,54130,70557,582,26290,35430
28134,4163,58861,77835,2660,79115,94288,1503,40650,44535
28133,1041,54938,81408,656,83986,91915,385,39430,63503
28129,2438,61250,67604,1827,69041,77703,611,29766,32895
28128,2779,55060,71606,2028,62148,83782,751,30729,37314
28127,2654,62330,103491,1884,72857,127342,770,31447,44068
28125,1120,69059,82960,891,81838,93603,229,26615,33555
28124,2372,65658,82464,1802,74375,93060,570,30441,41654
28120,8516,58995,77030,5918,68370,87842,2598,38947,49960
28119,1116,45197,47177,567,49087,48040,549,35104,42095
28117,16369,92518,139097,12175,112424,159526,4194,55391,76676
28115,13646,67923,85666,10124,76319,96498,3522,33038,49091
28114,2763,47400,63486,1868,63949,80695,895,19361,26267
28112,10071,52471,70889,7148,63703,81284,2923,28895,41028
28110,18325,69351,82536,14222,78161,90370,4103,39439,49708
28109,163,26460,44060,19,0,149279,144,26261,30177
28108,44,0,0,25,0,0,19,0,0
28107,2794,81351,94558,2268,92982,103302,526,46810,54177
28105,17849,86463,104894,12599,106761,123634,5250,43042,56282
28104,10561,108599,140169,8883,120317,151594,1678,49545,73258
28103,4101,61344,68773,3078,68938,77892,1023,31053,36751
28102,28,51667,76786,23,0,83983,5,0,0
28101,547,63750,88860,327,109160,118343,220,24464,41529
28098,1493,43596,63052,820,74130,76064,673,24587,34849
28097,2454,55820,70495,1635,81440,85993,819,32382,37794
28092,16203,50548,63319,10566,62169,73578,5637,27792,40974
28091,965,33016,43932,591,55156,58243,374,19643,19990
28090,3038,42032,61612,2178,54113,68564,860,20774,42082
28089,25,0,32964,23,0,32322,2,0,0
28088,839,56635,61578,571,77632,76335,268,30000,30136
28086,9754,50106,58138,6554,58789,67704,3200,24269,36163
28083,9112,49527,60200,6210,54855,66784,2902,32006,41640
28081,10312,54041,78036,7488,68107,90272,2824,27392,38674
28080,2730,57350,72696,1993,72058,85497,737,24075,34957
28079,13517,84301,105017,10562,96122,117742,2955,47054,54117
28078,22902,101752,124226,17113,117666,139463,5789,63369,76051
28077,244,19783,28311,150,25556,32161,94,13929,22079
28076,210,40192,42630,168,41000,46699,42,0,0
28075,6017,110906,122268,5155,124225,131675,862,53426,63062
28073,2244,44688,52397,1632,45377,53233,612,27794,37649
28072,513,44044,48574,396,48667,52502,117,23750,26562
28071,1106,59556,64634,629,74219,78328,477,41424,45633
28056,13512,73249,91135,9738,88325,102948,3774,36045,57290
28054,15247,45682,61419,8728,64295,77644,6519,25761,37529
28052,13086,39507,51848,7921,48905,60926,5165,26433,34395
28043,8442,35993,52924,5361,44753,62450,3081,21665,33791
28040,3069,47803,56367,1866,63786,71782,1203,25648,31342
28039,29,23854,25776,21,24688,30500,8,0,0
28037,8950,87096,127034,6728,104463,147496,2222,33409,60080
28036,6527,116213,154215,5052,132794,168631,1475,57461,102487
28034,6703,53514,63437,4637,62452,76615,2066,21610,30588
28033,1080,43850,56127,703,53050,59045,377,41102,47881
28032,1282,74125,92137,838,75944,108254,444,27256,43256
28031,11813,89658,140174,7760,125766,172519,4053,48101,76568
28027,23676,77367,100151,17266,88967,115935,6410,43036,54185
28025,20151,58257,82434,13802,75514,96694,6349,40130,48855
28023,6051,52424,67619,4100,61747,79806,1951,23299,35766
28021,5582,46864,62985,3714,68069,74508,1868,23613,35653
28020,772,45385,54770,623,61406,62134,149,15950,18471
28019,0,0,0,0,0,0,0,0,0
28018,1795,48445,71418,1242,65208,87760,553,22295,33104
28017,0,0,0,0,0,0,0,0,0
28016,5168,47353,61736,3751,56891,69011,1417,26727,38884
28012,8821,72399,104024,5916,86026,120294,2905,40021,63775
28009,447,32031,39978,283,40750,45973,164,18889,24825
28007,249,43958,57118,183,36607,57953,66,50455,48664
28006,565,44267,59638,433,43750,63728,132,34875,43402
28001,10814,50813,64235,7320,65274,75335,3494,29393,38505
27986,537,42212,56448,325,54417,67296,212,20357,36270
27985,148,33750,39786,77,47639,57544,71,16528,19661
27983,3291,33475,50846,2059,51250,64881,1232,18406,26329
27982,31,0,127097,12,0,0,19,0,0
27981,809,58984,66222,564,61932,71774,245,26820,41067
27980,990,63865,68893,770,64662,73371,220,43417,53221
27979,558,44263,63628,305,63380,77632,253,41806,46411
27978,96,36250,44482,62,51346,55116,34,20625,23021
27976,1562,75164,76915,1362,75981,81581,200,29390,41875
27974,467,53287,64426,399,54398,68568,68,0,38160
27973,555,59861,68636,364,81932,85065,191,29727,36432
27972,39,49688,73300,33,65568,80942,6,0,0
27970,1375,30160,56545,871,46763,77184,504,16269,20383
27968,110,55000,70027,46,0,106111,64,0,0
27967,58,36750,46341,34,49500,60950,24,25000,25646
27966,302,0,43790,227,57566,53632,75,25000,11035
27965,167,80302,64807,56,0,68411,111,80733,62989
27964,339,56952,70448,227,56382,73473,112,78056,61495
27962,2993,27266,43520,1367,45819,61294,1626,18500,27683
27960,410,0,42251,240,59205,49198,170,22083,32444
27959,1354,78235,92911,941,95805,111709,413,39292,45319
27958,4513,88586,101082,3550,97370,112579,963,41354,49401
27957,581,0,93555,334,0,132764,247,25000,40536
27956,157,77563,87022,157,77563,87022,0,0,0
27954,2810,53429,71714,1841,57140,74017,969,42473,63533
27953,420,46786,55845,237,57102,71064,183,0,36135
27950,901,61188,70947,638,90227,84158,263,34306,38759
27949,3262,87571,123492,2363,102292,139520,899,55994,73961
27948,5341,67227,78872,3288,84254,92217,2053,43125,52270
27947,502,77250,88337,284,100000,110900,218,51250,58173
27946,553,80362,84201,293,110102,101743,260,46364,64433
27944,5207,51085,66450,3763,57188,73327,1444,32370,47297
27943,171,70721,63369,118,75833,65374,53,0,0
27942,205,45417,46447,142,40938,43645,63,0,42941
27941,132,53409,58177,53,85208,87734,79,29861,38348
27939,1220,62992,72714,769,86432,90894,451,0,40836
27938,683,39803,46069,382,41175,57272,301,28958,31374
27937,1560,46129,58753,1087,61133,68443,473,25583,33875
27936,424,35916,48509,219,62989,58993,205,35659,36734
27935,638,66154,66274,512,70097,71408,126,29250,36341
27932,5383,41640,55761,3353,46890,63965,2030,29417,40642
27929,706,99537,104296,526,102763,117000,180,0,65117
27928,881,37261,52980,559,48052,63487,322,19839,33638
27927,548,65000,90427,369,67266,88889,179,39152,90822
27926,762,41690,64366,544,51731,72546,218,40516,43955
27925,1594,42683,52407,1075,52151,64872,519,20446,25586
27924,1491,33592,58015,910,55417,74607,581,20125,30905
27923,284,55667,71061,100,62083,98539,184,53415,55544
27922,213,47188,58622,154,45000,55690,59,58250,65393
27921,1757,62817,73335,1367,68517,83027,390,34818,34546
27920,600,59359,74954,472,47069,73865,128,47143,53400
27919,483,0,55800,209,85975,80989,274,16978,36587
27917,288,32321,54426,175,0,37853,113,0,78872
27916,374,66083,70125,260,50833,64347,114,85323,72890
27915,363,26729,31782,88,48864,50786,275,24009,25701
27910,4713,38854,51815,2824,53780,65070,1889,23178,30849
27909,14791,54455,69059,9831,72226,83460,4960,26199,37039
27897,727,59279,55709,562,61806,58649,165,0,45562
27896,8066,63026,82541,5604,77617,99932,2462,34942,39975
27893,15626,34401,47582,9202,46619,59074,6424,20602,28852
27892,5774,40259,58572,3879,51672,69875,1895,25903,32073
27891,1886,49490,55188,1325,56929,65815,561,21359,29451
27890,990,36058,50737,774,38214,56371,216,22885,27515
27889,11282,44056,64072,7313,54203,75851,3969,23898,40255
27888,783,36164,46035,412,48750,60237,371,19766,28070
27886,8481,41869,57198,5555,48570,68020,2926,23174,32620
27885,572,48029,50005,456,50196,52182,116,25370,28206
27884,461,63673,71609,343,73250,81830,118,52667,41900
27883,1248,49412,60588,821,61042,76849,427,22232,27241
27882,2932,45385,56301,1929,53003,67656,1003,24158,33278
27881,23,31750,45061,16,0,48594,7,0,0
27880,1613,71899,81443,1243,83488,89592,370,0,46619
27879,142,55278,56915,104,52500,61933,38,22000,35305
27878,650,31442,61480,418,45909,79992,232,0,26938
27876,733,40253,55951,328,42926,84041,405,39330,32567
27875,205,0,52313,157,80719,62118,48,0,0
27874,2017,27437,43575,970,47473,67234,1047,15799,21227
27873,158,0,47044,106,57292,61820,52,15000,16925
27872,243,0,32464,124,48266,45732,119,0,17099
27871,1911,38648,46553,1285,49536,54171,626,25909,30847
27870,10354,38209,53603,6730,44830,61411,3624,24970,36511
27869,786,32883,42049,444,34566,52832,342,18587,28050
27866,302,62031,58573,220,60313,64151,82,0,0
27865,826,74318,82808,569,114556,108093,257,12046,24626
27864,1985,43399,53973,1438,51875,60497,547,26509,33057
27863,4928,70714,89509,4096,74239,95533,832,34167,42406
27862,454,48182,50034,273,56279,62963,181,0,28286
27861,34,23393,26244,19,0,26826,15,0,0
27860,773,65821,62670,558,75714,78134,215,14712,22486
27858,22205,49996,70691,11228,69784,93962,10977,33214,44532
27857,523,44938,54473,370,50298,63312,153,33170,33097
27856,5893,57532,72426,4430,66037,73167,1463,29473,62715
27855,2391,43842,59199,1319,61458,69274,1072,30724,46535
27853,171,32917,48774,118,32833,60468,53,0,0
27852,1290,54934,65890,849,63256,64236,441,30028,39712
27851,1959,45842,63078,1384,59423,74874,575,28722,33710
27850,3387,47188,71990,2425,60991,82343,962,21486,45333
27849,732,37103,50942,409,44710,72013,323,27868,23685
27847,308,22885,32592,95,41761,55468,213,16058,22257
27846,1191,43683,59043,578,56167,74134,613,28542,43071
27845,952,40631,55926,693,42266,53119,259,20625,25905
27844,1304,30909,56417,810,46222,76441,494,12500,23185
27843,393,40341,41099,238,41429,44034,155,35662,31459
27842,857,66411,82255,597,74250,86261,260,41250,71184
27841,22,16250,25064,19,0,0,3,0,0
27840,145,35521,50775,90,51458,70471,55,14226,18544
27839,1404,33390,49821,770,50650,52311,634,16852,46798
27837,2694,74146,89408,2237,74554,96000,457,37008,55534
27834,23798,40138,59757,13974,46755,69148,9824,31301,44988
27832,1258,37753,51136,750,38226,53454,508,28988,46103
27831,1278,30114,36665,737,37341,45252,541,15801,23760
27830,1781,45718,57758,1260,46136,61891,521,41169,45785
27829,783,48038,50391,369,60917,65669,414,43000,35961
27828,3746,52121,63401,2591,72471,75370,1155,25377,33781
27827,83,78299,66743,76,78443,72191,7,0,0
27826,159,32756,37116,101,29728,32315,58,0,45478
27825,38,36875,53684,19,0,46968,19,0,44842
27824,522,45556,52136,379,56250,58271,143,38417,35875
27823,2878,29815,39803,1974,36467,44098,904,14063,28007
27822,3225,47702,57795,2209,62559,66862,1016,24333,37416
27821,86,25526,26285,13,0,0,73,25099,19989
27820,865,47775,62339,571,52101,76195,294,32625,30863
27819,147,31589,41510,118,31523,41597,29,32292,41152
27818,724,41445,39360,348,43939,47270,376,32708,27813
27817,3272,51820,68764,2324,69929,78922,948,32399,41571
27816,1281,30365,43930,1127,33150,45378,154,25988,32543
27814,698,70078,72589,495,79489,86514,203,34688,36664
27813,297,47212,55765,191,65417,68115,106,20278,29008
27812,1120,41397,51356,693,53688,58647,427,25417,39346
27810,1896,42904,51465,1027,60341,61032,869,15933,34978
27809,1760,52036,84529,1208,62347,100991,552,26667,46228
27808,897,86531,105733,562,99271,133827,335,40583,57544
27807,2320,47742,63332,1503,68084,74850,817,23554,38797
27806,1126,34787,48402,786,45435,56077,340,28889,30049
27805,1578,45221,52716,1036,51284,57609,542,30556,39375
27804,12488,50792,70435,8190,60369,83413,4298,36021,41173
27803,8075,46614,65687,4985,62392,85577,3090,18684,32344
27801,7414,37539,47781,5309,42201,52478,2105,19133,27934
27713,23116,79009,102628,13777,103657,123971,9339,53632,67768
27712,9044,84199,109635,6940,102321,126431,2104,48311,52179
27709,330,152250,147310,226,162750,181198,104,44365,73668
27707,20974,56215,85601,11349,71870,109465,9625,40754,53309
27705,21021,53879,85146,10157,83091,117060,10864,38822,53295
27704,15586,50631,62677,9269,59152,72578,6317,38041,43769
27703,22120,70440,85875,15072,82718,97901,7048,45569,55896
27701,10354,44510,69905,4475,50788,87601,5879,40606,54035
27617,9534,86859,121260,4247,119328,153918,5287,66240,94723
27616,19979,66578,81569,13923,76868,89870,6056,51352,59338
27615,19224,88894,119964,12707,111220,145472,6517,53945,67418
27614,12541,107588,152395,8720,136953,182686,3821,50568,79968
27613,16836,101806,131662,11782,129529,159543,5054,51278,64201
27612,18988,81681,113119,9711,129934,156342,9277,53069,66547
27610,26381,54072,65820,17908,60520,71502,8473,37211,47583
27609,16475,67130,101186,8471,106215,137424,8004,48251,61532
27608,5074,119211,174255,2940,168333,229976,2134,66786,97048
27607,9076,79134,119358,4272,140238,175420,4804,49968,66757
27606,18933,62204,85175,8809,84313,112357,10124,45796,60187
27605,3551,59508,115969,882,138357,204968,2669,53694,85687
27604,19107,69644,85673,11012,75686,96135,8095,56821,66711
27603,21301,72775,96759,12591,88610,116898,8710,44275,66068
27601,4271,58144,91191,1748,68929,111290,2523,54176,73026
27597,9385,66007,80597,6941,72376,89647,2444,43917,51369
27596,7155,81028,94750,5594,90365,99949,1561,41607,64456
27592,6003,74496,86816,4853,86793,95819,1150,41007,46476
27591,7595,65776,80036,5491,71957,88303,2104,42305,53403
27589,2938,36515,49873,1894,38932,55543,1044,28571,38246
27587,26266,103434,125308,20082,114181,133864,6184,55957,91862
27583,2668,63050,72253,2115,75130,79912,553,32679,40776
27582,181,0,58190,141,93533,67335,40,23000,24988
27581,1286,60263,81393,998,65625,89360,288,45000,51488
27577,9473,46949,59788,6096,53869,71200,3377,26006,33836
27576,6786,41250,56842,4613,52311,68613,2173,18804,29718
27574,5893,59402,69493,4161,75595,82105,1732,23750,37947
27573,4889,43644,66546,2678,59234,83633,2211,25688,41666
27572,2812,85227,95179,1993,83592,90928,819,44063,62793
27571,2369,117911,117277,2116,130200,126118,253,0,42549
27569,3244,53062,67245,2523,65024,75816,721,20906,34800
27568,255,45625,54364,137,77344,69917,118,25556,32294
27565,9931,48035,64262,6605,54695,73954,3326,29737,43287
27563,2207,34087,49235,1267,46619,64536,940,18750,26007
27562,1198,121389,112389,843,142962,133427,355,35903,60949
27560,15172,98049,117137,9578,118452,137455,5594,74870,79213
27559,1066,56250,81913,889,64926,88973,177,0,29884
27557,2733,47344,65265,2142,56280,74066,591,19916,30482
27556,126,0,73110,66,0,36098,60,0,113605
27555,271,26813,44361,188,35469,52586,83,12734,25730
27553,858,29681,45302,516,38929,52328,342,14647,27762
27551,741,52014,78262,464,80758,95744,277,27139,38913
27549,9680,51109,64092,6927,59608,73396,2753,27630,37661
27546,6731,52346,62774,4403,70908,77529,2328,25878,32522
27545,10097,68003,84490,7118,79151,91601,2979,48282,61096
27544,1870,60534,68624,1296,65250,75392,574,36579,43753
27542,3765,51843,63464,2765,55087,68048,1000,27852,40795
27541,1571,61343,86728,1027,81402,98426,544,32938,59662
27540,13045,110692,130342,10940,120323,141844,2105,53350,65640
27539,8022,110579,126004,6115,128527,142229,1907,61003,71465
27537,8804,47314,62542,5945,64222,74937,2859,27731,34847
27536,6331,32882,49084,3858,45614,61165,2473,17856,27278
27534,13155,47735,64061,7772,64349,80773,5383,31155,38259
27531,12,0,0,0,0,0,12,0,0
27530,15640,44085,61308,10265,55616,73012,5375,28067,37133
27529,18154,69313,86503,12904,80184,94330,5250,48686,61305
27527,9527,91452,121657,7238,107619,145010,2289,35460,44248
27526,17112,80335,97269,12718,95930,112319,4394,36720,47634
27525,5479,51395,66144,3656,65081,78705,1823,32212,38624
27524,4710,56957,64568,3247,56033,69532,1463,43308,46476
27523,5634,90862,130731,4552,100444,143309,1082,77344,77534
27522,4813,64898,73591,3697,69020,79023,1116,44744,51230
27521,2699,45154,60971,1599,60701,73188,1100,33689,38599
27520,15112,71964,83318,11420,81799,92692,3692,43901,50241
27519,19516,136019,155626,15910,152862,171560,3606,65000,80545
27518,7704,108937,144573,5644,138295,170849,2060,55896,68601
27517,11182,93636,146329,6537,137184,201036,4645,51496,68280
27516,16073,86926,127936,10422,134570,163801,5651,39257,60008
27514,9619,82813,134955,5574,142257,188530,4045,41498,59229
27513,18953,99585,129283,12831,125331,152722,6122,55106,77545
27511,13427,81579,108599,8826,103882,130212,4601,56163,64801
27510,6595,56339,73090,3091,80476,100118,3504,40029,47341
27509,1559,59536,62332,1200,62080,67999,359,30625,41369
27508,878,37150,52389,409,64330,64298,469,36267,37466
27507,713,44969,57370,520,58922,69130,193,21103,25685
27505,2623,59648,70846,1828,71419,82857,795,37512,36827
27504,5719,49591,62788,3969,60483,71154,1750,26810,40078
27503,1431,72056,104977,995,104063,127447,436,53750,50075
27502,15109,115718,130769,11800,131157,142842,3309,62049,81183
27501,7454,57390,70707,5105,66990,82355,2349,33424,42850
27455,11871,76887,119064,7158,104264,151825,4713,37177,69166
27410,24603,71445,94860,14402,96023,119909,10201,40628,56493
27409,8040,45516,60790,3856,57725,69301,4184,34315,49276
27408,7606,69625,115279,4380,100724,152505,3226,42862,62795
27407,21514,50050,67148,13131,56813,73765,8383,38020,52502
27406,24559,44625,61888,15046,54992,70823,9513,34217,44510
27405,19357,39203,52472,12119,46208,59586,7238,26387,38548
27403,7844,51807,67845,3723,66373,86639,4121,42064,49670
27401,7588,36029,52821,3622,43095,62502,3966,27087,43318
27379,2077,36861,50953,1394,56601,63268,683,15545,25681
27377,3542,74938,96268,2582,81691,106607,960,62273,65841
27376,3931,64524,86562,2898,73778,92620,1033,40692,66071
27371,3205,50532,53041,1953,58612,68132,1252,21552,28409
27370,5456,57303,73026,4075,64488,83656,1381,29139,40109
27360,18572,49474,59286,12716,59809,67754,5856,26337,37764
27358,5321,99450,137347,4411,114701,146418,910,46000,91892
27357,3040,59545,95458,2434,80962,105540,606,44046,54960
27356,1017,45694,65745,738,66481,77536,279,27039,33830
27355,982,54551,91354,589,56987,68728,393,15860,25942
27350,2520,51351,68297,1789,59929,80551,731,28579,35965
27349,2150,59519,67358,1598,65653,72359,552,40625,50221
27344,7078,44440,63437,4982,52588,70449,2096,28066,41868
27343,647,80625,118864,370,91484,138126,277,56397,86639
27341,1861,46399,55624,1173,56994,63696,688,30392,36608
27340,9,0,0,9,0,0,0,0,0
27332,11606,61523,71900,8934,65726,76903,2672,35877,46749
27330,14075,50836,68527,9318,60530,80292,4757,33177,43217
27326,1359,51902,65495,955,65912,79577,404,29268,32050
27325,2847,44710,56753,2027,54351,64144,820,20700,33131
27320,16495,45955,57818,10816,55931,68833,5679,27237,34859
27317,6275,47678,60068,4273,59591,70257,2002,31962,35442
27316,2828,41438,53403,2032,52649,61862,796,21694,26742
27315,807,55804,66915,510,72426,87390,297,25083,31489
27314,350,71094,95244,288,71406,103880,62,0,55126
27313,2698,69113,79384,1894,89205,95677,804,35682,40594
27312,9461,75677,105913,6078,103449,129493,3383,34371,61380
27311,1343,32449,45017,849,42296,58126,494,17735,21618
27310,2398,138025,144039,2136,140298,153965,262,28611,62852
27306,2583,52861,59122,1692,60968,68390,891,25125,39898
27305,741,45991,64829,572,57667,71615,169,39063,40637
27302,12428,62263,77269,8434,75453,91659,3994,34828,44584
27301,3179,63690,76096,2465,73341,82358,714,35093,48691
27299,1972,52311,64448,1489,60799,72753,483,22802,32336
27298,4191,49515,59161,2956,62770,68913,1235,25679,31853
27295,15811,50426,65468,11361,61436,74185,4450,29609,40034
27292,16588,42382,56325,10864,53676,65880,5724,26277,36037
27291,551,70221,83825,369,86736,92828,182,15938,65571
27288,10125,42787,54027,6241,53464,64874,3884,25402,34014
27284,22482,65394,82083,15367,81543,95253,7115,36501,51467
27283,1113,67426,77871,874,72635,86744,239,29886,42111
27282,6595,75877,95177,4579,89614,105032,2016,53792,70803
27281,1309,56007,75492,821,74417,97175,488,18167,37900
27278,10672,80700,117732,7218,101081,129069,3454,46646,92044
27265,20471,60912,85975,13287,80387,99081,7184,35422,60644
27263,8711,47424,61347,5723,55528,71197,2988,30833,39711
27262,9063,48734,78396,5771,66558,94547,3292,32136,48512
27260,9439,31490,40779,6079,36257,46940,3360,15706,25374
27258,2797,53194,70868,1970,75042,84388,827,31034,36083
27253,12791,48592,66351,8259,58352,77819,4532,31714,42512
27252,671,47813,63973,445,37438,75101,226,20357,29102
27249,5198,62684,72954,3574,84776,84160,1624,32664,43338
27248,1226,47195,59624,970,47195,62307,256,35375,42206
27244,5332,59643,75960,3211,86182,100567,2121,24732,37767
27243,1950,67233,94264,1337,81726,116858,613,28653,43143
27242,682,34886,56689,394,78824,81702,288,14643,18250
27239,3759,51403,64128,2686,64427,69756,1073,24137,47093
27235,1906,94115,107619,1518,96750,121525,388,34022,49475
27233,1315,65787,82718,1106,68636,88929,209,29583,29926
27231,973,61406,74573,580,80938,91722,393,25893,44866
27229,1155,40875,44088,993,41124,44472,162,30761,33055
27217,14094,45233,56754,9701,51718,64152,4393,27381,35281
27215,18566,55441,77248,10738,75101,98929,7828,37228,44392
27214,4462,67823,82111,3301,76916,89442,1161,40019,52007
27212,498,56293,63824,326,57328,76085,172,0,40585
27209,1571,40927,57291,1120,41493,66465,451,12969,26938
27208,543,39750,59410,417,49948,72952,126,15566,14582
27207,1443,57201,69742,1184,65714,73996,259,32092,42820
27205,14298,52631,65563,10038,62222,75480,4260,28138,38347
27203,8855,36512,44473,5212,44013,51655,3643,24784,32092
27201,29,75781,67486,24,76563,75463,5,0,0
27127,15548,50113,60583,9177,61982,70958,6371,37694,43148
27110,0,0,0,0,0,0,0,0,0
27109,0,0,0,0,0,0,0,0,0
27107,18042,45011,63697,12446,56014,70591,5596,22403,44548
27106,19281,56775,96154,11467,79642,125535,7814,32124,51103
27105,14993,33168,45439,9416,43811,54419,5577,20108,27442
27104,13299,66418,111145,7659,95803,149392,5640,38636,57376
27103,15645,53349,68453,8827,63835,78044,6818,39904,52852
27101,9001,39557,58491,3565,50295,72115,5436,31739,48971
27055,5450,50310,62862,3807,63250,73663,1643,26164,33031
27054,900,73232,78758,559,80750,99564,341,39375,44651
27053,1441,53495,86020,985,56142,107836,456,23867,31035
27052,4257,46097,55213,3008,54483,62748,1249,32869,36358
27051,2824,47197,59942,2013,57113,67577,811,25972,39355
27050,1794,63333,71099,1181,65462,82307,613,39556,44916
27048,3334,54167,65006,2632,57924,69564,702,34464,44664
27047,520,56296,59384,371,57656,65697,149,41875,41197
27046,1119,41359,48983,746,75096,58647,373,21766,29654
27045,4108,58854,70046,2821,64279,82406,1287,33832,41141
27043,2737,62137,84400,2039,70019,88306,698,29756,69647
27042,143,54816,73069,117,57188,85980,26,0,0
27041,3237,51343,70004,2203,64475,81457,1034,25645,41378
27040,4749,79578,102237,3675,94242,114433,1074,46447,55179
27030,15037,37922,55783,9546,55821,70671,5491,19191,28516
27028,9616,54131,68397,6797,62495,76839,2819,32790,44435
27027,1987,34965,52200,1160,47159,66827,827,14627,28172
27025,4601,45686,56199,3233,51204,63311,1368,27708,35152
27024,1239,42246,71612,1043,64803,79561,196,0,29315
27023,4989,78024,112001,3576,98750,135952,1413,31902,48703
27022,522,43259,52596,361,48831,67222,161,14375,19802
27021,7348,54024,67708,4763,69526,79768,2585,33897,42290
27020,2478,45833,62840,1750,60179,76467,728,24392,30085
27019,1821,60532,75380,1407,65255,73942,414,29012,79317
27018,3144,54278,76701,2455,70565,88022,689,27823,34129
27017,3509,55787,64142,2572,66575,71103,937,20194,36347
27016,620,50449,49253,337,66350,64664,283,25875,30901
27014,343,45417,58384,239,60156,63349,104,28750,40259
27013,2339,47241,59704,1523,60432,67904,816,36625,42627
27012,10915,85814,105165,8083,104836,121814,2832,41520,53054
27011,2279,44301,59477,1324,60109,76974,955,30895,35051
27009,1162,78026,89093,941,79292,87180,221,0,83300
27007,851,79219,86910,707,85982,94763,144,0,43654
27006,6255,80347,100119,4329,102592,117777,1926,47781,58144
26884,289,31875,48033,202,51630,58067,87,18750,17170
26866,294,63056,63397,231,69922,75112,63,18403,18694
26865,84,66591,70598,84,66591,70598,0,0,0
26855,303,43068,60808,187,67784,82090,116,27083,25596
26852,333,40938,48278,295,40369,45371,38,86250,70847
26851,908,53125,66850,674,57159,72918,234,41923,49076
26847,2623,41527,51257,1598,53125,60707,1025,22014,32193
26845,374,67738,62111,267,73275,71606,107,37292,38418
26836,3020,45022,68678,2054,46761,70646,966,28156,39959
26833,903,48750,54896,615,51886,63443,288,31458,35358
26823,68,0,0,0,0,0,68,0,0
26818,302,47885,51795,247,43882,52020,55,48958,42451
26817,123,0,77847,94,102917,89370,29,0,0
26815,365,41625,74894,271,55313,70854,94,24688,83583
26814,232,54605,57225,180,57054,61099,52,22500,24596
26812,639,55208,71247,496,61862,66932,143,40579,86203
26810,158,0,147937,100,0,208248,58,25921,28562
26808,212,83722,79375,170,84889,95584,42,0,13769
26807,1249,49550,55305,886,53897,62535,363,17031,28412
26804,255,35179,64563,201,55391,73387,54,17500,19387
26802,485,32083,48301,307,45893,56439,178,26429,30229
26801,312,38714,50151,170,69310,75462,142,0,19849
26767,223,40179,57657,158,50278,65575,65,23920,37448
26764,1608,45100,56343,989,59609,72530,619,17552,29925
26763,600,53929,56316,390,67903,65347,210,31875,34788
26761,337,23496,40403,128,0,65782,209,19695,22967
26757,2837,40064,53384,1642,52907,68954,1195,25175,31062
26755,376,33000,40972,140,50750,52454,236,0,34161
26753,2391,51455,62662,1587,63438,71467,804,27292,38211
26750,313,35250,62178,134,55536,55939,179,25114,60732
26743,723,49008,60625,512,56400,69496,211,35250,39101
26739,357,53272,65653,188,72917,78240,169,34792,51650
26731,238,0,43879,89,66964,77631,149,19824,23718
26726,4995,51871,61860,3080,64442,75730,1915,34309,38528
26722,139,45221,47185,57,65347,57879,82,42344,39750
26720,32,0,29491,32,0,29491,0,0,0
26719,1215,54782,67342,842,69314,82072,373,24609,34089
26717,303,40050,64209,208,44167,77285,95,24844,29767
26716,279,80133,73242,247,80739,80844,32,0,0
26714,182,0,42614,105,38988,57529,77,0,0
26711,1257,58828,66114,940,79917,74077,317,33224,37165
26710,844,62600,62807,618,65321,57832,226,60161,68600
26707,128,36071,44173,74,44625,57096,54,21667,25574
26705,238,46250,88641,159,53750,116926,79,22031,31714
26704,2070,62526,67960,1305,59536,68565,765,53750,61149
26691,192,64142,71648,169,63489,56790,23,19712,20965
26690,260,0,47663,217,0,49175,43,0,40033
26684,74,0,65530,74,0,0,0,0,0
26681,421,27409,31005,284,27273,26296,137,0,37577
26680,117,0,221669,79,0,31638,38,"250,000+",607542
26679,741,37276,45346,426,63571,63983,315,0,20143
26678,459,51780,56428,394,49412,55647,65,0,46534
26676,161,62219,58606,161,62219,58606,0,0,0
26662,466,38478,56265,395,53086,62808,71,23112,19863
26660,168,0,57311,115,74583,76066,53,0,16617
26656,93,0,38810,67,43958,45201,26,23289,22342
26651,3944,41350,57241,2774,56404,69475,1170,19246,25241
26638,71,0,43341,50,78047,55810,21,0,0
26636,174,38696,42167,174,38696,42167,0,0,0
26631,51,0,21033,21,0,0,30,0,0
26629,115,49191,45263,78,49412,50373,37,0,30222
26627,128,15722,38167,108,0,38923,20,0,0
26624,1386,47733,53338,812,56173,67882,574,26008,31789
26623,451,54147,60045,356,66818,61999,95,14536,15623
26621,263,40982,49461,187,48967,51959,76,36563,41596
26619,124,29286,29561,90,31048,33522,34,0,0
26617,29,26726,33407,29,26726,33407,0,0,0
26615,100,0,0,100,0,0,0,0,0
26611,55,0,58885,42,0,70555,13,0,0
26610,339,37721,50473,267,39926,55843,72,30000,28797
26601,1642,41938,59553,1203,43836,64371,439,30399,40163
26591,524,64737,64530,453,66215,67770,71,18365,29744
26590,277,83964,111375,187,91528,109107,90,0,116088
26588,1163,53775,65880,842,54375,69304,321,38958,52168
26587,157,65568,55371,124,0,54205,33,0,32515
26586,92,0,70708,68,118191,88990,24,0,0
26585,143,60750,55681,127,62712,61779,16,0,0
26582,1685,44952,63804,1192,64375,77529,493,18578,27465
26581,364,51667,58147,264,55278,63889,100,0,35041
26576,433,82125,85117,373,86375,95587,60,19896,20025
26575,349,27917,35887,238,36726,43057,111,14960,20513
26574,241,46523,59417,173,59659,57239,68,33043,64415
26572,33,0,28433,21,0,0,12,0,0
26571,762,74667,75226,572,80349,80530,190,27857,50823
26570,1361,53264,61756,928,74722,74232,433,24743,34250
26568,239,0,73871,189,0,63714,50,18750,112260
26563,133,36397,43944,111,46094,49718,22,0,0
26562,179,41016,53526,136,48571,55820,43,40547,46270
26560,46,0,60230,25,0,0,21,0,0
26559,540,60714,63472,348,81667,81436,192,19655,29281
26554,17270,52308,68746,10719,67184,81076,6551,32267,44278
26547,1167,54536,69998,819,72202,79379,348,35625,45887
26543,80,0,0,34,0,0,46,0,0
26542,1047,48880,62481,640,66548,78215,407,30592,37739
26541,1072,58438,91709,712,80000,108789,360,55515,55726
26537,2415,44554,59664,1574,56146,71508,841,25476,35368
26534,940,28547,41751,360,56447,52152,580,25313,34519
26525,1868,74750,85419,1395,92717,96981,473,38798,50586
26521,71,0,138246,52,184375,172769,19,41875,43763
26520,259,0,79595,227,70903,84115,32,35750,32947
26519,786,50556,61570,631,50972,65944,155,30688,39404
26508,12789,74120,109869,8693,101378,133150,4096,37048,55179
26505,15132,41594,64395,6152,75307,96006,8980,24641,41677
26501,8635,55906,78745,4519,85269,107349,4116,36142,45407
26456,1352,50357,79122,958,68300,96607,394,18256,35281
26452,3795,40975,57877,2428,55400,65918,1367,28175,37902
26451,263,61875,68702,191,77813,82844,72,28125,29250
26448,494,55000,68038,367,67415,82082,127,18996,25660
26447,498,33000,57562,305,53942,55992,193,0,55384
26444,1430,45064,67755,902,69375,86230,528,25185,31433
26443,144,75862,74456,97,75819,79378,47,0,64298
26440,411,52713,58587,282,64000,72399,129,0,19613
26438,28,0,0,0,0,0,28,0,0
26437,238,0,92601,186,0,108281,52,0,36515
26436,69,43295,42314,69,43295,42314,0,0,0
26435,39,22375,26251,19,0,0,20,0,0
26431,2384,48469,64684,1637,57938,76654,747,29288,36483
26430,115,0,37917,72,33750,41178,43,18977,31853
26426,2618,48469,65251,1840,54000,75484,778,28209,40208
26425,419,52850,55047,257,60043,65152,162,28000,37945
26424,76,40924,41470,32,0,0,44,0,0
26422,203,58688,64628,134,82813,74187,69,0,46064
26421,62,44063,47853,51,43073,44402,11,0,0
26419,411,43615,54848,250,63145,65472,161,24491,38350
26416,3373,37919,56949,1792,60880,78710,1581,22204,29217
26415,1284,56486,79997,1034,68947,92052,250,18661,26588
26412,105,44271,45858,84,50972,48505,21,0,0
26411,164,65435,69784,103,79219,89987,61,36719,35669
26410,354,54357,61985,291,53964,61103,63,0,59811
26408,1003,88565,89600,745,101016,98707,258,34359,62425
26405,430,37250,50044,285,49145,53164,145,32163,42092
26404,275,13872,29301,121,0,49726,154,0,0
26386,1101,49690,58697,702,54250,65917,399,47743,39352
26385,1472,68788,72748,1084,78333,88223,388,19423,28003
26384,252,62704,64270,196,64133,73343,56,32065,32516
26378,1726,53571,74613,1219,70868,85075,507,30625,45636
26377,286,0,51873,202,80236,61431,84,23750,28887
26376,147,0,67178,82,0,49500,65,0,89480
26374,595,48194,57750,406,42955,61988,189,52750,46454
26372,249,53750,89564,140,90270,122361,109,52736,46642
26369,246,80962,68803,195,86250,74334,51,0,0
26366,21,0,0,4,0,0,17,0,0
26362,1431,40387,62010,990,54621,71420,441,24911,39715
26361,51,0,0,38,0,0,13,0,0
26354,4334,49006,59997,3001,60394,68234,1333,26721,38077
26351,1372,40556,46961,727,55883,61597,645,24938,29826
26349,56,50167,42816,41,0,0,15,0,0
26348,166,19118,25579,23,0,0,143,18836,24779
26347,698,57727,74569,549,60764,74444,149,26510,35386
26346,344,52500,66795,237,61761,80342,107,30586,33133
26343,157,34395,42467,124,35833,48367,33,0,11452
26342,88,41250,39366,46,39688,37657,42,60114,41236
26339,67,20972,38542,67,20972,38542,0,0,0
26338,246,58788,79526,204,75625,89634,42,0,30431
26337,534,41429,43985,334,45556,52044,200,22759,27872
26335,641,66573,64454,492,77054,72140,149,36181,39077
26330,5939,81831,98096,4113,100702,114998,1826,48788,57754
26327,54,41929,50426,19,0,0,35,0,0
26325,136,0,37913,96,45625,46694,40,11900,16835
26323,288,23700,30068,123,24321,37780,165,0,24063
26321,99,26008,28394,34,0,33294,65,26250,25831
26320,286,42105,46027,148,47778,58180,138,30556,32376
26301,11772,45061,59300,6617,60960,73766,5155,25697,38398
26298,51,0,30022,16,0,50263,35,0,20769
26296,34,0,0,34,0,0,0,0,0
26294,457,37241,44882,310,54833,57847,147,15050,16432
26293,280,113315,101693,229,0,104299,51,0,14471
26292,256,44063,53100,125,55991,66461,131,28309,39488
26291,56,99130,83289,56,99130,83289,0,0,0
26288,1438,37670,49290,1026,39830,50304,412,20769,43892
26287,1370,46276,55685,920,58500,68471,450,22632,27991
26285,134,35625,47274,67,45324,64682,67,30625,29866
26283,661,47452,56386,402,66786,69660,259,26713,35783
26282,42,31389,30898,26,0,0,16,0,0
26280,685,39375,44086,406,51111,52766,279,26348,29972
26278,237,55443,47843,166,55885,56118,71,0,28493
26276,293,50612,51367,268,50938,53889,25,0,0
26275,217,29489,37798,143,29821,32525,74,0,47293
26273,289,36750,45120,261,49375,46646,28,16250,15104
26271,236,40625,50073,152,51667,59363,84,20694,33263
26270,162,30608,35472,99,0,41998,63,24327,25216
26269,455,49250,58874,256,62885,65374,199,30673,50513
26268,22,0,0,14,0,0,8,0,0
26267,110,49474,65312,90,53214,74334,20,0,0
26266,25,0,0,25,0,0,0,0,0
26264,260,39302,51185,152,67917,63714,108,33712,31537
26263,81,0,45147,47,0,56074,34,0,30041
26261,1181,28906,40095,647,45673,51384,534,22525,25675
26260,730,51481,62116,471,67361,77628,259,26458,33616
26259,13,0,0,0,0,0,13,0,0
26257,399,52212,82205,290,51731,96644,109,25438,32284
26254,75,41696,44604,33,68487,67403,42,0,0
26253,1431,49363,73980,903,53512,83525,528,47897,54675
26250,1845,40678,54813,1395,48098,61925,450,23869,29996
26241,5556,43698,63919,3059,62739,73523,2497,24006,50894
26238,293,30469,39929,189,34261,47208,104,24167,26700
26237,198,32188,40720,157,36434,46029,41,0,0
26236,16,0,0,16,0,0,0,0,0
26234,640,32386,41784,301,60665,56107,339,21782,29067
26230,71,0,33880,8,0,0,63,0,34438
26228,0,0,0,0,0,0,0,0,0
26224,120,66875,64893,79,73682,76457,41,41172,42612
26222,138,40658,34310,75,36583,29236,63,44519,40351
26218,1010,39833,48200,699,47114,57132,311,15662,25706
26217,59,0,75046,49,0,86810,10,0,0
26215,16,0,0,16,0,0,0,0,0
26209,65,66094,73360,32,46944,57559,33,91528,88679
26208,386,43125,58533,235,50875,55005,151,20074,63338
26206,1285,23723,37657,832,30909,46746,453,19503,19876
26205,1412,41622,54318,1010,50877,66248,402,20373,20124
26203,101,0,47626,53,0,0,48,0,0
26202,212,29875,38869,160,33311,43170,52,0,25637
26201,7878,43253,66770,4958,59050,72914,2920,26895,52398
26187,2628,74310,89538,1811,85417,106722,817,27111,49711
26184,798,66875,77151,668,73864,80945,130,31300,42282
26181,2567,59926,78433,1981,70784,85490,586,36484,47156
26180,742,52708,69735,475,51681,75167,267,41981,54469
26178,91,37230,44668,63,36875,44868,28,43889,44218
26175,1367,49396,67296,788,63103,70902,579,37585,59307
26170,2233,51027,72246,1624,66094,78639,609,28782,53155
26169,222,66667,88156,149,88482,105235,73,0,53297
26167,324,30556,46330,187,43155,64197,137,21080,21942
26164,3092,38243,56447,1921,71570,77856,1171,11902,19169
26161,258,55192,47410,184,63750,59612,74,0,17069
26160,452,57333,63835,282,56333,70505,170,70600,52344
26159,1168,50968,58091,882,52470,61482,286,32500,42176
26155,2998,44898,58694,1718,65786,72766,1280,31803,39480
26152,2,0,0,2,0,0,0,0,0
26151,274,25000,33683,153,27563,35742,121,0,25367
26150,2446,55000,71152,1501,63732,82225,945,42448,49290
26149,844,50000,72364,510,72944,94354,334,31220,35464
26148,112,0,64426,90,0,68632,22,0,0
26147,873,50750,60059,550,60526,75561,323,18917,32233
26146,342,74853,240208,261,120250,297372,81,0,55260
26143,1927,46359,55501,1309,56761,66635,618,23269,30665
26142,963,55547,56480,673,60077,62212,290,29024,41019
26141,130,39500,48805,106,41111,50499,24,25000,18258
26138,62,0,0,0,0,0,62,0,0
26137,242,50667,57462,181,50917,64292,61,0,37197
26136,197,35469,43639,119,46250,55183,78,14531,18641
26134,391,50125,55205,207,68194,71826,184,25227,36507
26133,495,82946,78942,393,86054,87404,102,47000,46338
26105,5099,54213,74187,3200,67738,94016,1899,24909,39431
26104,7365,43164,61516,4120,64904,79614,3245,26686,37751
26101,11951,39239,52682,7299,47005,62590,4652,24419,32107
26075,227,40208,67755,141,63750,84024,86,33980,40242
26074,230,34423,45541,101,78250,77554,129,9430,19938
26070,3566,48138,57015,2449,59107,67336,1117,24935,33212
26062,8909,51136,63038,5148,66466,76398,3761,31446,42884
26060,655,62639,75789,500,67174,84896,155,26220,33031
26059,1057,63882,75921,792,66230,79601,265,31250,61907
26056,34,76184,76229,34,76184,76229,0,0,0
26055,431,26567,47230,256,0,56872,175,0,30049
26050,745,23597,38604,347,0,52116,398,16964,26440
26047,2568,48018,66018,1655,58938,79154,913,33425,40351
26041,6331,42317,53788,3753,56187,64616,2578,21667,36149
26040,770,36170,52215,389,53149,67944,381,22007,34438
26039,149,57026,68821,113,56806,65093,36,0,73258
26038,1377,73922,106611,1017,96016,112177,360,43500,90112
26037,2798,47148,62464,1660,67308,76508,1138,40326,41034
26036,74,141048,128023,55,140282,109033,19,0,0
26035,855,40184,54838,513,78450,74075,342,30318,25981
26034,2250,45203,49185,1157,59989,65630,1093,25785,31158
26033,759,41650,55801,448,67778,75032,311,19190,27681
26032,174,55417,67920,89,85750,86225,85,34792,47131
26031,654,38276,51501,417,49625,61059,237,22981,30403
26030,254,42500,51637,129,57841,60620,125,21750,33439
26003,17344,49178,72490,10209,71575,92206,7135,26613,43504
25989,9,0,0,0,0,0,9,0,0
25985,178,48750,60008,141,58456,63565,37,31250,34141
25984,720,24659,38435,588,22458,37903,132,23824,33852
25981,281,24395,36240,172,31591,38699,109,23147,26861
25979,345,26576,30790,181,31106,32043,164,25326,29101
25978,257,52788,74946,196,72375,88346,61,0,28274
25977,36,0,44331,36,0,44331,0,0,0
25976,1103,49506,56464,825,57277,65139,278,22315,28138
25972,64,15726,17622,64,15726,17622,0,0,0
25971,469,53542,58970,352,61196,68693,117,0,29718
25969,474,46705,61993,386,63421,70736,88,13929,19175
25962,1427,37472,46929,825,47303,61342,602,26964,26312
25958,278,43125,49250,197,44241,52321,81,27448,34767
25951,2946,32176,46733,1701,49435,59185,1245,21743,27093
25942,47,45750,45985,47,45750,45985,0,0,0
25938,485,59625,65310,352,77121,79809,133,0,26938
25936,0,0,0,0,0,0,0,0,0
25932,141,73920,61979,123,72557,66180,18,0,0
25928,205,27977,31006,113,45234,44479,92,18175,0
25922,106,54400,46617,86,55769,57458,20,0,0
25921,942,28360,39989,560,31071,51968,382,15000,18804
25920,53,0,0,53,0,0,0,0,0
25918,1919,59604,69921,1378,78625,83509,541,23322,34262
25917,720,40700,46205,504,51413,50767,216,0,32120
25916,76,23947,22046,76,21833,19757,0,0,0
25915,84,30000,32650,43,35486,38379,41,0,26641
25913,133,48292,52774,114,49083,61115,19,0,0
25911,25,0,48460,24,0,0,1,0,0
25908,56,55795,61954,56,55795,61954,0,0,0
25907,34,0,0,34,0,0,0,0,0
25906,193,38427,62558,144,0,58610,49,0,74159
25904,163,16743,32342,78,65625,53051,85,15331,13339
25902,80,0,66118,55,0,79935,25,0,0
25901,4826,43071,55850,3040,56031,68246,1786,28036,33831
25882,860,47413,73134,593,70347,88841,267,27250,38251
25880,2613,38779,53251,1907,49107,61723,706,15458,28079
25879,59,65195,50144,59,0,46615,0,0,0
25878,396,0,29902,212,0,44537,184,0,13038
25876,15,0,0,15,0,0,0,0,0
25875,295,50461,56691,262,57576,61090,33,0,0
25873,380,31176,44435,224,37581,58173,156,20357,24709
25871,372,23681,36067,162,23681,39401,210,23750,33496
25870,14,0,0,14,0,0,0,0,0
25868,215,86023,65800,166,87197,77072,49,20815,27614
25865,482,32454,46035,380,38571,52368,102,21500,20371
25864,76,50000,54051,52,80667,75156,24,0,0
25862,99,0,34700,57,0,45223,42,0,0
25857,35,0,0,35,0,0,0,0,0
25855,63,0,0,63,0,0,0,0,0
25854,518,50214,60353,287,82656,86422,231,23992,27965
25853,15,0,0,0,0,0,15,0,0
25849,407,42545,34203,108,35820,32049,299,0,0
25848,109,51433,46409,99,51738,49775,10,0,0
25846,97,25347,30861,55,0,33289,42,0,0
25845,223,43787,39723,162,51250,47606,61,17768,18789
25844,518,69545,66486,348,62105,72684,170,69886,53799
25843,443,105852,108332,357,122036,123939,86,0,34303
25841,175,35240,50314,89,62969,66376,86,19412,33692
25840,3358,47723,59397,2259,52463,68307,1099,25562,36206
25839,184,0,39561,37,0,0,147,0,28434
25837,117,73125,68681,90,90750,86199,27,0,0
25836,53,0,0,53,0,0,0,0,0
25832,1766,69113,99638,1264,88846,116772,502,20167,56082
25831,669,59250,60397,554,67500,67413,115,16422,26599
25827,1002,44817,43397,471,50970,52323,531,30677,31311
25826,66,0,0,66,0,0,0,0,0
25825,1157,58821,62432,1027,59893,64684,130,44844,44638
25823,859,29707,41304,608,43452,51065,251,22879,17659
25820,163,41895,57594,114,77917,77388,49,0,11543
25818,236,36894,45011,33,0,0,203,36098,33865
25817,254,0,45892,217,56393,51449,37,0,0
25813,2734,39077,57567,1722,61083,75807,1012,25016,25957
25812,689,37880,50233,445,50461,59659,244,21953,26909
25811,16,0,0,16,0,0,0,0,0
25810,29,0,0,0,0,0,29,0,0
25801,13220,47148,60833,8947,58254,68937,4273,23954,40138
25705,9069,46609,65533,5178,62829,85295,3891,26844,37560
25704,6577,42166,63088,4049,59036,80213,2528,24255,34455
25703,2288,19902,28272,629,28105,41140,1659,16458,23139
25702,3084,26590,39250,1573,47726,52771,1511,14571,22927
25701,9260,40020,65487,4498,63839,92525,4762,19815,38546
25699,40,0,33963,40,0,33963,0,0,0
25696,137,44896,49680,103,65208,59988,34,0,0
25692,350,28796,36691,230,35625,43056,120,10441,24490
25690,85,0,61989,73,0,65132,12,0,0
25688,92,56538,62591,92,56538,59136,0,0,0
25678,740,37588,42196,472,45714,55060,268,14524,19540
25676,494,28250,49161,444,21799,48909,50,19904,23396
25674,882,23203,36198,631,41771,42365,251,14893,20518
25672,202,0,35609,128,63182,49528,74,0,11532
25671,544,45769,44506,462,56013,49220,82,13448,17950
25670,2413,38199,45787,1656,44622,53998,757,14531,24711
25669,419,25655,33705,238,51786,45364,181,9395,11434
25666,142,0,36287,96,60417,49905,46,8864,0
25661,2475,32205,51721,1505,41781,66371,970,14794,26856
25654,39,0,0,39,0,0,0,0,0
25653,159,40208,50036,121,55694,59745,38,0,0
25652,514,24408,40996,324,0,31647,190,0,29395
25651,332,20000,23642,185,28447,29223,147,13750,15776
25650,120,60000,52411,96,65074,53066,24,0,0
25649,588,46750,46806,522,46479,46324,66,72643,50624
25647,265,36406,58900,184,0,65853,81,29803,31309
25646,432,29844,56660,311,31607,69188,121,26860,24458
25644,274,51080,59522,245,0,60261,29,0,0
25639,160,40259,50840,145,40905,53244,15,0,0
25638,319,63472,56505,287,64954,60513,32,0,0
25637,513,37723,39173,326,38661,35035,187,0,42250
25635,653,45164,70506,548,45329,74149,105,44219,51089
25634,283,29250,49778,197,0,61179,86,0,0
25632,140,23750,62970,101,0,78695,39,0,0
25630,185,24625,35972,137,0,45554,48,9118,7854
25628,115,32070,47780,59,0,33851,56,0,0
25625,415,51795,65782,339,55163,69733,76,0,0
25624,55,0,40045,54,0,40583,1,0,0
25621,771,39609,48660,422,58466,63291,349,25368,30970
25617,364,36793,53202,265,0,63105,99,0,25349
25611,354,21215,28614,119,0,37197,235,21519,24221
25608,399,50321,62737,341,49271,65286,58,50741,45950
25607,353,23309,43056,316,26250,44689,37,16713,22830
25606,520,40278,68477,424,48000,81041,96,25000,12982
25601,2260,44035,62472,1508,56892,71770,752,24063,35748
25573,216,51188,42498,161,0,32978,55,74766,70365
25571,826,47778,59398,608,62083,68377,218,25543,29272
25570,1886,34000,45676,1308,44286,55969,578,13724,20912
25567,230,0,170104,132,72750,282701,98,16179,18445
25565,260,28286,37264,211,0,38202,49,0,0
25564,470,100799,88246,416,101495,96638,54,22941,23589
25560,3117,89504,95626,2161,96177,109595,956,40294,60298
25559,760,35368,41390,625,35618,42127,135,0,37979
25557,804,27010,34599,496,36667,44127,308,9983,19255
25555,676,57391,61467,426,69182,76175,250,31250,36405
25550,3782,56709,68214,2832,62765,75779,950,25645,36791
25547,407,0,40542,137,0,106844,270,25000,6899
25545,1916,71734,86818,1362,72218,93612,554,40882,62091
25541,4475,48837,77060,2912,75417,98212,1563,25471,36669
25540,144,19191,25201,96,18750,20792,48,0,34019
25537,615,40483,49446,223,62946,72504,392,24746,35941
25535,858,70707,104757,731,72719,112806,127,26278,53788
25534,88,0,34547,32,70417,57750,56,0,20123
25530,2607,46219,55590,1587,65465,69800,1020,23036,33167
25529,412,54091,52418,374,55347,54786,38,0,29105
25526,8381,68011,87052,6107,82509,101382,2274,36188,44373
25524,941,26289,43203,726,34375,49719,215,13932,18856
25523,1021,35417,45426,701,39325,51045,320,17333,31170
25521,320,50625,85151,225,54968,110898,95,25529,24171
25520,528,29850,49633,392,53214,58814,136,21500,23168
25517,568,25921,41978,324,36250,54035,244,0,23601
25515,747,43780,53128,441,49965,63052,306,21719,37828
25514,1679,40274,42987,1148,53056,55703,531,14153,13408
25512,467,33213,37708,353,33936,41290,114,0,26617
25511,329,25590,33232,160,45655,47826,169,15491,19415
25510,1900,73214,76735,1413,79450,90423,487,24612,35892
25508,4172,47417,61636,2924,65471,74465,1248,18919,29813
25507,355,40020,41337,232,41328,51855,123,16510,21482
25506,2204,36453,48155,1649,45644,56917,555,19904,22122
25505,118,14623,20664,78,22308,24445,40,0,0
25504,5091,54272,73786,3246,62708,89307,1845,33430,44035
25503,443,56250,63038,325,59095,72192,118,36337,37825
25502,296,52941,56054,268,50682,53409,28,0,0
25501,557,47604,44821,422,47662,48902,135,0,30399
25446,473,138641,129635,349,144434,154780,124,0,37879
25444,123,0,87878,107,0,87718,16,0,0
25443,2545,87179,109359,1592,107368,130738,953,54450,71082
25442,763,100163,134596,611,101750,138572,152,64286,78253
25438,2341,69821,82314,1521,86338,92815,820,50064,60644
25437,46,95921,80713,46,95921,80713,0,0,0
25434,1080,65425,69269,879,65963,71563,201,44193,50539
25432,50,50000,57090,41,70288,65929,9,0,0
25431,79,0,59094,52,20741,24090,27,0,0
25430,3154,71049,92042,2202,89239,106354,952,41637,53959
25428,4683,69877,73049,3405,76858,79583,1278,39544,49446
25427,5933,71336,82980,4537,78171,89994,1396,50192,55411
25425,5345,79141,94590,3644,97941,107557,1701,48750,61298
25422,756,32268,47888,423,34271,52958,333,31934,41448
25420,1968,76731,91307,1332,82153,109804,636,43839,47351
25419,4149,73139,93286,2971,79543,95569,1178,45625,80776
25414,6966,90654,100262,5020,104905,116624,1946,46548,53738
25413,3529,66584,76754,2159,79282,86223,1370,65340,58020
25411,5329,60525,73462,3482,67500,86207,1847,36390,44441
25405,4842,82357,91549,3698,83262,89056,1144,51207,90936
25404,8953,57767,70233,5835,65704,78943,3118,42827,51485
25403,5664,70000,87534,3481,96108,103734,2183,54888,56101
25401,6141,40727,60516,2924,50375,79497,3217,33184,39471
25320,2175,36399,48769,1455,52737,59895,720,15000,23556
25315,1397,42159,51739,953,52452,59909,444,24766,30961
25314,6316,69583,109349,3864,102386,139838,2452,41330,60593
25313,5381,52903,76518,3627,66719,89218,1754,43133,48457
25312,6219,40124,56199,4368,48750,64116,1851,27058,34312
25311,4848,45745,66839,2471,55284,82315,2377,37260,48527
25309,5740,46852,70729,3427,64199,90049,2313,30972,39499
25306,3060,52426,63583,1819,62480,74060,1241,31456,43635
25305,0,0,0,0,0,0,0,0,0
25304,3524,66364,113451,2037,101033,147107,1487,37623,61706
25303,3154,53583,70988,1855,70641,84389,1299,37860,50133
25302,6254,39898,56838,2808,65116,78834,3446,26854,37882
25301,1278,18415,45681,306,49688,74601,972,14956,36576
25287,237,43203,50033,120,0,70505,117,31392,29037
25286,673,44511,49322,395,60583,59621,278,38500,34689
25285,224,0,38028,113,46732,57185,111,16580,18526
25276,3205,33121,47350,2007,39830,56970,1198,21529,30465
25275,683,59226,61538,469,76074,72497,214,30119,37520
25271,3922,48576,62285,2263,62960,77826,1659,24447,36305
25270,340,36618,67594,209,55179,89564,131,21397,31947
25268,448,0,76088,319,0,66483,129,0,99840
25267,258,24551,32475,210,24130,29479,48,0,32967
25266,316,45375,52104,187,58051,62991,129,43058,36321
25265,731,39776,85285,444,70417,121889,287,22173,27483
25264,154,46786,41634,119,53427,49063,35,20069,16374
25262,485,47625,69548,348,0,89547,137,20417,18747
25261,43,0,28781,14,11458,21379,29,0,0
25260,628,30938,44977,366,54167,57761,262,18843,27119
25259,302,43933,60492,256,43904,60403,46,0,60987
25253,876,55982,61976,708,57455,67154,168,33235,40153
25252,610,51389,62390,460,70313,69368,150,37045,40541
25251,86,0,105274,55,185938,140209,31,0,43294
25248,1266,50164,70052,926,60192,82447,340,0,29218
25247,218,50598,53630,177,50516,52593,41,60313,57063
25245,306,0,67075,198,0,83956,108,33793,36127
25244,187,53977,59371,150,76250,66542,37,0,30300
25243,179,49219,65511,72,0,119297,107,29258,29319
25241,614,86875,133042,482,97273,161483,132,26912,29189
25239,623,40580,57775,478,66833,70159,145,20685,16949
25235,403,0,39018,238,0,44642,165,17532,17869
25234,311,40324,54328,259,43281,60452,52,23362,23035
25214,255,0,70805,216,0,76365,39,0,0
25213,2427,70302,90265,1937,89946,97114,490,35678,63090
25211,33,0,30809,14,0,0,19,0,0
25209,419,26115,47151,237,0,59856,182,25405,28004
25208,289,30464,43840,189,33750,55857,100,15313,19787
25206,121,65764,53353,69,43967,42267,52,69000,68063
25205,110,27125,27425,70,26000,27490,40,28523,27313
25204,45,41750,40400,26,62679,51588,19,22750,25089
25203,9,0,0,9,0,0,0,0,0
25202,466,57786,62278,306,59071,72955,160,24405,37763
25201,0,0,0,0,0,0,0,0,0
25193,223,54750,52720,179,63417,58688,44,16667,25602
25187,262,0,58274,159,88438,86967,103,15549,13980
25186,453,37011,49812,300,47000,57570,153,24625,34084
25185,0,0,0,0,0,0,0,0,0
25183,18,0,0,18,0,0,0,0,0
25181,493,33036,62822,351,50134,73601,142,25278,36176
25180,96,0,36934,63,63882,51835,33,0,0
25177,9467,44501,58092,5990,59900,69967,3477,27874,34073
25174,156,0,57546,91,0,43190,65,0,77643
25173,117,24938,27868,66,34138,41376,51,0,0
25169,237,40052,46978,151,40365,48927,86,0,43556
25168,1449,76493,72665,1160,80797,79019,289,34901,41691
25165,342,83241,79375,213,90380,79641,129,82642,64123
25164,425,42604,54848,250,65833,76393,175,23750,24070
25162,134,54306,75057,98,64500,88180,36,38235,34064
25161,170,24167,33719,93,50982,43185,77,23542,22286
25160,118,39012,37308,87,38110,34721,31,0,0
25159,1773,43185,58513,1345,50865,66930,428,24375,29094
25156,103,32537,24965,52,0,0,51,0,0
25154,259,55324,57600,211,75037,65725,48,0,21883
25152,219,0,51194,109,25865,31532,110,0,33928
25149,46,0,59130,46,0,59130,0,0,0
25148,164,47778,46396,134,47778,45714,30,0,41453
25143,3634,44126,61176,2507,58244,72450,1127,27294,32858
25142,122,65625,57941,110,66094,57504,12,0,0
25141,96,0,37893,50,47308,55168,46,0,0
25140,468,21053,24494,290,22456,27049,178,0,20333
25139,155,0,100671,155,0,100671,0,0,0
25136,652,28457,42861,301,34844,60218,351,20673,27560
25134,144,0,55891,60,0,103702,84,0,0
25133,295,28438,36334,210,36250,42262,85,20542,21688
25132,74,0,53170,20,0,0,54,0,0
25130,1304,41406,61706,899,58042,70793,405,29327,34029
25126,22,0,0,22,0,0,0,0,0
25125,443,55329,73246,361,72981,82286,82,0,31530
25124,481,63576,99572,313,85625,90513,168,0,116448
25123,1117,44911,76068,766,51278,90725,351,33699,41915
25121,404,36648,45506,344,37216,49363,60,0,0
25119,115,0,28123,92,0,33302,23,0,0
25118,349,46131,52799,212,49750,61175,137,40947,39839
25115,55,34208,35598,46,34405,35807,9,0,0
25114,107,12153,27340,54,0,27448,53,0,27232
25113,242,29286,41704,141,32208,55516,101,20865,21004
25112,0,0,0,0,0,0,0,0,0
25111,230,23636,49393,152,0,69287,78,9375,10624
25110,230,45220,39096,139,45975,45585,91,25208,29186
25109,257,35594,42842,117,0,64746,140,0,24536
25108,160,0,33490,92,61094,46849,68,9524,15416
25107,257,0,63033,119,107054,108977,138,19545,23414
25106,252,29583,38701,152,0,46934,100,19405,26187
25103,91,0,29963,35,0,35603,56,0,0
25102,99,45923,47622,83,22054,40275,16,22778,22350
25093,107,0,44678,68,0,27778,39,0,0
25090,86,0,62363,71,0,71861,15,0,0
25088,72,0,17428,27,32656,36059,45,0,0
25086,252,49853,61179,148,63500,67025,104,33750,49675
25085,352,32031,38561,240,45625,43734,112,25882,26563
25083,196,0,66963,156,66667,75983,40,15769,18888
25082,571,76581,102784,443,87188,106871,128,0,85759
25081,533,75813,76142,395,78902,92271,138,35595,29974
25076,117,0,37556,84,0,39965,33,0,0
25075,330,22000,26423,207,28839,28684,123,20861,20170
25071,4668,55117,78615,3191,69135,86779,1477,27156,59432
25070,645,64563,64427,406,68988,78759,239,0,39977
25067,403,44345,54594,347,45764,56015,56,21071,33593
25064,4176,42857,50532,1991,64495,67404,2185,27765,34982
25063,739,33854,38094,522,37000,42281,217,23197,26776
25062,71,21563,34027,32,0,52844,39,21563,18585
25061,206,0,51972,108,0,42154,98,80524,62793
25060,133,32750,37056,74,34214,56038,59,0,12493
25059,177,62750,79333,144,66500,92973,33,28417,0
25057,53,41691,40211,53,41691,36855,0,0,0
25054,72,0,0,72,0,0,0,0,0
25053,1598,50000,61178,1068,63409,71771,530,23158,39313
25051,57,0,67146,57,0,67146,0,0,0
25049,156,0,66079,129,90795,76909,27,8967,14337
25048,18,0,0,18,0,0,0,0,0
25047,55,22148,37847,24,61667,56588,31,0,0
25045,1779,32565,42277,1295,43322,49404,484,16875,22104
25044,104,42328,47560,44,0,43861,60,50278,50272
25043,656,29500,34510,507,43798,38192,149,15721,19603
25040,279,78125,67020,183,81688,86980,96,27742,28972
25039,391,37079,49165,320,43333,54588,71,0,21210
25036,69,0,58328,52,0,0,17,0,0
25035,341,26479,61724,272,0,72275,69,13750,20135
25033,636,48462,57372,431,52159,65676,205,28378,36803
25031,261,45750,48839,131,0,43439,130,23889,30181
25030,131,51042,53711,119,51193,55753,12,0,0
25028,159,37614,29174,63,38917,35698,96,0,24893
25025,50,0,0,50,0,0,0,0,0
25024,216,24224,40681,120,0,55603,96,25000,22027
25022,137,53050,42328,114,54200,48986,23,0,0
25021,194,16667,25381,80,37000,36895,114,16299,17301
25019,178,34597,41168,151,39018,41804,27,0,22893
25015,1679,43813,59551,1078,69167,79684,601,19006,22893
25011,248,39079,56431,153,84531,77272,95,15375,22866
25009,409,27480,45216,314,29688,45509,95,13856,42869
25008,79,0,63510,69,0,61359,10,0,0
25007,138,38819,40325,107,39896,51614,31,0,0
25005,89,67604,58027,44,71146,77966,45,30481,38533
25003,1064,54672,62042,781,67723,71543,283,22617,29905
25002,0,0,0,0,0,0,0,0,0
24991,315,47146,56670,192,65917,61983,123,46325,41961
24986,2198,35288,42708,1236,38868,52814,962,18432,25034
24984,91,0,28430,28,30833,30232,63,25000,27629
24983,1023,30881,49061,623,38147,62500,400,24125,27053
24981,245,0,81343,226,115184,84723,19,0,0
24977,159,37188,57898,105,0,64649,54,35714,44772
24976,455,44073,65989,265,69688,88234,190,35759,34961
24974,153,28073,40847,104,42778,51798,49,0,0
24970,2006,38654,59586,1327,46793,74868,679,19464,29242
24966,577,44196,54175,388,49167,47841,189,0,67019
24963,1562,55862,63336,1054,69224,71630,508,40556,38429
24962,41,0,0,41,0,0,0,0,0
24957,104,230566,175328,94,230802,185524,10,0,0
24954,1743,31726,63113,1029,54639,81396,714,24961,34343
24951,674,50278,48877,464,53770,48576,210,36333,46481
24946,435,54297,66452,291,75179,83788,144,0,30373
24945,154,31048,36091,109,40268,44939,45,0,0
24944,160,43056,50595,121,48750,51145,39,0,25515
24941,385,48168,47268,289,49024,53309,96,19762,29080
24938,563,65524,75342,434,68750,78290,129,0,62279
24935,254,28644,41160,117,58641,57963,137,27383,26811
24934,151,40781,55951,96,50167,65508,55,0,39269
24931,449,25625,51860,277,65057,69922,172,18068,22771
24927,166,18170,25702,29,81458,69203,137,17522,16493
24925,235,26382,38088,132,36500,49567,103,23652,23377
24924,179,40208,53301,150,46500,59700,29,25486,20203
24920,89,0,51948,53,44583,79349,36,13500,11608
24918,826,52800,55423,600,54500,61623,226,35179,35178
24916,357,63635,70631,350,63708,70800,7,0,0
24915,274,37059,55471,164,42500,69870,110,0,32114
24910,1818,36190,51881,1243,51094,59402,575,18875,30539
24901,4670,43066,66271,2285,71116,87659,2385,26323,45485
24898,0,0,0,0,0,0,0,0,0
24894,73,22171,27188,56,21974,24766,17,0,0
24892,653,24784,34055,444,28571,40309,209,15536,19967
24888,24,0,35679,18,0,0,6,0,0
24887,11,0,0,11,0,0,0,0,0
24884,128,31009,30826,92,31404,34941,36,0,20308
24882,330,71989,60705,297,72433,65785,33,0,14979
24881,145,35933,37995,84,36875,46281,61,24635,26585
24880,123,40669,35586,123,35958,29182,0,0,0
24879,188,29314,39395,161,28652,38012,27,0,0
24878,125,24013,20547,85,28750,26094,40,25000,8760
24874,1144,46650,69887,1019,50639,74356,125,0,27488
24873,207,65024,68202,187,65495,73525,20,0,0
24872,355,24512,24529,196,23810,23729,159,28285,25516
24871,130,25000,18282,130,25000,18282,0,0,0
24870,999,41636,59483,592,51214,56079,407,38527,62841
24869,150,28390,34300,64,29259,50572,86,0,22191
24868,571,19212,27621,384,18864,29097,187,16932,17242
24867,124,0,36742,96,0,0,28,0,0
24866,110,0,52884,83,70250,63636,27,0,0
24862,285,14219,18249,203,18264,23011,82,0,0
24861,44,25000,16418,20,0,0,24,0,0
24860,73,0,47516,52,61000,55487,21,0,0
24857,441,0,68115,355,0,78877,86,15917,23690
24854,86,0,117430,58,0,16643,28,0,0
24853,92,34125,42498,68,0,44349,24,34167,37254
24851,232,36284,40686,172,36800,46501,60,0,24015
24850,317,0,38213,182,0,55209,135,18327,15300
24849,125,31183,43526,125,31183,43526,0,0,0
24848,129,26042,50357,79,0,63467,50,27083,29640
24847,70,0,54259,50,83854,73932,20,0,0
24846,50,25000,3686,50,25000,3686,0,0,0
24845,93,33795,41462,93,33795,39345,0,0,0
24844,476,16061,29388,364,27500,34763,112,9487,11917
24843,42,0,35855,19,0,0,23,0,0
24839,601,41250,48000,394,46600,52296,207,38482,39822
24836,277,40493,46878,182,67768,56111,95,32989,29188
24834,230,0,51168,167,73831,61863,63,0,0
24831,72,51500,49278,67,51917,52370,5,0,0
24830,64,0,22114,19,37083,38458,45,10446,15213
24828,247,31350,34015,163,31696,37214,84,20179,21813
24827,519,46809,50415,476,47083,52198,43,0,0
24826,24,0,0,7,0,0,17,0,0
24823,188,39432,38824,155,38352,34858,33,0,57458
24822,439,48828,59659,260,0,92743,179,10828,11603
24818,430,38488,49481,301,57019,59079,129,24325,25764
24817,385,19956,53548,218,0,72625,167,17666,16168
24816,11,0,0,11,0,0,0,0,0
24815,279,24094,36630,168,45278,48996,111,0,17914
24813,0,0,0,0,0,0,0,0,0
24811,247,0,43566,247,0,43566,0,0,0
24808,224,41750,47536,171,65938,57589,53,15625,15100
24801,1473,24517,38640,872,30986,47573,601,18826,24660
24747,1222,32650,40871,850,33375,46562,372,30455,27294
24740,12981,45488,60895,8417,55960,68503,4564,25381,43205
24738,106,75203,66959,82,69333,60983,24,99250,0
24737,55,14464,16347,38,0,0,17,0,0
24736,209,37596,37035,117,39327,41704,92,0,29121
24733,204,0,46598,135,64792,55924,69,24077,28349
24731,67,0,33663,37,53646,50027,30,0,0
24729,83,36078,48110,56,29808,48504,27,0,0
24726,303,21504,46588,201,0,46795,102,16250,28237
24724,31,56313,57806,29,56438,61266,2,0,0
24719,13,0,0,13,0,0,0,0,0
24716,125,32113,39382,104,31488,40104,21,0,0
24715,156,33333,39401,103,51131,53282,53,9402,12119
24714,76,38750,32597,48,43229,46181,28,0,9311
24712,485,36902,50181,326,53611,58460,159,0,28995
24701,8488,34660,45739,5098,46269,56280,3390,22167,27096
24657,243,16452,27323,167,0,34222,76,11277,12166
24656,950,41029,64095,670,53784,77733,280,0,28023
24651,2015,47703,60424,1506,59444,70116,509,24871,29942
24649,1156,33372,51606,779,48631,65692,377,19655,22502
24646,363,40898,39990,307,41216,43082,56,20833,23038
24641,2462,29830,51673,1351,53953,75967,1111,12412,21350
24639,1373,39583,49043,926,47292,56348,447,27259,31567
24637,1420,56887,64582,1057,66520,74156,363,31719,36704
24635,232,20357,32825,80,0,54725,152,0,20225
24634,194,26250,41868,112,51429,54352,82,20938,24113
24631,742,43293,47794,501,44438,54284,241,0,34303
24630,2641,46784,63719,1961,62578,76829,680,22273,22675
24628,86,0,34430,77,50272,37845,9,0,0
24622,251,22232,37107,137,0,49931,114,15682,18744
24620,1034,27118,62575,723,38958,80381,311,16233,18944
24614,2675,36750,49582,1693,46563,59095,982,19570,31574
24613,255,36406,37415,148,26667,29110,107,0,36049
24612,61,0,25880,47,0,30700,14,0,0
24609,2850,42939,54442,1946,52917,63949,904,28060,32964
24607,136,58182,63429,86,93750,76059,50,38182,41706
24606,56,66250,53813,35,0,0,21,0,0
24605,3424,46433,82513,2207,59646,103770,1217,34034,42682
24604,95,17664,16441,38,0,0,57,12298,14779
24603,387,29554,35970,207,31105,39188,180,25972,32270
24602,276,44792,74028,220,45000,81611,56,0,0
24601,0,0,0,0,0,0,0,0,0
24599,343,34967,52956,215,43188,65192,128,0,26175
24598,599,63527,64907,456,66410,72949,143,26490,37044
24597,457,44728,65825,365,64909,75304,92,29000,28175
24595,48,106184,98277,48,106184,98277,0,0,0
24594,571,52688,56907,454,54625,62066,117,39583,35426
24593,866,76591,80081,677,90215,92444,189,29219,35795
24592,5284,46956,60688,3425,60080,69209,1859,23504,40333
24590,3151,72675,85281,2325,88696,98780,826,31274,43921
24589,997,44191,60628,608,89659,83174,389,21250,24311
24588,4132,52616,61083,2748,54981,69947,1384,28179,40532
24586,2225,47188,59605,1554,66117,73996,671,16306,20637
24581,27,0,0,0,0,0,27,0,0
24580,243,46941,55337,217,46375,54154,26,58889,65204
24579,350,45978,50092,254,47446,58561,96,0,27682
24578,402,52892,65984,298,53775,76812,104,0,34960
24577,2067,33727,47323,1057,45313,59532,1010,21437,30835
24574,1450,53021,83780,1113,61414,93277,337,36525,42853
24572,6517,53856,64177,4287,68234,77992,2230,28333,35223
24571,907,59640,87179,649,62065,109295,258,24167,27438
24570,0,0,0,0,0,0,0,0,0
24569,414,51207,101474,355,55795,112734,59,24306,33729
24566,533,54250,57244,356,63659,66608,177,24246,38411
24565,388,41310,47198,242,48068,50431,146,0,41838
24563,2407,42808,55349,1607,53535,66882,800,20640,28880
24562,251,63162,64636,161,66094,79138,90,0,33651
24558,2740,33596,50372,1824,50473,62767,916,17415,25261
24557,3595,40754,52753,2242,52346,63804,1353,26109,32891
24556,1041,61250,83852,763,73344,99384,278,38571,39192
24555,989,34620,54035,518,65705,72501,471,23691,32703
24554,1499,49577,65152,1041,55398,75206,458,27917,36649
24553,807,56587,59541,613,56971,64021,194,44250,41998
24551,10080,81332,103548,7542,99871,118824,2538,39003,56537
24550,3045,63086,81800,2190,81343,96888,855,31834,40475
24549,1516,55272,60857,1192,56071,63420,324,35900,40346
24541,12630,41061,58351,7371,60788,73379,5259,25831,35846
24540,13389,39790,55894,8328,51516,68465,5061,24228,32193
24539,111,47390,44794,48,0,0,63,45625,41332
24538,2254,53618,64584,1478,63448,74055,776,34615,45553
24536,85,96771,107016,68,128125,119141,17,0,0
24534,501,34250,41285,316,53929,54151,185,14156,19310
24531,3413,51008,68049,2288,64889,72154,1125,24164,56222
24530,404,54167,51839,228,64432,62546,176,31154,37968
24529,644,51489,62442,394,67778,78129,250,22813,37721
24528,1514,47903,51769,1063,49589,57978,451,26103,31796
24527,1264,60263,70852,983,63242,77769,281,37083,46654
24526,579,60427,66683,434,61747,71221,145,47337,51404
24523,8059,55896,66035,5886,66031,74995,2173,32491,37413
24522,3675,55684,67424,2636,68356,76634,1039,26493,40297
24521,3834,64271,81257,2402,90000,99912,1432,24517,47251
24520,1003,51733,54283,650,75500,67931,353,11684,24678
24517,2131,41610,54565,1429,56781,63555,702,25076,32761
24504,3767,41096,57288,2165,59136,69649,1602,23313,37379
24503,7760,75445,97081,5065,93091,119874,2695,47791,51301
24502,16101,52768,64239,9583,67359,78413,6518,35987,42502
24501,10007,39256,49192,5741,50213,58372,4266,27564,35347
24487,174,68092,73625,158,68355,74534,16,0,0
24486,1131,57280,81216,764,86131,97936,367,31118,40181
24485,173,65341,62101,125,66250,66282,48,22222,27417
24484,214,55962,62169,153,67969,60784,61,0,65641
24483,329,72281,119354,250,99750,147104,79,33839,31541
24482,1808,59250,65910,1230,66313,75119,578,41700,40049
24479,707,65347,87632,429,95980,109032,278,43649,50900
24477,4392,64107,68729,3129,73644,78780,1263,29531,38128
24476,101,83317,75849,69,84856,91491,32,0,0
24474,190,50179,45452,120,52083,52226,70,27188,33840
24473,368,37500,62153,274,77647,77777,94,18913,16612
24472,841,31845,50810,491,40625,62248,350,27969,34525
24471,720,54839,68903,471,67325,77756,249,44053,48824
24467,955,77946,102772,701,86563,111833,254,68193,74225
24465,591,57813,74584,394,63269,81425,197,50510,51473
24464,205,29231,46771,195,29147,45895,10,0,0
24460,496,0,79527,270,81667,124346,226,14557,25982
24459,259,87841,84738,221,71188,80087,38,0,66997
24458,156,33571,58796,53,51250,53009,103,23906,61773
24457,143,26131,40517,60,0,53177,83,17950,18754
24450,5995,60980,79509,3857,70336,98919,2138,34541,43392
24448,173,40972,53932,108,82500,71166,65,25240,23794
24445,1085,48988,65539,652,62353,73333,433,42361,44774
24442,52,0,44712,20,72917,56330,32,0,37450
24441,2486,66167,69088,1726,71370,77826,760,30735,43125
24440,1163,58321,60731,719,66592,67281,444,36198,37524
24439,533,40439,64403,285,54408,66199,248,22500,60464
24437,552,71305,71645,483,71939,77464,69,28994,30909
24435,893,51115,81260,594,94722,109233,299,0,25690
24433,27,49063,45759,27,49063,45759,0,0,0
24432,177,67083,73408,42,84545,101538,135,0,63877
24431,1004,46199,62861,792,46575,67912,212,31450,37135
24430,776,22128,39745,464,40804,50539,312,17967,22724
24426,5661,46707,64688,3630,61833,72258,2031,30043,49675
24422,2616,43977,59043,1504,62353,72686,1112,22308,35098
24421,1798,77159,81324,1375,76676,85597,423,0,65352
24416,3406,41298,76529,2310,49740,72116,1096,22971,85072
24415,0,0,0,0,0,0,0,0,0
24413,109,48224,59906,86,49737,66470,23,40703,35361
24412,100,0,0,100,0,0,0,0,0
24411,12,0,0,0,0,0,12,0,0
24401,15783,53578,73235,9378,73041,91561,6405,32069,44104
24382,6446,47126,76159,3959,62332,96501,2487,33198,41963
24381,1462,52346,72341,1042,62331,74800,420,0,64354
24380,1245,43546,56368,787,60521,71472,458,19329,28480
24378,511,30337,40829,347,45074,50062,164,17353,21293
24377,203,46597,57798,138,0,58125,65,39306,37889
24375,668,49667,50845,488,63077,60088,180,17885,20923
24374,373,41125,55494,229,80972,63588,144,35100,42623
24370,2628,38200,44418,1707,47008,54273,921,17266,23865
24368,2188,56629,66185,1566,65595,74892,622,32500,36877
24366,198,45776,70592,139,51250,88201,59,21250,23631
24363,633,45063,59125,384,73239,72654,249,26298,38261
24361,1796,59167,63797,1288,64948,74445,508,26250,33410
24360,2313,66723,82274,1653,82953,96005,660,41522,46498
24354,5926,38069,52577,3892,52413,65635,2034,19871,26301
24352,439,50069,56269,305,0,69661,134,27880,25787
24351,185,17094,31418,37,48125,48765,148,15938,27080
24350,521,41910,71396,383,44438,83337,138,19615,26712
24348,1661,42466,76068,1104,55347,98998,557,19341,30558
24347,596,54650,62486,368,73092,71194,228,38214,46874
24343,3480,45233,54046,2338,59091,63461,1142,22135,32015
24340,2279,51533,68830,1587,55907,66425,692,27153,71512
24333,7054,41806,57590,4760,49463,66677,2294,23795,35897
24330,1195,36940,46941,735,53517,58621,460,17750,23866
24328,792,44853,49393,527,47265,56732,265,32750,34797
24326,503,36250,44198,324,58646,57633,179,16743,19881
24325,558,63421,62209,285,64803,67120,273,0,56292
24324,985,70272,80521,598,92500,85240,387,35987,70560
24323,320,49875,56651,236,62500,61003,84,0,44423
24322,26,83889,68277,9,0,0,17,0,0
24319,2699,46938,58589,1915,60736,67589,784,27006,33318
24318,223,57321,58296,160,80203,71098,63,0,23478
24317,1700,38116,59176,1092,59911,79505,608,13355,21284
24316,0,0,0,0,0,0,0,0,0
24315,1283,53022,64249,766,53607,70833,517,46383,51661
24314,575,46186,57820,373,57250,72963,202,20216,23390
24313,281,37176,45144,173,58950,52398,108,31750,33523
24312,913,27418,43799,656,36071,49106,257,24112,30253
24311,777,36125,47029,502,44483,55914,275,20875,27860
24301,5748,51190,59966,3629,56681,71816,2119,28307,36979
24293,4052,43411,55515,2610,55722,68361,1442,23479,30825
24292,176,32667,40102,108,34667,45755,68,19239,31124
24290,765,39702,56728,409,50288,62410,356,28000,43750
24283,871,34289,43633,538,55523,54657,333,20438,24946
24282,235,30852,44600,187,42361,53724,48,9038,9054
24281,921,31250,48483,518,61591,60814,403,24016,29489
24280,302,56548,67256,240,61094,76783,62,17348,27479
24279,1901,36121,43880,1281,50060,52676,620,20720,23692
24277,2078,29714,47776,1356,45600,61647,722,15449,21089
24273,2778,30577,47567,1412,55294,63447,1366,19976,30135
24272,228,19191,26084,139,26399,30591,89,11523,14838
24271,1174,30417,42833,594,49762,62527,580,17073,22631
24270,192,45603,51094,138,41778,48186,54,0,0
24269,132,41750,49602,73,64345,65934,59,21536,25908
24266,3904,41245,58671,2368,58222,77922,1536,19615,27561
24265,355,0,49848,272,73046,61714,83,9375,10965
24263,2578,35148,44295,1477,44083,55730,1101,21465,28439
24260,2001,29911,39045,1151,39531,50813,850,15200,22043
24258,657,41250,62308,438,63500,78047,219,25417,29756
24256,1399,26453,37647,894,32443,46908,505,17218,17538
24251,3170,45565,60154,2062,60263,76386,1108,18641,29130
24250,518,40519,43618,326,45417,52774,192,23548,28072
24248,1010,42500,49882,691,68105,61265,319,21863,25226
24246,181,30487,29950,59,0,0,122,0,29301
24245,366,42500,47481,221,56036,59103,145,25208,29538
24244,2129,35713,49605,1337,43958,59458,792,28021,31298
24243,634,48553,57461,408,56765,68626,226,0,35813
24239,70,31406,29963,31,0,0,39,0,0
24237,373,22473,34146,202,0,42016,171,20972,24849
24236,1192,35338,52048,879,39155,55860,313,24004,40382
24230,2945,44081,48753,2092,48500,55974,853,14489,30025
24228,2503,35108,52543,1574,41875,67084,929,19401,23457
24226,597,34250,133465,379,48125,196645,218,21250,23558
24225,947,22939,35108,480,46129,50263,467,13653,19532
24224,2279,38725,45904,1503,42950,50312,776,22500,33563
24221,220,51250,55689,171,70096,59068,49,0,28059
24220,347,44375,51298,305,46125,52207,42,0,25695
24219,4147,51868,63752,2976,60843,70623,1171,26571,41456
24217,109,0,40805,66,70208,58536,43,13750,13588
24216,1067,28542,46116,650,35943,45750,417,19476,45157
24211,4351,69652,93978,2944,85969,115215,1407,35230,47256
24210,7011,45417,61531,3970,66394,82317,3041,24955,33259
24202,5397,51031,62986,3881,61144,70872,1516,28805,38294
24201,6985,38068,58275,3926,54599,76149,3059,24460,34040
24185,355,68343,70151,315,68731,74930,40,0,32515
24184,1777,56605,83499,1217,56932,84046,560,56395,81288
24179,7824,55171,74031,5312,73482,85733,2512,35099,45833
24176,568,94722,133889,439,106125,155034,129,0,61930
24175,3278,77402,92645,2465,89055,102698,813,44031,60840
24174,1320,47672,56560,945,55945,67918,375,16036,19528
24171,3749,52967,67010,2330,63707,75645,1419,24162,51189
24168,116,0,25965,68,25000,9018,48,37941,40931
24167,75,0,39983,46,73333,59391,29,0,0
24165,571,35179,49724,296,47083,64038,275,26250,33979
24162,959,60331,57808,644,61842,67832,315,33313,34870
24161,161,43750,50284,143,43950,52594,18,0,0
24153,14678,67823,85100,9167,83644,102950,5511,38330,51228
24151,7865,50677,60816,5086,58934,68874,2779,33448,43065
24150,349,72227,80183,273,90203,91881,76,30682,38162
24149,1448,56875,74501,1069,65781,80772,379,0,52884
24148,3217,43884,54080,2163,60282,63604,1054,21935,32939
24147,508,46554,61931,282,60833,85063,226,23043,29480
24142,0,0,0,0,0,0,0,0,0
24141,9242,45427,63029,4600,73974,90731,4642,22784,32560
24139,461,27936,44863,248,0,69902,213,11272,15710
24138,592,74177,68582,527,74070,68648,65,40938,47952
24137,1514,56582,107006,941,66825,153526,573,14324,28362
24136,1332,61897,67984,857,74125,79872,475,42631,45818
24134,1963,59283,63999,1321,64205,73741,642,40074,42436
24133,907,44432,51898,588,57667,62332,319,18594,31367
24132,150,0,31595,45,0,0,105,0,0
24131,16,0,0,16,0,0,0,0,0
24130,0,0,0,0,0,0,0,0,0
24128,960,62045,80238,674,73667,89353,286,37500,52766
24127,1864,48868,64295,1215,79792,81224,649,20331,31900
24124,1712,51632,58691,1122,53974,64424,590,43750,45466
24122,591,62554,64984,460,63400,71476,131,25139,36773
24121,4397,73250,88797,3421,75656,97575,976,36034,52439
24120,693,45341,51858,426,61232,71044,267,21295,21246
24112,12825,38253,54441,7263,50843,67190,5562,26313,36536
24105,227,44396,53401,151,67868,68105,76,22308,24186
24104,1346,79556,127919,977,85868,138578,369,54875,94111
24102,632,44536,59265,346,63833,60503,286,30500,46764
24101,2376,69063,83787,1703,88125,94193,673,32235,50697
24095,1779,64441,79183,1264,69136,91508,515,40250,46865
24093,43,77813,71212,29,78438,81224,14,0,0
24092,1279,57578,77329,864,77500,77607,415,29469,43578
24091,3276,51425,61824,2106,63698,71553,1170,21439,37558
24090,1876,76625,99433,1414,91656,112396,462,54444,54328
24089,1379,40825,54048,638,53163,63573,741,39625,45023
24088,1527,36287,55466,1071,56838,66146,456,23977,28817
24087,1500,50238,87526,1016,54625,102572,484,34318,50186
24086,71,0,54045,13,0,0,58,0,50045
24085,1058,50704,57646,680,54464,71257,378,24111,31541
24084,4709,52403,64030,3150,64914,78238,1559,25375,33568
24083,1183,103942,110151,859,110337,124765,324,73578,70403
24082,222,0,69535,141,92578,97608,81,21023,19637
24079,789,42755,65439,526,47500,71950,263,29677,47994
24078,2864,39471,47548,1626,48947,58352,1238,23735,31792
24077,447,50423,142441,224,88333,256788,223,17166,27581
24076,479,60046,57102,343,67109,68548,136,24167,28237
24073,12330,63064,79435,7665,81143,94306,4665,37432,52534
24072,415,82868,72280,355,88674,76916,60,38088,44853
24070,648,64559,70996,433,93292,92237,215,23853,28220
24069,728,49643,60820,497,61344,76742,231,19861,25550
24067,912,60349,73390,667,64024,82712,245,35487,40881
24066,2110,57045,70893,1474,70051,79907,636,35435,46861
24065,2914,55195,76774,1881,76821,99182,1033,45278,35066
24064,1894,77714,90288,1446,86050,100938,448,39571,55293
24060,18210,54620,81252,8092,111311,131891,10118,26548,39977
24059,443,70438,79377,315,87768,81165,128,41154,74975
24058,82,0,65544,61,90208,84248,21,0,0
24055,5096,34047,49354,3156,49178,62910,1940,18653,26016
24054,2330,48350,55998,1610,57644,66477,720,22460,27971
24053,1180,37895,55266,748,61042,74238,432,23622,21044
24020,21,0,0,21,0,0,0,0,0
24019,11304,71003,82735,7322,83680,96535,3982,43915,53217
24018,15808,71597,105779,10399,97577,130852,5409,44354,53944
24017,9551,34423,49444,5493,43521,51223,4058,23177,43637
24016,4303,29407,51860,1065,45038,92575,3238,25625,37876
24015,6496,57952,74453,3239,73478,92787,3257,45425,54472
24014,7326,57129,88405,4306,80189,117697,3020,35449,44445
24013,2668,42111,52261,1630,52619,61382,1038,21349,30393
24012,12166,46381,58359,6890,54324,67708,5276,27332,43262
24011,407,52196,94371,61,156094,347828,346,50135,49686
23976,65,0,11714,0,0,0,65,0,11714
23974,1655,41586,51039,1145,53006,61108,510,23700,27616
23970,3312,52551,69441,1749,66063,79191,1563,26548,56263
23968,246,37833,47872,112,0,66488,134,0,32187
23967,468,48824,100054,274,32206,75557,194,31167,92098
23966,695,52209,70541,489,55493,82648,206,41121,35212
23964,540,47625,54297,342,65556,67289,198,30000,31856
23963,57,74081,89544,23,0,113474,34,0,0
23962,282,72877,65586,212,74340,73757,70,0,40840
23960,832,51154,55010,654,57708,60613,178,23542,29550
23959,554,58542,61774,370,68182,76048,184,0,33072
23958,970,43750,58671,621,60327,67559,349,0,42857
23954,920,40000,51474,590,55227,54594,330,19704,44300
23952,130,0,69084,115,0,74385,15,0,0
23950,1263,37301,57221,900,47750,62035,363,22417,38688
23947,1342,45439,58481,855,56887,71917,487,24401,34017
23944,1354,43396,51170,872,46333,56647,482,24625,39451
23943,0,0,0,0,0,0,0,0,0
23942,538,40987,73691,385,56442,92105,153,17212,27355
23938,136,52875,52478,62,90179,82089,74,0,27670
23937,733,39250,53860,467,58142,67701,266,29600,26230
23936,2350,48527,62074,1536,60459,74354,814,31667,35861
23934,260,118500,84998,214,135270,102356,46,0,0
23930,2160,46755,56311,1244,63000,73514,916,20000,29530
23927,1981,57368,79554,1208,64034,102965,773,29669,40743
23924,2561,38544,53420,1573,61825,68897,988,22535,28106
23923,1111,40477,51541,705,53417,64588,406,21645,27427
23922,921,66228,75355,687,76639,85404,234,43594,42136
23921,708,55938,80996,421,86964,114927,287,22321,31223
23920,1307,47524,65329,922,46989,57309,385,26615,37761
23919,1099,58102,71688,808,73214,77870,291,46791,52132
23917,985,60774,76414,715,71650,87817,270,29500,43999
23915,284,39667,56147,200,0,61422,84,38056,34832
23909,0,0,0,0,0,0,0,0,0
23901,6128,44069,67616,3180,74226,90601,2948,30321,41406
23899,233,0,46369,115,63750,68609,118,21463,24157
23898,821,68306,72103,504,91000,93291,317,37344,36943
23897,263,45375,47193,99,61213,57763,164,38889,40809
23894,280,96731,85563,179,97180,97997,101,0,53940
23893,144,57303,75528,92,55592,53885,52,89091,113817
23891,0,0,0,0,0,0,0,0,0
23890,1627,59073,75434,1162,58585,82840,465,36047,45207
23889,299,47772,48857,197,48542,58062,102,33661,31078
23888,901,53510,61157,603,70417,74145,298,25000,31014
23887,95,0,195042,76,0,235150,19,43250,34611
23885,982,68214,87269,689,80644,102983,293,34005,41013
23884,0,0,0,0,0,0,0,0,0
23883,839,67396,82499,620,81048,93422,219,34625,50021
23882,712,52174,60679,485,70331,74952,227,24943,29698
23881,954,47000,58225,544,55132,68119,410,33173,42185
23879,227,62583,75670,178,67955,88745,49,20694,28173
23878,549,77563,75238,412,80000,88335,137,0,34907
23876,136,43854,59084,70,0,75883,66,42813,41268
23875,4671,66511,84318,2953,79628,97734,1718,48544,58797
23874,365,53040,65135,254,58000,76832,111,29821,33514
23872,1052,68636,75901,643,83131,93423,409,36607,39905
23868,1984,32000,56274,1282,46613,65654,702,22990,33596
23867,950,45313,59996,625,60125,68944,325,30082,41820
23866,827,64023,72163,605,68811,75768,222,38462,56281
23860,10717,46410,63215,7108,57599,73426,3609,26420,38441
23857,349,60893,63685,150,0,84596,199,0,47923
23856,445,50142,62141,260,57300,74265,185,44940,45102
23851,5574,57774,64508,3751,71322,77347,1823,26081,36852
23850,375,46674,64608,249,0,70516,126,45976,51306
23847,5045,37367,55387,3133,52172,69934,1912,24091,30285
23846,320,56058,57758,168,66042,67098,152,48478,47160
23845,211,82883,76218,105,83189,69543,106,0,82830
23844,279,36910,53990,205,61005,66181,74,19868,20215
23843,207,58257,65544,114,63750,88952,93,34271,36849
23842,2520,84544,91900,1989,87112,92388,531,44766,80395
23841,1182,62979,95834,776,97759,123540,406,48750,41090
23840,777,73708,92403,686,80488,100241,91,0,33321
23839,317,77614,84136,266,103750,95075,51,16615,26557
23838,5913,111040,131336,4858,121524,144360,1055,50195,69027
23837,1783,48456,62575,1212,62431,73782,571,42541,38168
23836,4619,86016,99172,3182,94479,113671,1437,49560,65229
23834,10534,63356,77124,7216,78293,88519,3318,37043,44610
23833,988,61486,71429,642,67331,92162,346,23700,31275
23832,12269,91024,103614,9519,96195,112374,2750,52452,61615
23831,13742,79476,94506,9978,89513,106829,3764,44684,55094
23830,522,99844,101269,450,90714,103241,72,0,33350
23829,405,89792,96451,335,100625,105604,70,35833,36510
23828,178,63056,53965,107,73472,77604,71,9583,17932
23827,564,50870,67248,435,69886,77112,129,0,33184
23824,2571,46502,73319,1784,53022,89269,787,22829,36237
23821,732,53500,60875,465,56369,71606,267,18801,35222
23806,0,0,0,0,0,0,0,0,0
23805,7626,56025,76060,4278,76039,94845,3348,41425,50172
23803,15384,47718,61211,8702,57370,73201,6682,33795,42297
23801,1411,68942,78249,1370,69615,78064,41,36750,53868
23709,0,0,0,0,0,0,0,0,0
23708,5,0,0,0,0,0,5,0,0
23707,6016,48581,65722,3447,54646,76225,2569,37035,48308
23704,7823,42226,54522,3936,54027,65487,3887,30689,40796
23703,9355,70448,82665,6467,79543,92883,2888,41909,55283
23702,4633,41744,52398,2812,45000,56036,1821,31504,43268
23701,8818,54086,65909,5245,59004,70474,3573,42397,54603
23696,1311,107688,128602,1158,115769,138107,153,38125,50005
23693,9081,103082,125361,6648,126458,140552,2433,64821,80564
23692,7422,88434,101476,5433,103941,117052,1989,43931,57238
23691,22,0,77036,22,0,77036,0,0,0
23690,1470,97000,107698,1136,117541,120957,334,30909,61427
23669,15951,54411,74884,9455,74049,90728,6496,34588,48246
23666,21885,58887,71661,12712,69181,83303,9173,40850,51268
23665,1510,62319,70064,1445,61582,69666,65,66186,78572
23664,4271,72537,85433,2609,90803,100421,1662,51121,60879
23663,5316,42574,60186,3386,50330,63866,1930,33176,51113
23662,4614,100981,111406,3578,118771,124645,1036,53352,62106
23661,5410,55775,70488,3177,64153,82244,2233,46607,52634
23651,206,97083,106860,79,118125,141280,127,71477,84213
23608,15509,59980,72715,10121,71646,83867,5388,38860,46335
23607,9166,33887,45707,5042,41931,54294,4124,23231,31562
23606,11187,55621,80657,6287,73964,99985,4900,41627,52588
23605,6115,40758,51629,3201,47713,57886,2914,30906,42000
23604,734,62708,66243,665,62753,67864,69,46188,42822
23603,1282,59242,68650,933,71863,74580,349,44297,52661
23602,16612,62488,79654,10240,75806,90421,6372,48873,59727
23601,11082,55342,73710,6718,71330,90293,4364,38585,46995
23551,0,0,0,0,0,0,0,0,0
23523,2705,32268,44343,1735,41020,51163,970,29028,29201
23518,12289,60243,83474,7697,69144,97854,4592,45015,56914
23517,2281,49175,74521,636,87000,121029,1645,41366,55049
23513,11622,52373,65617,7618,61477,76244,4004,30000,42323
23511,198,60682,79238,198,60682,79238,0,0,0
23510,4235,61650,88609,1665,72837,95840,2570,61113,83668
23509,5001,56900,78065,3039,64754,89277,1962,45811,57622
23508,6370,63678,84957,3354,95929,117151,3016,32598,47072
23507,3239,75799,116124,1413,139514,184417,1826,43915,61643
23505,11789,49825,75006,6347,55548,91894,5442,38465,52073
23504,7993,30546,45671,4856,33702,50741,3137,22201,35339
23503,13693,56635,70524,7725,67553,80408,5968,41492,55310
23502,7983,58952,76556,4760,69493,85520,3223,39801,59513
23488,326,46485,47537,282,46354,45817,44,71071,58559
23487,2310,66832,79276,1521,95169,97354,789,32578,41967
23486,19,0,0,0,0,0,19,0,0
23480,183,41125,49148,129,55096,55329,54,35000,34381
23464,28031,80013,96379,21002,89432,105819,7029,50122,59361
23462,26805,64400,76005,16871,72651,84183,9934,49192,58456
23461,0,0,0,0,0,0,0,0,0
23460,0,0,0,0,0,0,0,0,0
23459,274,51000,58569,261,51375,58116,13,36250,30754
23457,1699,87755,108304,1269,96051,124138,430,32955,57557
23456,19116,111087,129412,16055,117650,138590,3061,59909,74916
23455,20340,73856,105159,13117,92706,123917,7223,51240,68183
23454,22368,83650,107324,15371,98380,119143,6997,54195,76973
23453,12279,69952,81749,9155,77211,88330,3124,48129,54022
23452,21603,71224,103400,14425,83828,122610,7178,46833,60981
23451,19924,80045,117709,11095,107583,147720,8829,55483,78003
23442,391,0,50076,317,0,49482,74,0,52619
23441,34,0,0,15,0,0,19,0,0
23440,227,31607,52691,163,43750,62754,64,0,27064
23438,670,71860,127357,435,85750,159735,235,0,53745
23437,1830,67766,79407,1210,84459,94529,620,37273,47836
23436,387,123828,212343,332,151000,240740,55,31250,40924
23435,11807,98870,121682,8579,111185,137323,3228,57356,75101
23434,18776,66840,83050,13338,82101,96213,5438,31425,45907
23433,519,119896,174914,398,140833,204937,121,43472,73504
23432,614,115385,107684,485,118967,122006,129,0,48389
23430,6968,82894,108745,5075,103248,125919,1893,40066,60181
23427,130,29375,47655,87,0,56955,43,25625,28242
23426,36,0,41542,32,0,0,4,0,0
23423,133,38698,42744,84,59643,51299,49,29821,28082
23422,38,0,39571,22,0,0,16,0,0
23421,1530,41600,64594,958,59091,70138,572,16786,53514
23420,1093,37917,54058,762,63468,63067,331,14233,30771
23418,361,63614,71662,198,63929,72378,163,60125,67761
23417,1794,46009,76008,1010,61769,101954,784,25972,42285
23416,104,0,31268,55,61597,50367,49,0,0
23415,642,28021,32267,524,29630,32757,118,22862,21667
23414,104,0,0,104,0,0,0,0,0
23413,289,42396,65457,136,53750,89636,153,37054,39878
23410,691,42329,66275,492,53900,79191,199,24890,34329
23409,49,0,107384,38,165125,133913,11,0,0
23408,69,23776,28541,58,0,0,11,0,0
23407,198,0,59810,147,0,69969,51,0,0
23405,482,73235,91488,327,83750,102721,155,72831,67788
23401,149,35382,38697,79,28438,35711,70,36250,42067
23398,27,55469,54741,8,0,0,19,0,0
23395,152,38013,50879,152,38013,50879,0,0,0
23389,65,0,0,65,0,0,0,0,0
23359,413,0,66726,303,0,57996,110,0,89419
23358,63,59816,60389,63,59816,60389,0,0,0
23357,272,60769,66477,222,61875,67704,50,30645,61032
23356,553,59886,76654,445,75854,78288,108,0,68977
23354,89,147639,165442,76,149444,190200,13,0,0
23350,1484,52344,70434,991,62313,84268,493,17471,36597
23347,317,62750,107567,218,71979,131327,99,47150,55249
23337,205,27067,48926,70,107600,86049,135,26361,29676
23336,1685,53580,74040,825,81875,103511,860,39605,45745
23325,7045,68012,87244,4901,71236,98906,2144,46522,54370
23324,8246,44883,58709,5904,49645,65552,2342,30913,36220
23323,13629,85308,102358,10748,93593,111917,2881,44703,58023
23322,21108,112332,128665,17437,123252,139492,3671,51492,68143
23321,13054,82324,103305,9958,95995,115629,3096,56792,60715
23320,23455,75816,93015,15319,91701,110381,8136,49228,58381
23316,230,41719,62990,182,51250,68655,48,20833,26585
23315,609,58682,78311,380,61029,90884,229,48688,53862
23314,3442,87155,100707,2501,103867,114513,941,45966,58303
23313,49,0,38796,0,0,0,49,0,38796
23310,1859,48863,71520,1174,71321,88516,685,36319,41027
23308,786,52024,66244,517,70729,75421,269,32292,46227
23307,237,48650,45151,141,57784,53383,96,0,30808
23306,411,69250,71715,263,74861,85160,148,33295,43945
23304,0,0,0,0,0,0,0,0,0
23303,157,40083,51194,90,68106,71359,67,0,24106
23302,26,0,0,16,0,0,10,0,0
23301,640,43488,60633,449,43826,67163,191,30734,30860
23294,7895,58420,72660,4306,76792,87495,3589,42002,50758
23250,0,0,0,0,0,0,0,0,0
23238,11095,81559,115357,6921,107773,146625,4174,48070,61205
23237,8854,65188,76111,6276,74156,83169,2578,40192,50777
23236,9534,84184,95027,6964,91510,104142,2570,55089,67230
23235,13197,82642,97461,8352,101201,115189,4845,51984,63316
23234,15536,52455,63875,10399,56970,69741,5137,35379,47193
23233,12714,102500,133136,8376,133115,158793,4338,57932,79343
23231,14530,61931,77881,8983,82051,92736,5547,34898,51923
23230,3531,58480,69352,1181,74771,92685,2350,41379,55749
23229,13361,83904,134175,9108,110728,165491,4253,46781,64138
23228,15112,53726,68944,8014,71926,83832,7098,42789,50609
23227,11724,55235,84693,6188,84102,110791,5536,36057,52954
23226,7322,109680,165512,4401,139479,213856,2921,62227,92305
23225,18071,54731,75953,8680,73197,92705,9391,38874,58916
23224,14529,40840,50714,7155,40951,51375,7374,37373,47249
23223,21989,45629,63835,10570,58772,78816,11419,37600,48815
23222,10252,41746,58798,5817,54116,70769,4435,29985,39514
23221,6994,83343,132533,2712,142500,201469,4282,60340,88437
23220,12287,46873,87865,4098,82078,138142,8189,34737,61841
23219,2943,50218,55727,391,78618,102158,2552,45784,48613
23192,2414,92273,125728,1882,110753,145002,532,33808,57543
23188,17701,88938,102843,12305,105712,119987,5396,46210,59658
23187,0,0,0,0,0,0,0,0,0
23185,18257,87930,120454,12109,109277,146392,6148,43267,65003
23181,2008,83590,95506,1548,92083,108030,460,35758,48477
23180,268,55850,62490,201,56675,70032,67,22426,31755
23177,356,70543,74936,175,73125,97611,181,49938,51181
23176,176,62925,88457,118,63868,102774,58,58387,59329
23175,826,55357,69983,467,78292,99428,359,20471,31679
23173,14,0,0,14,0,0,0,0,0
23169,404,37632,50656,278,0,59488,126,0,31169
23168,2766,78017,94593,2105,87377,106611,661,53891,52323
23163,25,0,0,18,0,0,7,0,0
23161,40,0,34330,15,0,0,25,0,0
23160,0,0,0,0,0,0,0,0,0
23156,496,56923,67954,355,82961,83184,141,0,27970
23153,515,111174,124586,360,112348,125791,155,56652,115343
23150,5058,66386,76480,3301,79628,91005,1757,44253,47420
23149,1105,72279,89519,673,86755,116493,432,48008,45530
23148,685,60208,68206,408,73750,85882,277,25366,41289
23146,1344,120777,130786,1042,132222,142131,302,81700,91641
23141,2841,88906,104332,2211,100875,114178,630,39600,62417
23140,2381,87242,104767,1879,105241,117441,502,50000,54730
23139,9528,92252,107923,7506,104615,119322,2022,45921,61255
23138,333,0,71873,147,0,97829,186,0,51360
23130,97,0,64132,34,0,0,63,0,0
23129,204,90577,117555,156,86346,118236,48,91154,107342
23128,272,99643,133933,88,98333,104255,184,0,148127
23126,163,70139,118579,112,0,152012,51,0,45157
23125,154,110926,98238,59,0,0,95,0,0
23124,1576,113000,121439,1343,116811,129783,233,54625,67247
23123,747,43672,48215,560,49766,54816,187,16595,19205
23120,3838,123393,144155,3380,137872,155919,458,38750,50177
23119,91,0,94563,91,0,94563,0,0,0
23117,3757,72954,91001,2912,78214,99622,845,48068,55867
23116,10595,117057,136658,8640,123871,147737,1955,60227,82823
23115,1,0,0,1,0,0,0,0,0
23114,7400,104643,120723,5320,119388,138387,2080,55369,72051
23113,9448,123380,189994,7295,151232,223354,2153,48940,74821
23112,20371,106692,175063,14812,114208,131409,5559,63640,286938
23111,14359,80116,101261,9725,97484,110950,4634,42126,78406
23110,318,48500,71180,248,58618,80106,70,26071,38011
23109,1085,67473,106856,625,90391,121356,460,46713,82924
23108,117,0,80036,41,106708,114549,76,0,0
23106,533,49583,78669,353,86875,92192,180,35806,40161
23103,2262,128015,190340,1830,146058,214126,432,0,89577
23102,1136,91111,109628,904,107222,120567,232,62353,63833
23093,5313,57203,78806,3792,68361,85362,1521,32253,53855
23092,424,31005,38613,99,56953,86989,325,30510,23877
23091,158,0,131730,126,0,154528,32,0,0
23089,2300,80227,86908,1454,110985,113650,846,28168,40945
23086,1307,68845,80081,1023,69418,85434,284,40987,57508
23085,168,0,97655,155,0,101862,13,0,0
23084,659,80313,107315,469,115417,134944,190,31806,38370
23083,776,91118,84645,544,107111,107893,232,38443,29318
23079,156,54028,65114,131,52292,68804,25,29063,34952
23076,338,88958,141290,204,0,155599,134,0,119507
23075,3819,45687,52910,2200,53775,65033,1619,26961,34762
23072,4834,64906,81058,3323,80873,91840,1511,36716,53978
23071,785,60719,74713,503,48125,69206,282,58816,61348
23070,308,106071,81771,226,118203,103262,82,13710,22539
23069,1062,73333,94031,764,106019,110036,298,43668,45140
23068,69,0,0,0,0,0,69,0,0
23066,109,62750,51331,73,63568,63475,36,0,0
23065,756,79122,79946,527,93839,100826,229,0,30426
23064,187,0,52073,122,0,58065,65,0,0
23063,1627,67372,90332,1109,95619,113422,518,15069,38322
23062,1092,48524,69992,647,80063,86465,445,40067,43012
23061,8241,78577,90912,5938,86899,100997,2303,50216,59849
23060,13209,89754,111081,9790,101859,125025,3419,60305,66983
23059,14547,119670,159119,11091,152609,188797,3456,45168,62158
23056,177,76020,95580,164,75592,93510,13,0,0
23055,514,46980,75932,441,46576,61824,73,0,158741
23050,310,66352,79519,194,67213,96026,116,43250,51912
23047,672,64057,116961,528,67833,130311,144,36333,68013
23045,25,0,0,25,0,0,0,0,0
23043,756,58661,73693,471,76875,84370,285,33646,55519
23040,1797,55795,63036,1207,64648,69772,590,45000,47967
23039,428,105833,142816,327,114050,163645,101,50515,75378
23038,672,62500,71878,525,49821,63522,147,68875,97690
23035,496,74038,97129,358,86019,107080,138,0,65231
23032,151,0,59822,92,0,69446,59,39609,44817
23030,1990,58828,82332,1247,79321,101306,743,30104,44762
23027,527,0,62418,269,71655,97619,258,17000,24499
23025,114,0,63907,47,143224,134570,67,0,0
23024,3879,78942,101723,2429,99743,116377,1450,39621,75449
23023,230,98810,96657,118,128359,134353,112,0,56940
23022,351,37292,58701,93,0,89156,258,33404,46853
23021,127,57583,58145,45,0,0,82,0,57572
23015,1464,101563,103688,1246,104886,109304,218,39730,64718
23011,414,105469,108220,200,108304,123451,214,0,93986
23009,2399,76089,88951,1929,86952,99102,470,39267,41373
23005,6462,75593,96264,4356,102842,118385,2106,37317,47755
23004,368,45278,48882,227,68934,66615,141,15078,20333
23002,4186,64123,80032,2883,76632,97919,1303,24102,40217
22989,19,0,0,0,0,0,19,0,0
22980,13255,50570,70608,7858,73077,88395,5397,32592,42906
22976,138,92361,101801,119,93618,114022,19,0,0
22974,1428,89528,118692,1110,95833,131515,318,61111,69944
22973,2348,50606,73680,1520,67273,93034,828,28529,35652
22972,181,0,112204,71,76250,104520,110,0,117164
22971,626,81410,112472,448,86176,144282,178,0,32410
22969,616,79205,68484,464,85217,72051,152,48929,54986
22968,3951,69755,91475,2956,81368,96967,995,65645,71660
22967,875,68373,85893,634,69914,97570,241,0,54107
22964,78,67833,69381,78,67833,68967,0,0,0
22963,6285,80508,121964,4519,90536,144052,1766,45496,59697
22960,3788,58544,68046,2535,62168,78555,1253,35605,40704
22959,739,56719,91335,512,66250,101894,227,49141,65664
22958,1051,79676,121248,803,108589,140529,248,46029,58816
22952,994,61800,67641,664,89621,88112,330,23744,25662
22949,624,0,48215,257,0,66372,367,0,26568
22948,80,42439,48914,53,0,0,27,0,0
22947,1902,105449,191927,1336,130982,233860,566,58542,90828
22946,67,0,87469,60,0,97558,7,0,0
22943,183,98229,134216,157,99063,145134,26,0,0
22942,3959,60923,80016,2891,77917,89732,1068,25882,41562
22940,450,79706,98008,377,81016,103049,73,0,71977
22939,2518,72500,87660,1778,86452,102475,740,36875,48184
22938,360,62000,98866,281,57303,98174,79,57708,76497
22937,800,74071,83210,558,92813,106773,242,0,28779
22936,1920,115523,139192,1479,128583,156727,441,70733,78169
22935,319,70486,95966,205,81131,122384,114,0,47713
22932,3188,93562,137026,2201,129646,171233,987,34819,57847
22931,99,76042,85073,48,84286,113775,51,61513,58059
22923,2373,89769,95736,1740,101161,103891,633,67604,71685
22922,818,67672,78297,617,82991,87684,201,43987,44778
22920,1620,88864,112077,1127,102452,135994,493,38125,54426
22911,7473,91777,110927,5019,106766,129039,2454,60909,71053
22904,60,25000,4082,5,0,0,55,25000,1149
22903,14865,60766,101719,7036,105130,145168,7829,38959,60691
22902,11107,68834,92730,6160,87016,111956,4947,51376,67265
22901,15170,74325,111586,8155,105527,144172,7015,49574,70846
22853,1558,54333,65193,1070,66197,77610,488,29167,34321
22851,2263,46335,58229,1560,63538,69733,703,23850,30040
22850,430,68750,97039,365,73262,106919,65,33375,38958
22849,1925,54282,64266,1350,59643,73465,575,26188,36179
22847,309,56635,66960,207,67361,80296,102,41250,39896
22846,702,72203,89313,575,71819,92224,127,65515,68980
22845,8,0,0,0,0,0,8,0,0
22844,2083,44707,65584,1227,69821,88113,856,18548,33290
22843,958,70854,95151,737,82625,107415,221,36723,51416
22842,2110,51818,73574,1477,72557,88194,633,37872,38415
22841,1067,63065,92174,683,84271,114532,384,40552,44176
22840,2058,77742,100994,1559,86935,109681,499,43917,72012
22835,4874,52320,62341,3238,62198,71041,1636,31113,41713
22834,331,73594,84688,275,73862,88734,56,0,52957
22832,326,51442,76586,177,71172,104258,149,45260,42583
22831,340,64722,75940,264,75536,83352,76,43726,45966
22830,847,64728,72382,726,71591,77347,121,0,40706
22827,4553,53340,68490,2884,66646,84050,1669,26922,37595
22824,2544,55781,70290,1663,70590,80082,881,37860,49008
22821,2331,64906,89076,1769,82589,92822,562,35122,73240
22820,105,39464,41051,52,38429,43208,53,48384,38934
22815,3319,62042,70989,2380,70962,78400,939,36051,47681
22812,3258,64617,85651,2033,85571,109873,1225,40640,43783
22811,224,65769,76676,160,50926,54554,64,69722,103178
22810,400,68611,89912,195,77022,122873,205,0,58558
22807,0,0,0,0,0,0,0,0,0
22802,10930,51770,76090,7213,65239,85328,3717,33800,52546
22801,13518,57443,78643,7459,77433,97309,6059,33559,52932
22749,72,0,84292,45,0,121287,27,0,0
22747,454,74700,113650,331,109178,138384,123,33558,47089
22743,56,0,149021,56,0,149021,0,0,0
22742,617,93523,98592,449,95197,97788,168,83125,88915
22741,67,40875,53788,58,41250,59724,9,0,0
22740,491,80336,80137,332,80116,80019,159,51406,68308
22738,517,71047,71385,372,92955,84349,145,0,35968
22737,1148,92969,103714,950,94438,110963,198,65972,64902
22736,390,55400,69826,254,0,77065,136,57100,54182
22735,892,72266,78907,625,98012,98288,267,19954,33541
22734,1196,78564,86848,928,88167,94400,268,50625,56071
22733,456,80183,109434,354,86250,125809,102,48534,50365
22732,45,0,0,13,0,0,32,0,0
22731,12,0,0,12,0,0,0,0,0
22730,61,0,0,40,0,0,21,0,0
22729,104,76667,68590,67,77450,96767,37,0,0
22728,1004,91752,103046,724,92106,112524,280,68750,70618
22727,2344,64590,90851,1684,72152,106915,660,38833,48258
22726,329,73906,92280,255,90268,106056,74,38214,40758
22724,759,114125,124010,619,152589,141673,140,0,42249
22723,75,35994,48729,14,0,0,61,0,0
22722,128,40982,56088,57,0,70947,71,40759,44158
22720,323,144306,165448,276,153295,177027,47,72639,86462
22719,38,0,0,38,0,0,0,0,0
22718,205,72138,79164,182,71974,81345,23,78281,61913
22716,352,147368,149220,257,"250,000+",192218,95,26375,32898
22715,448,81875,122018,403,85625,120389,45,50234,136609
22714,316,93750,148277,235,107750,189680,81,30184,28159
22713,663,70234,112664,565,80884,127488,98,0,24788
22712,2602,88649,107802,1986,99787,119687,616,53587,63790
22711,13,0,0,13,0,0,0,0,0
22709,509,74550,83990,503,74250,82692,6,0,0
22701,12087,76707,108988,8818,86765,98957,3269,41412,124983
22664,3765,63530,195680,2359,67780,80126,1406,46705,381854
22663,384,56711,96565,197,96985,139405,187,33693,47150
22660,670,55395,67998,498,49805,67306,172,31875,56369
22657,4202,53317,65546,2864,62908,73549,1338,27545,41565
22656,1471,100046,95832,1147,106339,108981,324,0,45792
22655,7775,85322,94567,5650,93807,104949,2125,54664,60450
22654,315,82533,84002,284,83553,88525,31,18558,22629
22652,566,68125,86279,364,85962,100841,202,55313,60039
22650,326,56196,73073,196,76818,93530,130,32155,42230
22646,25,0,38432,17,0,0,8,0,0
22645,1636,68500,87124,1120,84364,100023,516,32667,52909
22644,1013,60478,73798,710,69079,90541,303,15417,32947
22643,104,0,103847,104,0,103847,0,0,0
22642,1736,78148,95650,1247,81047,97805,489,62740,81375
22641,151,61314,66409,98,61923,76097,53,44861,48496
22640,143,67560,102843,57,0,187026,86,50469,47048
22639,212,0,100112,156,136538,126103,56,0,27707
22637,897,71106,70331,742,78906,74041,155,49129,52573
22630,12330,66931,85060,8394,82795,98791,3936,40369,49254
22627,333,0,164163,226,89444,220986,107,21875,44144
22625,1370,85000,99773,1132,88468,109737,238,34000,48326
22624,988,82813,96008,834,83198,95983,154,47969,74086
22623,240,111354,112342,137,107063,123500,103,97639,80679
22620,1082,121563,123383,832,126667,140624,250,41429,56904
22611,3386,85183,102016,2454,113819,123705,932,37438,42616
22610,674,63750,73817,399,76964,84056,275,34813,55195
22603,5856,72163,99262,3828,86389,106772,2028,46654,63157
22602,11016,81442,108978,8008,101833,125888,3008,53966,58876
22601,11185,61018,79219,6416,72970,95499,4769,38854,51610
22580,2021,73769,88808,1567,83813,97187,454,41900,51393
22579,29,0,0,29,0,0,0,0,0
22578,1261,79020,105739,913,98350,126323,348,41146,51598
22576,940,44111,76312,579,47788,86134,361,26250,58613
22572,2394,51317,77475,1655,54698,70083,739,33438,91609
22567,1144,62158,79829,952,65662,83546,192,29853,39511
22560,2797,50372,57973,1792,55365,65905,1005,33464,39980
22556,9601,116782,129238,8012,122568,136529,1589,54458,80187
22554,18043,124857,142129,14601,134238,151272,3442,76378,93299
22553,5060,101931,115662,4056,113343,124025,1004,62434,74668
22551,6696,87530,126572,5305,97205,140992,1391,44529,60777
22548,94,16469,17131,38,0,0,56,0,0
22546,6161,72299,100254,4639,84392,111226,1522,39825,61706
22542,738,72566,88238,536,73007,98497,202,52237,59455
22539,1039,81985,91026,818,86618,101105,221,36875,47537
22538,88,54722,57847,76,61000,65266,12,0,0
22535,163,61042,90471,114,65948,107050,49,0,47331
22534,920,61544,83637,569,89297,105088,351,35536,41489
22530,86,0,28183,78,0,25535,8,0,0
22529,7,0,0,7,0,0,0,0,0
22520,2347,59492,85353,1429,89250,115183,918,28160,38513
22514,952,63281,80240,578,86667,94877,374,34352,49768
22511,442,58250,79488,206,82885,110223,236,0,52660
22509,21,0,0,21,0,0,0,0,0
22508,5737,91971,103991,4519,100015,110147,1218,66816,77751
22504,61,0,60164,35,0,55329,26,0,66677
22503,1784,70215,81514,882,77414,110096,902,45000,53194
22488,276,41792,59174,193,42429,61163,83,38015,39828
22485,9231,97695,107695,6858,103966,120256,2373,52117,67523
22482,1528,60081,98766,783,71950,102928,745,44718,93531
22480,436,69545,282482,291,128194,384909,145,43232,76600
22476,131,103032,77054,44,0,0,87,0,55606
22473,2378,50568,66097,1694,60352,68361,684,27679,57497
22469,1000,45156,78729,617,84112,101003,383,38568,42848
22460,570,66071,70582,391,78781,84406,179,41250,40385
22454,762,49267,58654,423,70174,70161,339,48308,42253
22448,169,66146,85622,144,65625,85569,25,97708,81152
22443,4021,53727,70384,2108,78293,91621,1913,35213,46525
22438,170,58043,66032,99,85733,91183,71,22992,23685
22437,330,82422,78960,291,83444,84827,39,0,0
22436,313,53674,58262,204,58250,73477,109,0,29785
22435,1064,55585,65282,776,66146,70577,288,31786,46931
22433,123,66217,64263,85,62438,63874,38,0,0
22432,113,0,0,64,0,0,49,0,0
22427,1378,55847,66206,849,68036,77669,529,41921,47394
22408,10903,95173,107813,7774,103496,118841,3129,62346,73925
22407,19816,88622,106100,14897,99138,113700,4919,58137,74958
22406,9180,98266,116415,6829,115063,129642,2351,63274,70646
22405,11336,106319,123135,8316,122700,139261,3020,53276,71626
22401,11059,69528,93458,5646,94833,124093,5413,50168,58517
22315,11339,131330,155315,7779,151285,174435,3560,98850,107633
22314,18205,135928,177075,8044,194329,234483,10161,106530,131105
22312,10788,90665,117802,6597,84714,124491,4191,91309,100500
22311,7512,77284,104877,3769,77660,118629,3743,74638,86894
22310,11529,127470,148156,7465,151074,168866,4064,94527,106118
22309,12363,84963,118854,8544,95863,135787,3819,46964,74430
22308,4580,179271,209657,3450,207632,237136,1130,104524,120516
22307,4484,113622,180087,2553,162281,242869,1931,76382,95220
22306,11323,79632,107112,8012,87215,117032,3311,54399,78207
22305,7408,98611,127544,3635,128750,162538,3773,88340,91976
22304,22034,85719,110743,10280,98528,131346,11754,75150,88793
22303,7147,93886,114880,3210,125541,141451,3937,76036,92407
22302,8491,106609,145679,3653,163218,207667,4838,86597,98542
22301,5602,167286,195521,3344,226131,250320,2258,87538,112953
22214,0,0,0,0,0,0,0,0,0
22213,1612,157870,203917,1167,179281,231881,445,118092,127512
22211,40,131250,154473,37,133438,164786,3,0,0
22209,7672,108141,146169,2352,153906,219055,5320,91702,113672
22207,12053,193570,267234,9043,242642,310787,3010,103475,132890
22206,10571,109741,128476,4170,136951,148473,6401,92064,111988
22205,6696,184375,203081,4798,213450,233794,1898,87734,118628
22204,22914,92198,115425,11461,105309,136307,11453,80005,90637
22203,12900,112448,143601,4597,162843,177962,8303,92882,121716
22202,14537,120305,138745,5126,161992,189140,9411,101367,110682
22201,19717,130079,160441,7040,173839,209239,12677,112207,131871
22193,23960,103942,126598,19069,113252,135686,4891,66266,75353
22192,19322,104414,128505,14113,118349,140116,5209,83382,88109
22191,23196,86747,113757,16221,95238,119124,6975,68199,92902
22185,0,0,0,0,0,0,0,0,0
22182,9040,186582,231616,7013,218711,265686,2027,65625,103840
22181,5431,178434,228159,3951,200247,259970,1480,88269,132463
22180,8235,161799,211152,6199,196856,236105,2036,91165,123513
22172,3409,84978,115823,2486,113352,133099,923,42563,61050
22153,10445,145044,160238,8566,152222,171282,1879,100643,103122
22152,9730,131411,143495,7335,145646,157639,2395,77177,88049
22151,5527,129014,142395,4396,138750,152244,1131,73209,88946
22150,9398,100357,119926,6238,115297,129689,3160,61098,90575
22134,1336,57292,73140,964,66383,83631,372,35580,45955
22125,382,138000,142528,212,154500,175132,170,96250,98688
22124,6498,178500,233423,4938,209821,264482,1560,84464,131481
22102,11868,126667,222868,6761,174225,305195,5107,85811,110966
22101,10645,209659,308416,8036,"250,000+",355987,2609,76453,152486
22079,11476,112724,135713,9065,124635,143840,2411,73703,97132
22066,5725,224398,300954,5249,238490,313777,476,110833,146683
22060,2710,86385,130963,2218,86471,107284,492,80556,235072
22046,7032,158026,188017,4795,184513,224708,2237,86661,102040
22044,5149,81475,123562,3237,103059,141561,1912,65862,85098
22043,9424,110986,150177,6073,137349,171977,3351,90861,104340
22042,12778,116707,146271,8229,129116,162301,4549,92740,109777
22041,10788,75109,100551,5928,83549,116840,4860,66985,76925
22039,5707,214663,249666,4959,225953,260370,748,137857,177040
22035,166,46231,49807,17,0,0,149,45914,48814
22033,14989,118173,145295,9765,150553,170091,5224,81333,96058
22032,9937,154779,167863,7925,173594,185770,2012,77778,88044
22031,13179,120098,147800,8270,151655,171083,4909,80658,102827
22030,20145,121403,144972,13319,148454,169774,6826,78571,92226
22027,704,213919,250286,669,213632,240672,35,0,0
22026,5080,91657,108497,3819,91430,110062,1261,83675,93569
22025,6447,114098,138963,5058,123625,148285,1389,80766,92224
22015,14771,140108,158092,11738,153922,172882,3033,86250,96120
22003,18569,112823,136803,13681,128343,148763,4888,70000,93294
21930,58,0,0,58,0,0,0,0,0
21921,16339,74416,89498,11244,90817,103000,5095,44322,52592
21920,188,74318,70787,180,82857,70278,8,0,0
21919,1331,88039,110486,851,122583,148557,480,0,42990
21918,1568,83689,95886,1157,95521,104497,411,58083,70475
21917,637,87548,99798,490,84750,96829,147,93250,99837
21916,0,0,0,0,0,0,0,0,0
21915,1139,85693,121165,796,98013,125169,343,50984,111621
21914,391,88854,80187,197,64479,91390,194,91875,68487
21913,382,66667,79683,240,87188,87597,142,0,63065
21912,576,0,120122,399,0,154828,177,25649,41318
21911,3931,80863,91536,2909,98961,106046,1022,33634,43741
21904,2364,92765,104244,1820,100025,108590,544,55568,86712
21903,2213,77772,88949,1417,98787,109081,796,27885,45196
21902,90,0,0,0,0,0,90,0,0
21901,6086,84750,105593,4513,96862,116174,1573,55443,70200
21890,0,0,0,0,0,0,0,0,0
21875,2838,62543,70793,1778,71712,75495,1060,41591,60779
21874,751,45898,52932,527,49375,58414,224,26250,32192
21872,204,95125,77104,140,96458,98147,64,0,31073
21871,772,60784,64718,653,60664,65409,119,50536,57992
21869,439,53125,67750,281,66875,81002,158,36176,35766
21867,23,0,0,0,0,0,23,0,0
21866,39,0,47879,28,0,39461,11,0,0
21865,189,126597,133589,157,163490,153244,32,0,0
21864,254,0,65526,177,66563,78279,77,21964,30403
21863,1795,61857,85181,1136,71797,90898,659,35938,67809
21862,15,0,0,15,0,0,0,0,0
21861,249,70625,75851,184,70000,81178,65,0,50192
21856,286,45147,52004,253,36250,44656,33,0,0
21853,3789,37813,55433,2538,52458,68044,1251,11708,26868
21851,3061,38958,56489,1900,58793,73365,1161,20661,27958
21850,1216,63611,65457,825,71607,71814,391,44688,45778
21849,1355,52314,83615,936,62541,96704,419,38730,47260
21842,5340,61440,106806,2709,93015,152685,2631,40252,57903
21841,490,83692,100703,384,83924,117763,106,21326,26014
21840,157,69625,100659,124,0,104054,33,0,0
21838,753,75306,78318,530,77367,88661,223,28359,48452
21837,1139,69375,80207,881,75221,84499,258,52065,59328
21835,106,46346,55783,59,0,74239,47,0,27549
21830,1728,84297,91028,1373,92866,95877,355,45295,70720
21829,171,104886,102163,130,104773,103012,41,137560,99473
21826,1901,51898,66326,1101,68884,81789,800,36875,44071
21824,99,73047,63883,83,73464,69966,16,0,32325
21822,692,36346,64046,532,42581,71287,160,33462,31449
21821,390,36707,52319,221,58958,73446,169,14934,24403
21817,1876,45625,52162,1112,47137,60522,764,31250,37602
21814,111,90125,87975,76,105909,104538,35,0,0
21813,1075,77017,111863,780,96250,115105,295,40298,103140
21811,10471,72150,95808,7242,86635,109608,3229,41218,61371
21810,194,150490,130175,194,150490,130175,0,0,0
21804,14830,58336,73681,9104,66500,82323,5726,37654,52730
21802,0,0,0,0,0,0,0,0,0
21801,11059,56714,80758,6600,80000,99436,4459,26991,47827
21798,826,83500,107648,597,111875,120015,229,45221,54144
21797,2792,138077,172271,2200,155217,178345,592,66579,143317
21795,3651,72121,85048,2472,86369,97379,1179,35847,46849
21794,725,189531,260273,652,229000,281541,73,50987,62927
21793,3924,97593,115843,2992,116176,132656,932,42927,57632
21791,2053,89335,104612,1495,107847,121884,558,55068,55302
21790,63,0,67467,34,0,0,29,93750,87100
21788,4822,84224,104951,3633,97761,119383,1189,41588,52330
21787,4021,72240,88006,2755,83719,99161,1266,40448,62029
21784,12954,120344,141006,9993,137493,157742,2961,59671,81231
21783,3331,84104,94304,2704,89496,100721,627,43920,55827
21782,1634,77800,95314,1290,86131,102039,344,37031,52431
21781,14,0,0,14,0,0,0,0,0
21780,679,57396,103686,565,60074,111858,114,40208,59682
21779,565,79784,103484,450,113654,114313,115,68617,61108
21778,390,54531,72053,260,74375,87441,130,0,41278
21777,700,112155,130526,628,122292,134961,72,50882,59188
21776,2339,92429,102883,1799,101841,110112,540,59643,69728
21774,4695,141875,147089,3815,156077,159272,880,78125,89671
21773,1929,120348,132747,1561,121250,138555,368,94167,103480
21771,10351,131204,144220,8455,142020,158765,1896,54167,72420
21770,1898,146520,164129,1660,150494,172806,238,96167,103376
21769,4090,124439,147483,3338,139464,161811,752,48929,69389
21767,346,70400,63152,206,79926,69501,140,46667,53811
21766,329,51214,56911,145,61250,69630,184,50714,46888
21762,58,0,67062,34,0,0,24,0,0
21758,1740,100921,103425,1152,122500,124924,588,52903,55841
21757,948,83750,100282,696,105625,114759,252,51667,55830
21756,1155,70474,99095,933,76688,106538,222,46083,67591
21755,2054,112000,136612,1587,139280,155958,467,60223,68532
21754,2469,144688,157758,1976,151078,162586,493,68203,120431
21750,1525,46536,70780,1145,55852,77959,380,33426,47372
21746,0,0,0,0,0,0,0,0,0
21742,12881,70113,92972,8502,86358,108765,4379,40842,56516
21740,23453,49244,69521,14261,66658,84974,9192,29242,41872
21738,1249,199009,216645,1084,224342,235462,165,91544,91272
21737,713,"250,000+",308594,645,"250,000+",325670,68,128958,118304
21734,438,36548,56521,232,63542,83550,206,22037,25969
21733,336,86333,116097,314,87250,117327,22,0,0
21727,1975,77813,88409,1339,84236,102804,636,41686,55051
21723,245,233580,194181,212,248125,221547,33,0,0
21722,2161,73185,89827,1755,75334,94665,406,46000,56938
21719,376,66786,81437,253,75938,95732,123,52212,48950
21718,82,71071,91299,50,86250,112670,32,53125,54503
21717,44,0,0,44,0,0,0,0,0
21716,2148,77317,95596,1339,91930,120185,809,42098,51498
21714,47,0,179355,47,0,179355,0,0,0
21713,3835,92159,104481,2989,103945,116265,846,31250,57547
21711,456,81667,95382,393,84659,100683,63,0,62311
21710,1797,129250,136216,1280,145398,153384,517,62788,85314
21705,0,0,0,0,0,0,0,0,0
21704,5058,148914,168575,4322,156279,179908,736,77250,90115
21703,13858,91851,102623,9666,97701,109345,4192,61637,74997
21702,16096,86940,107015,10859,105403,123271,5237,52866,65075
21701,16163,86759,104887,9721,103122,122459,6442,60369,74337
21679,150,0,94682,69,0,141139,81,14178,55109
21678,765,52629,67406,443,71477,81660,322,32188,47017
21677,226,57083,83500,202,61250,76986,24,0,138333
21676,243,0,110395,119,96125,175796,124,46007,47632
21675,36,38750,36381,18,38750,37350,18,0,35411
21673,1337,71723,151739,910,88649,182661,427,34911,78067
21672,89,61042,59493,57,68487,71637,32,41071,37863
21671,353,53708,75790,238,66833,92505,115,40298,41197
21669,58,0,72164,44,0,92005,14,0,0
21668,697,61693,84868,522,77130,98600,175,33438,43733
21667,110,0,65595,75,66250,80392,35,0,0
21666,5201,104692,123645,3712,125665,148542,1489,41766,56050
21665,71,128125,340590,57,158194,395761,14,114643,115964
21664,215,46583,78649,125,71250,105243,90,32500,38983
21663,1725,73990,126197,1144,97803,158306,581,51989,56650
21662,191,135208,182623,141,0,212319,50,56250,98012
21661,1149,54583,74677,657,63698,90448,492,46500,53054
21660,1655,62883,76289,1235,68848,82162,420,37375,47095
21659,578,83625,104221,337,86472,121264,241,46984,74785
21658,1575,112870,137616,1222,125227,149761,353,50750,85202
21657,253,110208,113669,172,115938,138977,81,0,56811
21655,1894,66146,82836,1349,78972,94343,545,44926,51635
21654,651,79375,136497,413,82175,165995,238,49107,85086
21653,46,115769,110380,23,0,0,23,0,80204
21652,94,105417,123726,39,"250,000+",199546,55,0,69962
21651,1173,62311,84906,743,82917,101151,430,53106,54382
21650,107,80972,93733,80,81389,101434,27,0,70911
21649,576,63750,77026,479,52270,73194,97,81645,73511
21648,49,101094,97841,40,105000,117885,9,0,0
21647,162,94167,101925,137,94557,115798,25,0,25904
21645,542,71731,109898,382,117813,132751,160,0,44740
21644,26,0,62400,21,0,74005,5,0,0
21643,2209,62101,63970,1500,75000,77675,709,22538,31752
21641,41,0,52305,17,85750,74465,24,0,35517
21640,536,69118,71357,318,74333,82210,218,55278,54559
21639,1828,52273,67143,1289,60625,72522,539,41146,50297
21638,1971,110170,127830,1516,121687,144059,455,58155,70510
21636,353,56250,69760,275,65865,78252,78,0,35083
21635,870,101429,107700,500,124643,132169,370,44545,73887
21634,152,44500,57007,99,68854,70559,53,31181,31694
21632,2496,48289,71261,1610,54545,83467,886,36513,44322
21631,1030,59558,86536,815,68385,93950,215,36250,49928
21629,3319,65625,92169,2465,75191,105130,854,40260,49611
21628,164,65833,58452,84,67500,50454,80,55278,54090
21627,4,0,0,0,0,0,4,0,0
21626,27,44792,46789,19,51250,49837,8,0,0
21625,883,90257,105275,755,100208,115388,128,51667,45621
21624,55,85938,109480,28,109583,112175,27,74464,100389
21623,821,72043,89792,577,93359,105174,244,50732,52032
21622,294,44327,66272,202,62917,80690,92,0,34616
21620,5243,62210,84243,3104,91509,112369,2139,31683,41877
21619,2438,85208,122839,1618,114074,147704,820,46750,70534
21617,3609,106025,130095,2888,117278,144941,721,51176,64332
21613,7527,45087,67047,4622,63279,83532,2905,25401,38963
21612,221,95453,170725,173,95927,196014,48,51250,79579
21610,180,58958,74377,112,89167,88788,68,45833,49619
21607,262,81500,115279,212,74625,102170,50,97625,159900
21601,10602,68781,96072,6180,85957,119290,4422,42788,57880
21562,1211,46328,53531,817,53824,62712,394,23869,28169
21561,1048,52596,83892,695,72250,102088,353,33368,44745
21557,795,43278,44687,403,70078,64766,392,0,24044
21555,672,56667,78382,553,63083,85162,119,0,45273
21550,6143,55478,81231,4158,67563,99295,1985,30313,41651
21545,765,46850,68342,444,59667,86150,321,31589,41870
21543,137,31225,39314,79,0,45084,58,0,0
21542,255,49250,58313,201,48250,60690,54,43750,44443
21541,840,48509,63600,315,56458,102142,525,37361,40069
21540,35,39028,37463,22,0,18677,13,50417,41654
21539,1094,45833,62495,713,70750,74730,381,42525,37510
21538,307,92608,70427,258,93091,78971,49,0,21588
21536,1616,55122,75742,946,62619,82507,670,32885,59427
21532,5321,48546,61382,3146,64400,77829,2175,24943,35272
21531,887,38217,59564,500,53846,78109,387,26329,35419
21530,793,55369,64912,594,60000,65054,199,42656,62388
21529,216,46111,62971,142,70417,79226,74,35000,31778
21524,350,46875,58518,222,52778,59849,128,0,48688
21523,106,38774,37217,75,38844,43172,31,0,0
21522,96,64286,78399,85,65972,84629,11,0,0
21521,490,42353,52465,318,51250,58928,172,31944,31952
21520,859,62102,91089,620,73281,104363,239,33792,56167
21502,15749,51793,64913,9538,64446,78279,6211,30115,42385
21409,7274,124870,167568,5543,138375,190473,1731,74482,91041
21405,173,132344,155458,126,175500,183641,47,81375,79902
21403,13671,93305,131972,7675,124345,168368,5996,63724,81567
21402,521,83403,82417,266,77500,86200,255,100364,78471
21401,16944,112011,148605,9837,137864,177759,7107,78362,102223
21286,7912,88750,113501,4259,133057,156752,3653,45049,60255
21252,0,0,0,0,0,0,0,0,0
21251,0,0,0,0,0,0,0,0,0
21250,0,0,0,0,0,0,0,0,0
21244,13522,68596,82397,8860,75798,90017,4662,53256,64261
21240,0,0,0,0,0,0,0,0,0
21239,11731,56546,80203,6284,72652,90651,5447,41956,63622
21237,11493,78283,92727,7845,89130,101537,3648,52745,67120
21236,14826,82162,92944,10136,95761,103802,4690,54340,64407
21234,28640,70870,92954,16873,86936,101920,11767,50393,76502
21231,7694,73538,105099,2756,102652,133814,4938,65446,88042
21230,14835,85310,117722,6723,100932,137516,8112,72391,98664
21229,17772,46937,61960,10313,58478,73643,7459,32125,40573
21228,18971,91178,106625,11714,111897,128320,7257,51593,69695
21227,13148,67250,81819,8023,84576,95871,5125,37215,54514
21226,2429,88050,91902,1510,109342,112411,919,43633,57682
21225,12428,39831,56947,7508,54239,67765,4920,25631,36043
21224,19252,79975,104581,9550,80661,111220,9702,71765,92705
21223,8485,29590,47343,4068,33865,55603,4417,22767,37600
21222,21258,54456,70947,13481,62307,82209,7777,36440,45385
21221,15945,60227,77787,9882,73333,92695,6063,35633,46016
21220,15266,72414,89686,10285,82054,96993,4981,48417,67162
21219,3468,93864,121823,2707,108038,134640,761,35655,68009
21218,18308,51276,77499,8318,78433,108274,9990,38670,50359
21217,14263,31570,52780,5871,47809,70578,8392,24875,38098
21216,11103,42067,53745,5512,52981,67197,5591,30110,37435
21215,21569,39393,57823,11163,51505,73639,10406,26118,38622
21214,7937,72185,86829,5156,84412,100253,2781,45384,57704
21213,11129,44429,60608,6537,54674,70057,4592,31185,44189
21212,12243,81978,131819,8147,110146,163365,4096,48106,65663
21211,7782,71572,91786,2992,96238,111783,4790,59850,77836
21210,5130,102885,170517,2651,200018,252498,2479,54358,81424
21209,11359,83610,120219,7321,107519,146166,4038,51261,70752
21208,14789,83190,108041,8574,105610,138968,6215,51447,61463
21207,19066,57563,72311,11521,74054,86956,7545,41727,46683
21206,20100,55304,69697,11982,72570,82161,8118,40599,46223
21205,5251,33645,47626,3155,39785,50279,2096,21618,34707
21204,7773,85189,128316,3695,136380,188194,4078,53346,71237
21202,9865,51672,72366,2737,47173,84031,7128,52407,67386
21201,9731,45797,62742,2575,63250,81953,7156,43462,55718
21163,2439,119307,142828,1572,143333,169072,867,61469,89329
21162,1334,115804,119844,1033,135063,135139,301,0,64091
21161,2001,100694,125685,1695,106789,133515,306,64211,71317
21160,897,89931,116553,734,116000,125825,163,0,44720
21158,7880,91655,103397,5673,105929,119629,2207,49069,56072
21157,14075,90119,102228,9959,106679,120498,4116,37064,51837
21156,147,138083,142781,126,139833,152663,21,68750,83486
21155,896,120625,137422,690,125313,143510,206,73250,112743
21154,2287,102793,118021,1846,111774,133131,441,43021,48858
21153,150,44500,304522,82,0,406213,68,42286,181894
21152,2342,95581,145797,1593,116152,180933,749,53089,67273
21146,9556,152394,190531,7721,162841,210232,1835,69583,94035
21144,12100,112323,128540,9603,126632,138347,2497,67887,82489
21140,1450,124671,160243,1153,134531,170907,297,100825,112111
21136,13195,87407,121351,9547,105080,142035,3648,50134,61372
21133,11823,74904,88773,7829,90705,104442,3994,44050,52041
21132,1007,127865,129272,915,133187,133316,92,85729,74012
21131,2616,148010,206568,2230,161929,229048,386,72848,71451
21130,40,84079,70798,32,84605,86163,8,0,0
21128,5175,105995,133153,3642,145289,160366,1533,43101,64062
21122,22199,104967,121742,16383,117334,130875,5816,64348,89144
21120,2202,128571,169841,1786,146016,186387,416,81591,83153
21117,23125,91520,114543,14709,106365,133602,8416,61087,77140
21114,9397,120635,142018,6971,129986,155170,2426,76550,96445
21113,14449,99278,113858,9052,118218,130651,5397,61702,81745
21111,1821,134063,172425,1458,152857,191892,363,83218,89974
21108,6505,130505,150114,5383,138732,162772,1122,60250,76528
21105,0,0,0,0,0,0,0,0,0
21104,1964,171012,185170,1669,177402,199750,295,60234,79513
21102,4245,97399,115209,3301,114564,129376,944,52900,59538
21093,15293,105868,142900,10012,141009,176186,5281,56180,77227
21090,3627,94487,108539,2573,107679,117789,1054,71444,81441
21087,1984,102400,143394,1638,127794,159232,346,38182,47080
21085,6380,90765,107428,4606,100130,118611,1774,51875,68707
21084,2780,97964,116651,2227,101929,119554,553,45422,93318
21082,222,122442,154181,195,122464,157045,27,122344,133496
21078,7608,87560,115254,4988,110824,126291,2620,48207,90800
21077,117,160551,141900,97,161287,152155,20,0,92165
21076,7110,115769,131243,4766,126533,146896,2344,83200,97733
21075,12502,111195,127357,8919,125870,142665,3583,70853,86313
21074,5707,85266,106116,4022,104881,122600,1685,46080,61113
21071,157,103750,127161,121,178281,156258,36,0,0
21061,21596,71524,84574,13972,82411,96930,7624,47623,54822
21060,14077,80574,98947,9086,92041,113928,4991,51297,60925
21057,1555,120234,146960,1141,147336,168501,414,38500,86572
21056,172,"250,000+",325001,141,"250,000+",384822,31,0,0
21054,4054,134038,160572,3085,154743,182938,969,72371,78959
21053,1144,102955,128092,757,128429,146592,387,86306,88994
21052,66,80833,109883,49,98625,125302,17,0,0
21051,87,124375,139986,55,124792,153847,32,58056,76294
21050,6310,109547,130661,4974,128194,147599,1336,49401,61601
21048,3549,116713,148344,2842,132948,171910,707,37633,52666
21047,4449,125618,142015,3694,135944,155766,755,48724,70464
21046,6070,109159,129567,3940,119500,142021,2130,92250,101581
21045,15493,106209,119883,10737,124301,135388,4756,70846,79715
21044,18621,112206,137909,11913,135903,161353,6708,79331,92340
21043,16881,126892,152881,12564,154263,175412,4317,64442,83375
21042,14474,158858,188415,11663,178050,209945,2811,73876,94847
21040,8965,68705,76077,6586,76115,84127,2379,40880,46894
21037,7914,111142,138865,5732,126994,159458,2182,65750,75398
21036,794,175750,211831,573,188281,245371,221,49534,123661
21035,2847,151479,214517,2319,170903,236886,528,80912,101645
21034,1252,81579,96586,884,96548,113968,368,37083,47351
21032,2937,133750,185380,2155,157799,211972,782,57428,100881
21031,17,0,0,17,0,0,0,0,0
21030,9855,80453,119083,5540,109925,157912,4315,47489,67153
21029,3612,208906,229708,3295,216719,237904,317,110048,137462
21028,982,108958,130126,742,126759,154377,240,33670,48448
21017,2480,78354,82698,1569,80348,86812,911,75056,74221
21015,10317,118483,136737,8046,138173,155278,2271,44976,64576
21014,14128,95283,112530,9448,123455,135224,4680,45530,63335
21013,1792,147368,153934,1511,157063,167211,281,44821,79318
21012,7994,119792,145352,6177,137640,157702,1817,84208,86570
21010,133,80640,82750,72,81214,91893,61,59531,71961
21009,12299,99920,114032,8749,114438,126200,3550,68886,77688
21005,731,120583,119652,544,107000,124675,187,126932,102052
21001,9793,74237,88891,6424,96156,101348,3369,42814,61637
20912,9327,68662,108211,5620,100056,134327,3707,45631,60790
20910,20346,97944,120056,9657,132382,154942,10689,75414,87129
20906,25190,78611,101987,16471,91407,113756,8719,52882,75444
20905,5720,130811,156878,4890,143308,165948,830,71071,90762
20904,19428,85000,109558,13839,102805,123056,5589,58867,68164
20903,7428,67883,86539,5674,68257,89649,1754,46505,57087
20902,17150,94211,117613,12271,104284,130029,4879,58906,79297
20901,12669,112689,142956,9163,131774,155422,3506,72656,104207
20899,167,37279,44106,49,19950,25678,118,0,51758
20896,309,203750,240132,241,236625,267261,68,150000,137393
20895,6900,149934,186054,4800,186613,219392,2100,66364,106941
20886,12109,85578,109240,8442,99442,122907,3667,60477,70559
20882,4611,140428,179961,3952,150549,193733,659,55417,85619
20880,235,130536,140988,137,149375,161955,98,91667,111676
20879,8585,89163,113893,6484,102000,124220,2101,60881,74658
20878,22990,127957,165642,17497,151616,185860,5493,74627,94833
20877,12466,75531,94133,8369,83163,98085,4097,57599,78834
20876,9791,106061,125705,7894,112563,132913,1897,70665,83714
20874,21143,98007,119030,14991,107279,129473,6152,65577,87346
20872,4371,121896,135248,3460,132576,148093,911,59688,80239
20871,5723,136414,155147,4923,143327,161673,800,85893,104336
20868,149,0,150177,116,93200,131571,33,0,0
20866,4606,114195,128689,3784,122857,130875,822,96838,112725
20862,125,155694,132058,117,156806,139220,8,0,0
20861,725,158497,203821,593,158884,215443,132,126016,114101
20860,984,106772,153033,745,107249,174169,239,0,87146
20855,5487,137028,162600,4356,153686,178312,1131,78945,97431
20854,16497,210639,270704,13729,237931,300398,2768,85833,116821
20853,9733,120821,142987,7639,132196,152813,2094,60167,90222
20852,20626,105645,142000,10803,141215,175847,9823,81700,101946
20851,4980,92561,118518,3382,95988,126796,1598,65000,90344
20850,21275,114691,140835,13626,132165,161485,7649,84275,99935
20842,570,128542,176371,378,170357,216174,192,95278,89535
20841,3474,171598,189809,2989,186211,206167,485,0,83764
20839,30,188833,206940,30,188833,206940,0,0,0
20838,100,135714,217548,79,137411,260086,21,57708,57524
20837,2084,151667,158854,1702,173851,175615,382,38056,63307
20833,2408,178017,185146,2054,191111,202611,354,83256,82635
20832,8458,139007,158514,6889,153498,174442,1569,57214,79463
20818,780,181471,286771,620,186413,297441,160,0,245425
20817,13425,206592,283980,10446,"250,000+",334803,2979,71467,100112
20816,6124,202309,285164,4647,246985,334987,1477,85536,124090
20815,13048,163016,268666,7984,"250,000+",349457,5064,90850,139223
20814,13171,137962,193329,7112,201250,268428,6059,83079,102988
20812,109,141250,197199,87,174063,216080,22,73750,104268
20794,4162,95595,109311,2717,96806,120299,1445,79135,82321
20785,14354,74510,83221,8874,78927,90235,5480,60479,68877
20784,9677,71428,85140,6069,84741,95229,3608,52471,60111
20783,12047,66905,82846,8401,64463,83246,3646,51217,62850
20782,11400,68827,88021,7056,79943,102993,4344,45792,56570
20781,3802,86653,113900,2256,103646,112878,1546,55682,109564
20779,421,107689,134678,276,112083,174070,145,37228,57037
20778,888,149250,174573,692,149250,178340,196,0,149940
20777,1120,198111,246578,1024,202826,252418,96,174375,184278
20776,1181,96534,109135,785,109301,135942,396,38852,53657
20774,19052,113183,129779,11987,134416,149455,7065,80880,91263
20772,16403,116439,132646,11326,130435,146251,5077,81260,94513
20770,10309,70822,86489,5748,82914,95837,4561,58719,70330
20769,1900,143875,161285,1524,151389,169287,376,114167,119332
20765,209,0,135732,137,0,135068,72,173250,136996
20764,1365,98990,108021,1057,103843,117297,308,68380,72146
20763,858,85139,92533,460,110764,106864,398,0,62400
20762,801,76359,91965,632,74745,90916,169,103750,94908
20759,1565,174777,234355,1388,221250,252042,177,0,95660
20758,190,99853,129305,172,99853,132013,18,0,0
20755,2905,80438,96827,2411,73447,93271,494,106154,112599
20754,2304,133468,152201,1873,159102,169799,431,58194,68363
20751,838,91288,110647,496,98750,128270,342,67917,84766
20748,14957,72268,86379,8680,89844,99864,6277,53985,62384
20747,15704,65203,80024,9940,71650,88531,5764,52973,58948
20746,11394,69124,83278,6196,84814,99023,5198,51955,57394
20745,10641,68369,82036,6020,77106,92244,4621,55830,64478
20744,18678,111558,127805,12915,130501,143854,5763,76138,84662
20743,14833,65606,81016,8895,75883,93228,5938,52854,59619
20742,0,0,0,0,0,0,0,0,0
20740,9789,73315,96091,4516,107627,125702,5273,47079,66262
20737,6204,78060,94066,4468,84449,99029,1736,51486,64515
20736,3080,133750,152728,2603,143217,157071,477,87848,111954
20735,12142,112285,126972,8947,127849,142302,3195,66675,72003
20733,949,99663,124914,707,130817,144764,242,57857,66922
20732,4053,112771,127967,2818,124331,137944,1235,70859,95116
20724,6873,98811,109334,4295,109149,119967,2578,68924,81233
20723,11992,121500,150024,9279,147902,169612,2713,72247,74902
20722,1786,78478,94233,1104,81862,102758,682,55333,74610
20721,9944,138464,170863,7563,160438,187762,2381,101281,113842
20720,7624,142530,160542,6292,157707,168400,1332,104283,104555
20716,8712,103327,120440,5521,122595,135509,3191,87418,88131
20715,8949,122455,136006,6683,129653,147885,2266,81098,91440
20714,2014,82885,97124,1356,98580,99378,658,59038,79478
20712,4374,57494,72064,2089,81598,92668,2285,52545,52065
20711,2428,92614,111164,1892,94205,120159,536,50735,70847
20710,3709,50985,59102,1886,57097,76140,1823,40238,37851
20708,9584,71804,91097,5994,79049,98931,3590,52793,69933
20707,12033,85935,108402,7281,107891,125610,4752,66333,77138
20706,13492,83947,101935,10081,86932,106957,3411,69580,75081
20705,9868,92257,104223,6351,100554,116926,3517,64163,73920
20701,188,70686,68631,51,0,0,137,69201,67902
20695,3055,110859,121844,2179,125480,137719,876,48750,77054
20693,306,160395,153686,230,161842,166412,76,88750,113675
20692,295,156780,147422,217,170799,178382,78,0,61291
20690,379,139750,143736,351,139583,145946,28,0,0
20689,668,149500,169125,593,149050,164849,75,151250,121855
20688,836,110088,147731,569,111678,128952,267,49886,187183
20687,228,0,108826,172,125606,125377,56,0,57989
20686,87,0,0,87,0,0,0,0,0
20685,2325,118258,137425,1939,125139,142196,386,85305,93921
20684,331,119821,135043,235,168424,156709,96,95100,69533
20680,304,92708,95701,239,94401,111518,65,39896,37540
20678,4595,92479,109529,3172,114881,127675,1423,36289,63311
20677,778,141705,143680,607,181319,172103,171,35040,34340
20676,1322,114433,131551,908,146923,146223,414,78289,89752
20675,699,98318,101583,552,99568,113245,147,35785,43909
20674,365,0,109057,240,83056,105015,125,0,80986
20670,359,56813,74597,349,56938,75245,10,0,0
20667,295,63125,86340,180,0,101813,115,50145,50414
20664,1204,85750,102990,854,103203,110775,350,53112,77683
20662,933,55917,75611,648,65625,87253,285,32917,38854
20660,0,0,0,0,0,0,0,0,0
20659,7956,100000,111420,6325,110553,122173,1631,56016,64552
20658,362,72422,98364,227,80250,113663,135,51369,64857
20657,6990,100227,120700,4979,113790,133765,2011,55838,75010
20653,10645,75829,92475,6888,86066,100628,3757,60567,69050
20650,4996,111554,135976,3711,130322,153292,1285,62729,73369
20646,7757,114309,131374,5864,125520,137697,1893,56576,84389
20645,266,95000,158845,188,126324,197896,78,0,64722
20640,4180,72500,95458,2735,94283,109285,1445,57407,66358
20639,4694,127600,146407,4045,137212,152084,649,92250,94135
20637,1830,120060,139910,1514,122292,136400,316,96458,142095
20636,3854,123262,136489,3123,127128,147631,731,65898,81301
20634,2657,110377,108781,1632,126162,126294,1025,69720,80838
20632,88,109063,113931,85,108594,113246,3,0,0
20630,105,128950,141411,58,111875,94972,47,0,0
20629,208,50598,71712,144,51522,85974,64,46034,39620
20628,158,137426,135380,112,0,120590,46,0,0
20626,138,96071,142663,81,97411,161891,57,0,115339
20625,415,0,79104,346,0,78493,69,111397,82170
20624,434,100852,133884,321,131635,131336,113,85288,141125
20623,795,139306,149071,644,149310,161859,151,91469,91707
20622,1789,99306,118972,1416,111900,127661,373,58792,68017
20621,596,47978,91407,357,98285,130141,239,40404,33549
20620,592,0,89757,363,128882,109668,229,0,58194
20619,5154,102125,115246,3595,104953,120888,1559,77486,94827
20618,215,54931,78712,92,0,118018,123,52847,49312
20617,255,140208,180014,208,148846,175199,47,95536,83617
20616,2388,96625,107072,1551,104497,113509,837,69226,89920
20615,219,128036,166447,134,197105,196748,85,107415,118678
20613,4471,132835,149253,3574,159643,166808,897,58806,68129
20612,118,0,33139,78,0,44678,40,0,0
20611,512,97500,137463,346,131364,175555,166,45093,50846
20609,417,70972,94951,307,93150,111678,110,21033,28084
20608,264,69250,90283,172,76000,104835,92,65119,63076
20607,3739,140810,150116,2587,161018,166485,1152,103125,107573
20606,135,122344,129927,87,156146,150566,48,0,90373
20603,11248,122816,138473,8410,133401,151985,2838,81744,87187
20602,9987,88794,97570,6820,91531,102247,3167,68049,76933
20601,9317,104624,119433,7141,109978,127526,2176,81909,88650
20593,0,0,0,0,0,0,0,0,0
20566,0,0,0,0,0,0,0,0,0
20565,0,0,0,0,0,0,0,0,0
20560,0,0,0,0,0,0,0,0,0
20553,0,0,0,0,0,0,0,0,0
20551,0,0,0,0,0,0,0,0,0
20540,0,0,0,0,0,0,0,0,0
20535,0,0,0,0,0,0,0,0,0
20520,0,0,0,0,0,0,0,0,0
20510,0,0,0,0,0,0,0,0,0
20506,0,0,0,0,0,0,0,0,0
20427,0,0,0,0,0,0,0,0,0
20418,0,0,0,0,0,0,0,0,0
20405,0,0,0,0,0,0,0,0,0
20390,0,0,0,0,0,0,0,0,0
20373,0,0,0,0,0,0,0,0,0
20319,0,0,0,0,0,0,0,0,0
20317,352,0,56745,0,0,0,352,0,56745
20307,0,0,0,0,0,0,0,0,0
20260,0,0,0,0,0,0,0,0,0
20245,0,0,0,0,0,0,0,0,0
20240,0,0,0,0,0,0,0,0,0
20230,0,0,0,0,0,0,0,0,0
20228,0,0,0,0,0,0,0,0,0
20204,0,0,0,0,0,0,0,0,0
20202,0,0,0,0,0,0,0,0,0
20198,844,87593,134423,516,122656,147529,328,49821,107068
20197,1024,170313,201911,855,201949,231057,169,0,54454
20194,5391,138083,177821,3085,171424,215904,2306,109758,125611
20191,11695,122089,146913,8126,132885,160231,3569,90868,107331
20190,9594,110448,142059,4774,143570,165982,4820,92973,113168
20187,5970,140179,160631,5037,152591,168157,933,89018,98371
20186,5767,85461,110925,3509,122951,136255,2258,54494,68146
20184,326,0,364651,158,"250,000+",679058,168,60854,68960
20181,2745,132224,149574,2264,156048,162644,481,51580,70006
20180,2589,138015,159401,2151,141225,166772,438,95109,116887
20176,17048,136218,168157,13482,155352,183546,3566,68696,105522
20175,12342,136325,178260,8941,154719,201476,3401,72397,110785
20171,17278,149393,188933,13152,176315,213311,4126,95088,105449
20170,13406,130336,153539,10200,138024,161627,3206,94091,114491
20169,8215,156511,175255,7025,163473,184910,1190,75547,110180
20166,4336,112889,128536,3254,123333,135034,1082,89286,103534
20165,12040,151750,204378,8960,173177,236577,3080,94063,106002
20164,12121,107551,127131,9176,119192,133132,2945,66458,84902
20158,1558,176130,184182,1372,180286,195543,186,68958,90445
20155,11778,127422,145710,9702,138316,156777,2076,80000,87703
20152,11076,172350,199851,9772,181376,205727,1304,104200,132088
20151,6617,127476,159005,5504,142202,168104,1113,80176,102140
20148,16956,183134,200073,14475,199297,211448,2481,106475,121363
20147,22845,136913,161487,16090,162588,187453,6755,79902,92975
20144,561,114094,130934,412,157944,153850,149,60175,63505
20143,213,156435,233871,164,161548,282718,49,44750,60406
20141,2335,158125,181814,1963,171354,199692,372,74107,79579
20139,121,86740,102240,99,86201,96513,22,0,0
20137,667,123378,145883,574,124137,144499,93,0,103576
20136,8954,146432,162834,7907,153756,168003,1047,101920,109277
20135,1454,83448,131505,908,106429,142775,546,70431,102620
20132,5807,144406,174577,4887,159284,187377,920,74286,98980
20130,116,68750,86467,69,97875,110943,47,60852,50534
20129,183,"250,000+",441910,171,"250,000+",457756,12,0,0
20124,4802,187609,227166,4129,205995,241321,673,103563,132908
20121,9233,107933,122865,6489,116781,132103,2744,85806,94562
20120,13731,131298,153192,10852,141957,164181,2879,83460,106052
20119,1309,122656,150677,971,145052,170187,338,40119,68607
20118,2,0,0,2,0,0,0,0,0
20117,1108,106250,165002,719,144063,202125,389,91189,94980
20115,2638,111705,138626,1944,148258,163694,694,47194,59077
20112,8316,155000,169371,7212,163506,177636,1104,92989,103416
20111,10155,93777,119415,7833,100575,127391,2322,56571,73678
20110,14818,87205,106799,11031,98172,113847,3787,54370,72488
20109,13590,78484,91973,9180,77261,95026,4410,61974,73050
20106,1838,95134,111433,1321,111094,127965,517,57083,64274
20105,8281,166968,178162,6975,179417,187234,1306,100769,122664
20064,0,0,0,0,0,0,0,0,0
20057,0,0,0,0,0,0,0,0,0
20053,0,0,0,0,0,0,0,0,0
20052,0,0,0,0,0,0,0,0,0
20045,0,0,0,0,0,0,0,0,0
20037,6383,97901,137933,1192,172736,224085,5191,82784,118150
20036,3904,101154,130755,649,159375,222733,3255,95347,112038
20032,17033,43779,67318,7954,54912,72197,9079,33873,59903
20024,8345,86790,110912,2458,137065,146144,5887,75712,94965
20020,20918,40645,65723,11239,43826,73885,9679,34334,53754
20019,23438,39874,59818,13047,50431,69420,10391,26065,44704
20018,8133,70113,100067,3937,113657,137680,4196,38990,60776
20017,7545,89568,118571,4240,119048,145297,3305,66047,81472
20016,13149,158566,247621,7168,"250,000+",350752,5981,95590,119300
20015,6109,176298,240225,3956,"250,000+",313934,2153,75602,100288
20012,6367,104425,133752,3699,140801,165115,2668,61735,83011
20011,24221,78082,115950,13742,99688,133889,10479,58580,83305
20010,13088,101434,134308,5587,135673,168112,7501,82653,103486
20009,27898,118626,159084,7754,182083,240354,20144,105578,126727
20008,15814,114521,181804,6187,193125,292055,9627,82456,108453
20007,11969,135400,214265,4954,247672,334147,7015,92038,125499
20006,595,32286,65480,52,100357,132046,543,31858,59105
20005,8038,95653,140309,1582,156542,190165,6456,85598,127971
20004,1323,143798,177415,256,"250,000+",325906,1067,106344,141789
20003,14196,132681,163828,5886,196798,225542,8310,106144,116952
20002,28881,94939,129125,11673,124760,164898,17208,83534,101798
20001,20608,123474,148984,6284,147244,177884,14324,113069,133405
19979,297,82958,73652,196,83917,77686,101,59844,56055
19977,8406,66515,83790,6061,75677,93719,2345,46193,53186
19975,4199,67257,95408,2721,93385,117149,1478,41071,53401
19973,9612,55792,73546,6876,68415,82737,2736,30326,43939
19971,7245,75846,127187,4326,95116,147159,2919,48259,85300
19970,3927,69502,98373,2792,78500,110133,1135,55583,65956
19968,4975,72193,93674,3667,79821,104486,1308,33779,48193
19967,496,86071,94004,373,97125,103859,123,58233,63679
19966,13093,61604,78483,9392,73756,92138,3701,31313,38812
19964,588,0,87143,373,130267,111532,215,36380,43770
19963,8479,56026,72294,5676,65495,79052,2803,36294,51943
19962,4126,82148,90054,3276,92121,99954,850,36541,48675
19960,2319,57684,68019,1552,74529,82392,767,33368,35077
19958,12824,74544,101109,8068,94882,123584,4756,45664,59858
19956,5427,49939,60997,3830,61964,69587,1597,27232,33345
19955,30,58438,67337,30,58438,65880,0,0,0
19954,532,52045,69963,404,50833,73398,128,30750,37088
19953,1813,60505,77640,1121,78162,85136,692,32903,60762
19952,3907,60521,68183,2701,73132,78596,1206,28028,40049
19951,769,84799,116054,578,96331,134965,191,41289,56870
19950,2926,64674,76381,1788,80375,92656,1138,37901,47708
19947,6659,55459,71040,4478,62744,80429,2181,36948,45914
19946,2097,53732,76093,1596,58589,85017,501,31580,43456
19945,2839,66801,95178,1908,86635,115848,931,31651,50375
19944,325,90179,140554,216,133542,168585,109,46118,85006
19943,5221,59458,69410,3678,69460,78920,1543,41796,45847
19941,1222,69100,75945,910,53429,73378,312,0,64388
19940,2301,54355,69137,1514,74302,79650,787,29156,42629
19939,2852,65612,92544,2250,74076,101513,602,34318,46658
19938,2765,76370,86778,2240,80556,94445,525,38078,44951
19936,98,0,59127,61,54205,55079,37,21042,19389
19934,4676,72513,91025,3544,74481,101459,1132,40536,48951
19933,4141,49383,68584,2880,65303,77905,1261,30889,35538
19931,181,69750,71320,122,81875,79032,59,47102,53690
19930,1612,100278,158909,1194,120893,185170,418,57125,83746
19904,14739,56474,71219,8462,70417,84229,6277,36243,50000
19902,0,0,0,0,0,0,0,0,0
19901,14492,53314,66752,9676,60532,74201,4816,36500,46872
19810,10048,92992,115325,6907,111108,129817,3141,60437,80233
19809,6062,73462,86956,3733,86054,100117,2329,43977,59608
19808,14680,82113,103780,9767,96562,117375,4913,57282,69890
19807,3216,124104,226348,2176,196458,285392,1040,72195,99728
19806,5386,70256,110725,1423,146587,184973,3963,61009,82945
19805,15143,47300,63201,8595,58847,74812,6548,33644,45806
19804,7071,61531,75270,4113,80266,88671,2958,34301,54708
19803,8386,112108,155557,5864,138116,178321,2522,48466,68355
19802,10328,47258,71538,5496,66385,95045,4832,32500,41797
19801,7031,33410,49965,2990,45026,57635,4041,26891,43510
19736,24,0,0,0,0,0,24,0,0
19735,8,0,0,0,0,0,8,0,0
19734,4067,111006,125265,3171,113068,127894,896,43534,81671
19733,51,0,71539,18,0,0,33,0,0
19732,24,0,0,24,0,0,0,0,0
19731,91,0,73025,91,0,62236,0,0,0
19730,155,76406,103378,129,88125,115076,26,35000,39135
19720,21859,63018,81610,14066,80383,96569,7793,34881,50764
19717,0,0,0,0,0,0,0,0,0
19716,0,0,0,0,0,0,0,0,0
19713,11688,59030,75486,6829,73289,88923,4859,40169,53755
19711,19607,78818,101214,11971,102849,127782,7636,42987,56726
19710,0,0,0,0,0,0,0,0,0
19709,15898,108237,130933,12771,117486,136336,3127,61803,97497
19707,5937,148698,178168,4768,171081,197146,1169,50692,95378
19706,654,61354,67772,412,69333,77135,242,41818,46311
19703,6250,60841,76003,3487,89375,93955,2763,33091,45345
19702,20009,79567,99630,12990,88745,113859,7019,65306,68351
19701,15070,90240,109649,10691,99988,120856,4379,62936,76693
19611,3960,45298,72810,2300,46775,79601,1660,38618,58854
19610,6555,80781,119779,4120,125697,155246,2435,45078,58097
19609,3928,77537,93282,2688,88438,109281,1240,42500,56709
19608,8611,90987,115862,6257,99684,129655,2354,55079,74207
19607,9190,70422,86165,5503,84462,99891,3687,48806,61843
19606,13604,70827,88686,9536,85146,102133,4068,39444,49232
19605,7158,73705,87494,5037,83728,97186,2121,52690,57472
19604,8835,39122,52727,6382,47979,55739,2453,19813,27999
19602,6120,32262,41478,3623,36774,45952,2497,19798,29056
19601,11780,32430,46360,7449,43406,55474,4331,20330,26973
19567,1991,66891,81082,1457,77261,91814,534,35571,47968
19565,3777,58447,91433,2001,93726,108750,1776,36147,69218
19564,48,91417,95185,18,0,0,30,0,0
19562,1111,67108,74216,634,82553,87510,477,42417,50091
19560,3406,63742,69469,2203,75842,79835,1203,45298,47276
19559,106,53500,93688,81,75865,109431,25,25972,27332
19555,1371,66658,84130,929,81875,100130,442,37917,43485
19554,171,80417,84251,133,91719,97620,38,26500,37463
19551,1671,78527,92253,1216,92917,103171,455,44934,56485
19550,152,53571,74775,83,85208,84364,69,26750,63241
19549,139,55139,60334,96,60417,66943,43,40625,43158
19547,1910,87037,98193,1115,112476,127051,795,39076,57001
19545,341,73402,72399,233,73485,73096,108,63807,67110
19544,62,73750,69963,52,0,66990,10,0,0
19543,1920,100037,110229,1537,101742,116966,383,59837,73170
19542,45,0,68731,38,0,0,7,0,0
19541,1727,75946,91301,1320,82727,101162,407,44583,50881
19540,4369,86897,112393,3255,107938,130472,1114,40103,48123
19539,1887,67344,78449,1258,77195,92986,629,38286,45606
19538,16,0,0,9,0,0,7,0,0
19536,261,55469,61138,146,65705,72163,115,46220,47142
19535,6,0,0,6,0,0,0,0,0
19534,643,73239,78630,514,75882,83149,129,40950,51570
19533,2565,82596,98494,1856,101838,114787,709,40461,49101
19530,5012,62662,87632,2784,92861,117121,2228,32000,48045
19529,1212,84643,97879,932,90600,106416,280,37429,54953
19526,4793,57448,80956,3128,71968,94925,1665,38843,46295
19525,5692,120841,129278,4647,132521,143232,1045,60208,59347
19523,62,25000,0,11,0,0,51,0,0
19522,5392,79232,92823,3827,90119,106019,1565,38601,54615
19520,2375,86005,101945,1638,105292,123182,737,33598,50961
19519,69,0,0,69,0,0,0,0,0
19518,5504,99130,107042,4282,113204,117651,1222,33630,42631
19512,6899,71847,91354,4733,81860,99285,2166,43868,67866
19511,50,0,77710,46,0,73541,4,0,0
19510,3376,103265,112856,2611,124145,129399,765,52341,53267
19508,6257,73442,85636,4345,83795,96128,1912,34018,55720
19507,1029,74087,84983,748,88000,100457,281,33227,39792
19506,2674,83542,95612,1963,98910,113106,711,34044,44737
19505,1521,85423,86020,1184,86694,95366,337,0,44792
19504,1790,82642,104053,1442,91964,113943,348,43068,58447
19503,567,57146,72353,361,75792,83623,206,41500,42828
19501,411,62702,79988,343,58750,75486,68,39375,62588
19492,340,30882,41913,54,0,44948,286,0,41340
19477,0,0,0,0,0,0,0,0,0
19475,4472,85321,113498,2845,109968,139556,1627,45617,63901
19474,197,107868,101336,112,115761,122281,85,68728,73736
19473,6556,112392,137029,4863,122473,155328,1693,62645,78249
19472,5,0,0,5,0,0,0,0,0
19468,10002,82972,104015,6985,98042,120501,3017,52635,61339
19465,6833,86875,121033,5081,108257,140277,1752,44470,58222
19464,18589,64942,80703,12482,80040,94020,6107,35240,47249
19462,6055,101843,118282,4379,127869,139570,1676,44568,60874
19460,16443,104504,139548,10421,128750,171210,6022,63638,81583
19457,52,0,63333,28,0,0,24,0,0
19456,276,66891,94811,209,66633,104785,67,0,0
19454,10981,94410,126560,7235,120911,155664,3746,50893,68564
19453,801,64301,103429,455,116453,141842,346,48632,52114
19446,22647,87083,118037,15332,110896,141309,7315,48493,66374
19444,4466,121424,154146,2671,165170,203523,1795,60599,78444
19442,0,0,0,0,0,0,0,0,0
19440,7224,86696,105913,5071,103827,123911,2153,40440,51722
19438,9456,115748,138090,7249,136336,158212,2207,54196,68468
19437,407,133153,308402,299,0,395218,108,26776,32706
19436,429,61051,153100,184,150500,258222,245,55083,74150
19435,13,0,0,6,0,0,7,0,0
19428,8479,98031,122717,4240,120634,148318,4239,79813,96478
19426,12839,128070,161942,10135,151023,185786,2704,53803,67446
19425,5402,177641,220795,4643,198418,237437,759,60673,112856
19422,7366,126108,176158,5614,162159,204985,1752,60655,80705
19406,11438,97305,114751,6738,110286,129083,4700,70755,93010
19405,2034,52370,81058,998,68750,83527,1036,44303,68947
19403,18879,85248,107812,11686,110818,128672,7193,49703,72081
19401,16282,58782,75523,9899,68666,85687,6383,39741,55158
19390,4860,85722,117771,3692,106981,136763,1168,32500,52771
19383,0,0,0,0,0,0,0,0,0
19382,20429,104232,143574,12849,142798,182207,7580,50878,74192
19380,20999,106738,136205,13517,137818,172244,7482,56076,68196
19375,61,0,0,61,0,0,0,0,0
19374,377,0,66309,340,0,63681,37,0,90459
19373,850,184500,214833,790,199773,226906,60,0,0
19372,698,60278,170163,563,62338,202433,135,24646,35587
19367,24,0,0,7,0,0,17,0,0
19365,2665,83583,95857,2082,92574,104192,583,33098,41678
19363,5610,83949,97852,4241,95046,104451,1369,52304,69396
19362,2101,70668,85902,1530,76000,95315,571,51250,55470
19358,197,37147,51203,132,37500,54423,65,32159,42532
19355,10090,133686,187043,7290,153654,212797,2800,84556,116223
19352,3191,125719,146293,2870,135714,150375,321,63287,94375
19350,4136,141875,178426,3480,153542,188691,656,66667,90771
19348,8940,96729,143491,6624,122092,165056,2316,48382,75921
19345,0,0,0,0,0,0,0,0,0
19344,4433,70999,87273,3326,81581,97514,1107,33789,46764
19343,2635,136528,156413,2036,147091,175859,599,42371,84594
19342,8064,112373,147032,5052,149500,184794,3012,52500,80223
19341,7825,107338,135072,5433,122529,162404,2392,60616,71077
19335,17913,116895,148108,13229,142474,170268,4684,52271,81766
19333,2787,108674,184554,1907,163948,235600,880,60951,73293
19330,2052,98333,121014,1572,104500,128950,480,71250,88374
19320,20237,76710,94840,14589,88394,105705,5648,49303,62378
19319,51,246583,269427,51,246583,269427,0,0,0
19317,3659,143694,197674,2753,178661,235106,906,53875,82440
19316,118,79375,90511,79,108424,94242,39,0,82951
19312,4174,164844,220631,3329,198139,255794,845,58940,78996
19311,3115,125104,155499,2443,141741,168529,672,88875,102049
19310,948,68788,94289,763,86607,105078,185,43625,44968
19301,2579,95430,144165,1736,134375,176120,843,55083,75888
19154,12461,72161,90650,8587,87376,106331,3874,37727,50915
19153,5382,54485,58996,2791,60716,66984,2591,43322,49926
19152,13275,55927,70746,8242,68837,80705,5033,40401,52455
19151,12019,47174,63686,7064,64438,78428,4955,34676,38767
19150,9662,51163,61289,5634,65996,73606,4028,31658,40792
19149,18513,47196,59480,12844,50796,62358,5669,30380,44725
19148,19493,60226,75581,11534,65015,81783,7959,48203,60056
19147,18239,86147,128426,7913,132101,175206,10326,67785,91812
19146,17302,77091,108126,7785,99012,134245,9517,63681,84687
19145,17977,54353,70563,9848,64413,78100,8129,43996,58404
19144,18574,35047,54552,8423,52192,73905,10151,23493,37043
19143,24632,37434,56396,12409,46425,67827,12223,26391,42729
19142,9869,35049,43501,6005,39864,49769,3864,21218,28627
19141,13077,36572,49039,7234,44503,58208,5843,24867,36711
19140,19693,23138,36525,11274,31601,46395,8419,12570,20337
19139,18184,30490,41195,9611,36604,44970,8573,21910,33907
19138,11975,43556,51524,7094,50281,61274,4881,23355,34843
19137,3105,53750,68661,2187,58536,75600,918,36186,43941
19136,12417,54391,68317,7653,62876,77187,4764,34248,50555
19135,12940,44329,63165,8514,48486,69919,4426,33989,45748
19134,21273,34374,47673,13174,33981,49519,8099,27903,38964
19133,9012,24725,38922,6268,27059,44639,2744,10754,22403
19132,13712,23256,35854,5676,38962,51403,8036,15817,23505
19131,17503,39672,53014,8613,47695,62702,8890,32302,41599
19130,14431,88858,121662,5235,147855,177780,9196,74250,88415
19129,4901,72328,97886,2142,111057,140555,2759,41345,63600
19128,16980,76854,95665,8668,96620,115171,8312,61932,72593
19127,2678,74936,104604,716,137396,148346,1962,64302,88146
19126,5854,51858,65851,3649,63315,73407,2205,30422,47917
19125,10948,79612,89666,4648,89476,101799,6300,69047,77077
19124,22837,36884,56264,15243,44708,62885,7594,21603,37786
19123,8565,77111,106137,2887,112607,147549,5678,63717,84290
19122,6799,44758,72780,3009,48263,77288,3790,37500,65888
19121,12162,25162,45509,5863,36795,50583,6299,17749,37056
19120,24531,38996,53609,16972,42207,57340,7559,24719,37369
19119,11846,73671,111458,7116,99853,144952,4730,41838,54506
19118,4651,85766,148898,2416,135119,219710,2235,51719,70933
19116,12850,58203,74943,8392,73555,87773,4458,32371,47636
19115,14391,57323,82939,8913,76548,100315,5478,39659,51215
19114,13032,65893,80138,7667,85259,93501,5365,40895,56453
19113,45,53125,70231,11,0,0,34,43333,42274
19112,0,0,0,0,0,0,0,0,0
19111,24355,51567,69823,15834,58325,78722,8521,35703,49235
19109,0,0,0,0,0,0,0,0,0
19107,7823,60676,91522,2052,94459,140031,5771,51795,73123
19106,7625,116368,162885,2445,180262,249834,5180,92610,121844
19104,16508,28603,46430,5933,38705,62383,10575,21895,35516
19103,15765,79110,134268,3933,149471,218243,11832,67637,106053
19102,3365,110096,177851,840,173929,244578,2525,83328,155653
19096,5549,142434,215252,3841,213338,270736,1708,66576,90477
19095,3123,92859,127326,1739,152188,184433,1384,32750,48198
19094,1696,67679,84167,1031,89139,105797,665,29028,47770
19090,7006,81064,98255,4575,101536,116400,2431,51390,61690
19087,11749,144022,196760,8271,173576,228594,3478,74700,117343
19086,4369,119724,152544,3247,142132,176013,1122,65000,77075
19085,1852,"250,000+",368485,1691,"250,000+",387787,161,74205,165754
19083,13002,102055,126369,9873,126460,147009,3129,46631,58389
19082,15251,45569,62906,10122,53209,68315,5129,32120,43555
19081,3599,106356,141203,2346,126358,180048,1253,51989,67647
19079,3452,52519,63891,2177,60025,73067,1275,34401,42760
19078,4528,84063,95485,2841,102399,115868,1687,42394,54206
19076,2718,59120,86413,1535,78324,116441,1183,31058,42464
19075,2843,97490,115839,2155,112695,129820,688,57069,70106
19074,2265,77949,82178,1661,96809,96730,604,36190,38306
19073,7920,113430,168382,5362,165000,214302,2558,52083,70129
19072,4121,131685,209007,2875,194201,253614,1246,67983,105475
19070,2793,82917,96290,1721,111250,116418,1072,51324,61243
19067,20311,110452,146014,15171,130939,164148,5140,57398,86182
19066,1661,220329,279723,1385,241313,313780,276,85000,99800
19064,8675,116394,133939,7031,126832,147443,1644,58600,71548
19063,14697,102401,134722,9151,136982,175125,5546,48843,65710
19061,8073,72533,88303,5729,86123,99499,2344,38105,53727
19060,3660,145682,155911,3124,153575,171763,536,42353,49927
19057,5979,84074,86973,4434,88886,95648,1545,33089,48286
19056,5808,87188,107238,4275,100450,119804,1533,43770,51334
19055,4863,71958,78855,3531,84583,88025,1332,38786,43734
19054,6279,90960,105309,4678,100393,116502,1601,41359,57348
19053,9936,83636,101979,7399,102505,116981,2537,41498,53374
19050,11225,54935,71259,6496,72695,86133,4729,39688,46741
19047,12297,97362,120155,8652,119713,140781,3645,43278,65929
19046,7312,104193,142602,4997,130384,173535,2315,39951,72131
19044,6480,84391,104385,4186,106951,125709,2294,54841,62894
19043,1039,88033,89756,562,109348,125443,477,31489,40861
19041,2426,138077,227205,1508,208250,306216,918,52969,96495
19040,7763,87775,106953,5190,109132,128977,2573,40304,58435
19038,11337,97515,119805,7947,119659,142213,3390,50782,62387
19036,4958,64048,82613,3230,83041,99143,1728,34538,46415
19035,1443,"250,000+",409434,1151,"250,000+",426525,292,127750,332537
19034,2161,125875,171268,1552,167500,210879,609,54107,65890
19033,3007,83642,97819,2120,104019,113422,887,36094,56820
19032,2289,56169,63132,1517,64095,71120,772,41636,42497
19031,1648,113722,167372,1125,132083,194442,523,42361,105628
19030,4546,81921,98506,3340,94737,111359,1206,42722,55249
19029,1567,54688,68821,948,60565,73218,619,34097,56899
19027,8041,82494,114753,5235,104232,137979,2806,49214,67268
19026,11854,73762,98812,7788,92148,116009,4066,48677,57654
19025,2344,143636,256508,1946,168548,288771,398,65735,89496
19023,7805,46222,54909,4591,58618,65029,3214,28895,36643
19022,1493,34331,48335,884,36910,53164,609,26488,37426
19021,3797,60613,68789,2570,71171,78893,1227,29972,42389
19020,21379,70488,94744,14089,88079,108769,7290,47483,61853
19018,9575,68230,79445,5973,79158,89010,3602,40254,56354
19017,60,123700,129853,42,0,173357,18,23571,28344
19015,6625,66967,81433,4487,75077,85085,2138,48958,69272
19014,7688,89468,109389,5437,106807,125017,2251,53018,64509
19013,12664,32431,47320,6993,38398,55663,5671,22903,33185
19012,2266,100377,118747,1687,121484,134818,579,56146,65361
19010,7378,118529,191504,5115,149934,240199,2263,49940,79625
19009,256,94167,130283,180,110417,146269,76,0,90286
19008,6901,106551,135552,5460,125959,152220,1441,38650,66722
19007,8719,58802,78455,5283,67199,85216,3436,39003,62885
19006,7988,104409,132737,5952,123214,158206,2036,27138,53210
19004,3869,122950,174755,2556,147222,213915,1313,79922,95267
19003,5665,105061,135760,3415,136635,170327,2250,55952,80465
19002,11620,117544,161793,8480,154012,190576,3140,52550,80916
19001,6132,88867,99983,4558,102813,112296,1574,44944,60678
18980,199,98125,160375,155,125114,191326,44,0,51343
18977,1745,190202,233722,1469,198172,255690,276,81964,86969
18976,7354,106667,139685,5552,139330,166231,1802,41394,54414
18974,17299,76597,95252,11906,91474,109244,5393,46987,62774
18972,1425,83401,107641,963,98144,110383,462,58269,101799
18970,302,83125,101833,193,106250,128773,109,44531,52932
18969,6061,75125,100641,3857,111940,126739,2204,53833,53202
18966,13591,99189,123059,9687,126645,147416,3904,46581,60388
18964,5283,79931,101927,3875,97023,116582,1408,44821,56741
18962,149,78194,88598,95,78935,89823,54,56667,83287
18960,4649,86132,99026,3265,103513,118078,1384,41742,48554
18955,523,62917,76505,344,80000,94858,179,42644,39903
18954,4360,131421,172961,4041,131648,181421,319,39375,56230
18951,13398,79013,97905,9426,100870,115025,3972,46141,53577
18950,75,0,208867,42,0,137779,33,"250,000+",292267
18947,2469,112205,139784,1889,120551,162272,580,58864,64463
18944,9601,104314,120658,7375,115933,136380,2226,44180,63971
18942,1163,91615,110295,838,105806,114891,325,78047,87230
18940,11515,132214,176878,8345,159179,203509,3170,61350,103773
18938,6044,118877,191503,4108,160025,225345,1936,59194,115114
18936,0,0,0,0,0,0,0,0,0
18935,20,0,0,0,0,0,20,0,0
18932,135,62043,113964,102,0,136947,33,0,42924
18930,990,93281,111940,725,110139,125273,265,50417,74921
18929,3408,146212,178478,2906,156923,188020,502,84545,112358
18925,2412,161512,185003,1900,174038,198871,512,106731,130729
18923,405,109381,190710,374,109369,149817,31,0,0
18920,127,0,91638,46,147273,164107,81,0,50483
18917,960,78971,87102,482,92614,111726,478,56250,61695
18915,256,98667,104424,185,99417,111923,71,0,80790
18914,8207,106978,126726,6237,122158,141198,1970,65062,75464
18913,16,0,0,16,0,0,0,0,0
18912,5,0,0,0,0,0,5,0,0
18902,7686,134224,185218,6139,153588,198793,1547,65156,123879
18901,10486,103626,133441,6626,153266,172639,3860,43062,63870
18854,674,58472,77388,505,70852,86158,169,28603,47652
18853,1736,65244,77622,1198,74537,92774,538,33594,41370
18851,271,62292,69319,195,70417,79176,76,36000,42417
18850,860,51983,71417,531,62656,84693,329,34271,48984
18848,3742,44776,61725,2390,55510,72395,1352,27241,40312
18847,2387,47418,65900,1551,56322,75167,836,30633,44677
18846,377,75156,93166,271,83482,104282,106,66875,63866
18845,158,70000,83365,119,71875,86222,39,46953,74649
18844,749,75313,98174,615,79345,100680,134,46667,83425
18843,97,44191,47454,29,67019,72014,68,42647,36979
18842,88,54583,62739,65,63393,73951,23,26583,31057
18840,4477,50347,71270,2633,66589,89247,1844,36774,41580
18837,1135,57578,66248,839,61161,69866,296,28750,45513
18834,1351,63368,83224,916,70288,90014,435,28984,62865
18833,832,55603,68799,528,71071,84603,304,31250,35586
18832,805,49926,60520,541,69188,72614,264,26528,34495
18831,430,62222,61995,282,64635,74807,148,31250,36844
18830,267,53125,74435,168,71875,94807,99,34375,39275
18829,296,67813,73229,219,69656,85132,77,27917,34123
18828,153,52292,65961,104,73333,68465,49,46354,53510
18826,549,72772,96929,380,74706,103099,169,30179,64086
18825,31,0,85032,27,0,54174,4,0,0
18824,618,56667,80625,415,77031,86630,203,22375,65008
18823,89,65313,57985,44,79107,80493,45,28438,33264
18822,1404,47571,63259,823,60966,72887,581,26146,43600
18821,513,50650,61571,326,57500,65329,187,30781,38363
18818,566,54900,65203,321,74375,78945,245,34417,45669
18817,98,79167,72886,77,63750,66410,21,79688,68081
18816,48,73750,65029,31,74875,79484,17,0,38671
18814,77,44464,52195,52,59375,58462,25,31750,32288
18812,687,80547,90714,509,91083,102749,178,45000,55557
18810,2701,48085,64387,1465,69236,81207,1236,24885,41097
18801,3477,54028,78764,2294,69444,92034,1183,29816,47478
18709,1474,37826,50376,735,53365,68483,739,25689,30933
18708,3499,85363,111108,2423,103281,140860,1076,27122,41053
18707,5824,85827,108634,4745,96663,120160,1079,29572,53968
18706,6842,53167,62158,4236,66555,71532,2606,31099,45011
18705,6102,51955,65645,3680,63920,80282,2422,31840,41227
18704,13214,53016,67950,7871,68718,80891,5343,36426,45169
18702,16082,46926,59141,9732,57000,71969,6350,26944,36503
18701,950,29063,38638,163,36250,51385,787,26554,35712
18661,2129,57386,69281,1327,75994,85860,802,30556,40508
18660,1460,65278,79585,1086,73814,87908,374,44167,53594
18657,4698,65156,86848,3169,74095,104239,1529,35594,46568
18656,1008,57404,69931,734,58235,77151,274,50682,47778
18655,2350,61765,69397,1551,78992,81284,799,33385,43069
18653,68,82857,90291,44,125000,120091,24,34107,35658
18651,4000,40172,59808,2237,58604,76567,1763,27699,35437
18644,3590,59417,75326,1935,86917,99918,1655,26964,42053
18643,5657,56816,72973,3349,70734,86672,2308,38418,48346
18642,1813,68471,72823,990,76765,89757,823,34284,52235
18641,3034,53750,72583,1983,69671,84938,1051,29304,45306
18640,7350,43066,62603,4084,66840,78930,3266,28855,39556
18636,581,51042,68266,362,59432,86643,219,25341,35316
18635,1509,65967,73338,1088,79741,85110,421,31635,39362
18634,5478,47463,62379,3216,58011,69392,2262,33833,48242
18632,265,58355,64738,185,72361,73987,80,29500,38239
18631,466,45714,57367,253,59688,69743,213,0,42666
18630,1208,66500,79518,900,75227,86874,308,32813,52751
18629,778,52083,73787,478,53750,71064,300,47059,76025
18628,102,31071,44574,49,38438,51116,53,22083,36558
18626,195,71406,77389,126,100625,94530,69,39250,44004
18625,211,47708,60169,109,67446,84522,102,29423,30239
18624,262,0,115665,157,190846,155801,105,45709,55271
18623,1058,54185,71395,681,60375,74067,377,39821,61983
18622,79,74844,78292,76,75417,80851,3,0,0
18621,1951,62043,86322,1387,72846,100526,564,30556,47165
18619,107,53750,62731,68,66250,76371,39,27083,37849
18618,1516,78103,99123,960,99444,118585,556,53438,63064
18617,820,31611,49245,445,61641,67787,375,16773,22589
18616,323,54219,65196,212,62917,77047,111,35938,42561
18615,780,67895,83481,569,81750,88534,211,34063,64092
18614,1032,44063,56701,507,57788,74129,525,25231,36249
18612,6340,77359,100839,4307,108134,118110,2033,37886,61855
18610,1551,59781,69056,1119,60354,72879,432,51395,57745
18603,8527,50747,63327,5445,61359,75000,3082,29848,37693
18602,123,132750,173464,86,177500,223858,37,0,54165
18519,2149,56642,69242,1376,59293,80822,773,36042,44748
18518,3636,57014,70542,1962,80521,90367,1674,38478,43853
18517,2121,51629,75214,1434,65153,78590,687,41779,60530
18512,5215,54227,69116,2880,78113,88877,2335,32028,42056
18510,5048,39497,55664,2526,56747,72000,2522,26474,37130
18509,5178,44852,68831,2669,69112,94952,2509,30616,36923
18508,5299,37556,45820,3136,43539,50370,2163,30309,35781
18507,2077,57903,80138,1189,88466,101457,888,41719,49249
18505,8918,42463,61116,5166,57433,71589,3752,29167,43829
18504,8806,47786,63467,5383,60238,73555,3423,26993,42269
18503,581,32625,35153,20,0,0,561,29896,35030
18473,197,0,38006,99,45139,48070,98,0,27840
18472,1495,56534,67598,1065,67684,78563,430,29333,38048
18471,243,125417,157127,188,179722,191268,55,0,40429
18470,846,64808,76669,639,72596,82921,207,44688,51913
18469,124,56268,63620,101,56395,64350,23,0,0
18466,5796,60890,76470,4339,66592,83175,1457,37791,47755
18465,497,56719,68998,298,64167,80418,199,40104,50687
18464,530,81087,86891,366,107813,108954,164,19348,33064
18463,87,90625,89601,71,110050,93017,16,70714,74444
18462,163,62946,91517,108,93333,114075,55,46528,47220
18461,146,33636,65841,60,95833,99007,86,24643,41940
18460,73,0,45666,12,60000,60942,61,0,42661
18459,16,0,0,14,0,0,2,0,0
18458,1227,68990,89337,905,75725,95249,322,0,72722
18457,44,0,19823,28,0,0,16,0,0
18456,198,60547,71017,134,61641,83636,64,33125,44595
18455,57,45446,51772,49,46161,57437,8,0,0
18454,26,90179,66158,17,90982,82824,9,0,0
18453,425,59375,70474,313,72337,79862,112,22375,42188
18452,2482,47692,57228,1427,72776,77128,1055,21763,28909
18451,321,57311,92958,263,64464,103165,58,0,46674
18447,4435,53640,63595,2913,67034,71745,1522,32729,44122
18446,1329,56289,70856,863,67153,85780,466,27571,40148
18445,926,46667,69334,615,69107,83034,311,32083,40800
18444,5398,76184,88962,4072,86200,101682,1326,35058,44708
18443,127,0,96246,84,111429,133531,43,22375,23412
18441,154,0,145422,106,0,201135,48,21750,22390
18439,190,59688,80015,128,72500,81027,62,0,74979
18438,574,41261,53162,325,54116,62993,249,38861,39230
18437,90,49643,55049,72,66250,57276,18,37500,46139
18436,4827,68845,83235,3744,82443,95242,1083,27721,36213
18435,361,113821,147273,257,129191,193207,104,36250,33763
18434,1579,62649,63276,959,71427,79899,620,27344,37084
18433,2782,67447,82373,1838,88527,97020,944,37422,52770
18431,4976,52667,65163,2916,63615,82772,2060,27192,38042
18430,0,0,0,0,0,0,0,0,0
18428,4992,58881,76036,3311,71177,89326,1681,37125,47209
18427,27,0,0,27,0,0,0,0,0
18426,1692,53099,74315,1226,57500,82383,466,36591,42707
18425,455,70625,85213,285,96620,109065,170,42917,44798
18424,2036,61389,77886,1413,74426,89721,623,35219,49264
18421,1851,55443,73575,1135,75781,88751,716,36058,46536
18420,13,0,0,13,0,0,0,0,0
18419,1666,57368,73411,1174,69375,85300,492,34286,40725
18417,375,66103,73280,274,77857,82391,101,39306,48687
18415,752,75513,104367,405,76186,106568,347,54708,101263
18414,2259,75452,95167,1650,83944,106748,609,45035,61033
18413,104,21964,115366,54,0,199593,50,0,24402
18411,8397,81801,110177,5650,99572,133222,2747,50401,57818
18407,6034,47953,66493,3655,58801,76479,2379,24096,42456
18405,1007,63839,73442,801,65250,75441,206,45125,57175
18403,2786,54823,72016,1831,69890,80927,955,45529,50408
18372,1029,70481,110166,705,106705,147980,324,14643,27885
18371,263,77893,98038,241,78679,103351,22,0,0
18370,617,71174,86073,529,71660,96316,88,0,24499
18360,10263,58904,83974,6904,73690,98334,3359,41607,48667
18357,54,0,0,17,0,0,37,0,0
18356,28,0,0,28,0,0,0,0,0
18355,438,0,70437,352,0,67085,86,0,78427
18354,452,65868,67112,322,67431,77413,130,31071,41597
18353,4892,76850,99800,3423,91575,118628,1469,48470,54184
18352,409,71634,72370,279,71889,83608,130,0,48252
18351,201,52321,57774,133,71250,69065,68,33580,30903
18350,468,70185,77085,215,65625,87613,253,92684,68138
18349,123,53859,143379,72,0,0,51,0,0
18347,1554,69511,75504,707,72550,81345,847,69018,69746
18346,936,52056,75935,666,71786,88009,270,36613,41279
18344,1334,65595,87766,820,79184,110736,514,46250,49094
18343,1570,69265,92870,1057,87250,110999,513,40129,53932
18342,234,0,45797,135,0,62225,99,0,23395
18340,53,157109,144030,53,157109,144030,0,0,0
18337,5459,81308,98084,3708,99583,114743,1751,47527,59810
18336,1712,65441,98194,994,85000,101990,718,35388,87174
18335,262,96658,110952,229,97106,116815,33,43125,34264
18334,1604,83711,90307,1138,68963,89229,466,59853,58746
18333,215,0,50849,172,0,48770,43,0,0
18332,1070,86286,89916,875,86098,91261,195,49583,71548
18331,217,67792,63475,181,69292,69933,36,33824,0
18330,2942,69559,83206,2251,79094,91957,691,46914,51015
18328,2982,65167,85682,2013,81674,99511,969,53472,53701
18327,294,74375,77520,118,86250,98120,176,63500,63709
18326,1247,57147,65212,700,59811,77417,547,27938,42867
18325,991,142663,118132,830,148944,124510,161,72772,75132
18324,3719,51817,65547,2636,53775,68442,1083,32533,46936
18323,46,0,0,46,0,0,0,0,0
18322,1041,76717,81138,724,97727,93410,317,34663,53111
18321,569,61375,70269,417,72019,72986,152,40743,48230
18302,5871,70657,87642,4616,87074,93326,1255,34325,57847
18301,9995,70157,95242,7040,87845,110814,2955,42894,54214
18256,144,61607,65636,99,80694,75330,45,0,44309
18255,1713,53466,66020,1150,69500,76077,563,33563,40951
18254,402,48289,54273,290,45179,54950,112,29318,32879
18252,4807,51549,65748,3005,71793,82317,1802,25379,36007
18251,13,0,0,0,0,0,13,0,0
18250,1237,47734,70769,661,52188,64826,576,45417,76073
18249,1447,78098,93228,1008,90000,104506,439,45602,65282
18248,223,37279,66689,170,55139,78468,53,22708,26083
18246,110,50952,61166,100,36959,54150,10,0,0
18245,152,35714,32666,80,38944,46165,72,0,0
18244,111,53750,53352,65,67250,68683,46,20313,27763
18242,207,0,96806,162,85887,74269,45,35625,37649
18241,341,56295,67032,155,85179,80072,186,55357,53505
18240,1557,51762,61227,893,67303,78054,664,31703,36100
18239,103,0,0,103,0,0,0,0,0
18237,1458,36968,52680,888,44630,60548,570,27333,35210
18235,7794,64029,76935,5085,77725,91259,2709,33631,48241
18234,302,0,47616,76,0,0,226,0,36392
18232,1572,36500,50889,872,40000,58142,700,19798,36885
18231,195,50481,53206,135,53365,57743,60,46563,43000
18230,44,66154,64059,38,66731,71832,6,0,0
18229,3793,60126,73279,2469,77470,86272,1324,35449,44733
18225,0,0,0,0,0,0,0,0,0
18224,2594,44295,52724,1668,58393,63140,926,26156,32433
18223,76,0,0,60,0,0,16,0,0
18222,3658,76940,92753,2474,95319,106824,1184,49971,60696
18221,277,105741,84786,247,106073,89439,30,0,0
18220,112,48636,53570,73,61875,61921,39,27250,33813
18219,597,66932,89561,384,69531,88163,213,44063,87542
18218,910,45769,58334,501,59141,75655,409,26726,34796
18216,459,51250,71501,289,70852,81967,170,33500,51658
18214,787,58097,67199,539,64403,80401,248,23947,35944
18212,49,55268,53741,34,0,48982,15,0,0
18211,471,61012,72106,338,63750,78462,133,41086,55953
18210,2947,62562,76967,2151,70332,90207,796,27545,39520
18202,4592,44592,62350,2791,68664,79253,1801,24842,34613
18201,10607,39345,51577,6422,44181,59557,4185,30424,35873
18195,0,0,0,0,0,0,0,0,0
18109,6609,46184,54966,4444,49607,61327,2165,32832,37820
18106,2894,71368,102277,2053,81788,107895,841,39247,83492
18105,0,0,0,0,0,0,0,0,0
18104,16419,74960,98975,10523,91013,118229,5896,45503,60942
18103,18309,62586,83292,11964,73216,97123,6345,41496,53223
18102,16594,34538,45126,10661,36888,47924,5933,23903,33492
18101,1788,30197,47879,1032,26389,38969,756,30802,52489
18092,1359,95669,117842,1088,99352,130370,271,39665,61496
18091,2518,61986,82839,1592,89815,100087,926,36548,51631
18088,3196,64681,81578,2290,71885,92749,906,41260,48701
18087,270,41389,69309,174,65889,92433,96,21667,26375
18086,329,55088,69827,198,55132,84974,131,0,45734
18085,439,62679,88629,309,77969,108020,130,45250,41449
18083,136,60833,72132,90,58750,75189,46,77857,65137
18081,91,44365,54716,14,0,0,77,44078,47249
18080,4662,61987,77078,3043,79970,93777,1619,31207,39157
18079,169,0,64756,159,0,68003,10,0,0
18078,3076,98095,131412,2171,126315,159727,905,44607,57142
18077,935,87896,156793,664,101250,191805,271,70795,68746
18076,1187,71635,81498,719,99792,102047,468,31961,45157
18074,2298,99333,132779,1803,102070,131002,495,64635,131282
18073,4123,95657,108090,3152,107367,121694,971,44293,60280
18072,2522,65673,79382,1815,76679,89749,707,40875,46959
18071,4368,61757,80919,2737,72176,88641,1631,33496,60739
18070,242,71250,72924,192,93750,74490,50,35833,41306
18069,3168,97100,131903,2534,124412,148803,634,50192,58982
18068,0,0,0,0,0,0,0,0,0
18067,7321,74580,89267,4877,81933,101390,2444,47013,60931
18066,2321,94178,113664,1854,103922,126107,467,50592,58479
18064,9698,81774,99937,7019,97973,113325,2679,37088,54734
18063,196,36280,48117,119,65817,68956,77,14798,15913
18062,10426,85262,111307,7476,106458,128513,2950,45455,64700
18059,381,104583,123902,284,121667,146652,97,0,49696
18058,3454,61196,76370,2482,80653,90124,972,32480,37461
18056,390,63333,81328,295,80394,91410,95,29609,35668
18055,4620,74394,107945,3110,95417,127128,1510,42181,63160
18054,1697,84896,113893,1248,107143,126766,449,48505,70682
18053,851,79464,81271,646,88318,93647,205,35625,41628
18052,11505,67835,77452,7645,78366,88501,3860,43066,51934
18051,1318,123883,136677,1079,128239,147569,239,62344,82096
18049,7056,76737,98301,4880,100254,115826,2176,46475,53543
18046,53,0,0,53,0,0,0,0,0
18045,10153,98467,113019,7189,112646,130523,2964,56016,68401
18042,15200,60647,78858,9936,71645,92409,5264,38910,50780
18041,2088,79239,91174,1616,86912,93292,472,50500,77367
18040,6449,101068,121089,4804,117966,135304,1645,53257,71744
18038,1391,85524,89918,993,100573,108631,398,0,42086
18037,3185,64770,83023,2082,74583,101796,1103,32225,44875
18036,5673,104709,136917,4331,113315,151698,1342,49280,83214
18035,7,0,0,7,0,0,0,0,0
18034,3159,109158,164883,2568,123000,180231,591,62125,94321
18032,3913,65206,77679,2563,79332,91786,1350,33958,46778
18031,4244,78975,111765,3066,101167,129521,1178,53103,62152
18030,313,53125,66036,152,63000,78830,161,42292,51105
18020,7811,97359,118268,5701,113623,134978,2110,50184,68430
18018,13297,58487,86337,7024,74220,110994,6273,42018,54743
18017,15788,76189,94880,10717,86448,106461,5071,41130,65015
18016,0,0,0,0,0,0,0,0,0
18015,11003,48608,83413,6409,67068,109735,4594,29831,42254
18014,4326,67216,85188,3194,80833,96449,1132,26868,45433
18013,7113,68302,85604,5274,77500,94647,1839,36205,54818
18011,1983,94784,104810,1551,94554,107359,432,76316,82373
17985,517,68807,74307,346,85000,88347,171,40375,44846
17983,593,62589,63377,372,63462,66759,221,46964,44090
17982,232,48056,59484,160,62656,67671,72,0,27964
17981,1066,52075,66220,680,64091,76046,386,33289,42950
17980,1214,59563,69735,894,66406,76255,320,41364,45227
17979,66,57083,54450,51,56042,50273,15,61875,68647
17978,136,47308,49571,99,47813,48031,37,47212,46124
17976,2747,36511,55035,1830,49697,59522,917,23047,44013
17974,123,52589,53520,99,54732,54634,24,0,0
17972,4874,54426,64444,3062,74358,80899,1812,23191,31264
17970,1421,48145,59127,884,58867,67472,537,22409,33637
17968,77,67750,89143,60,76250,105707,17,0,23700
17967,940,60192,77314,677,69688,89110,263,31250,41786
17965,869,51303,57475,518,58125,69800,351,33456,37628
17964,288,48690,62002,201,56094,72164,87,29107,35307
17963,3765,63165,76427,2728,70702,84851,1037,33131,45207
17961,2544,71746,92090,1589,91442,113966,955,49904,53761
17960,1795,57383,72567,1298,70625,83068,497,29550,44686
17959,587,57250,65479,346,75536,79588,241,28125,39659
17957,122,103636,138998,94,115288,108612,28,34000,240861
17954,2109,32413,44131,1243,32254,49855,866,17159,23050
17953,171,50208,59784,113,75179,68029,58,40625,42295
17952,102,39500,109978,53,48393,66760,49,0,156492
17951,171,125043,100040,84,68667,72368,87,0,0
17949,100,52981,70948,47,58173,55326,53,46875,74728
17948,1845,34258,49481,1043,35905,54667,802,25208,34340
17946,47,72375,70755,33,0,0,14,0,0
17945,71,0,56492,50,90208,70176,21,0,23214
17944,67,86250,78507,50,97500,93042,17,25000,22241
17943,64,69375,54778,46,70583,66450,18,0,0
17941,288,60833,69159,222,70500,74802,66,42813,44392
17938,1056,75933,78613,687,78856,86147,369,75291,61583
17936,378,56691,67233,257,67708,84449,121,23194,25536
17935,700,29667,50830,330,41250,51775,370,18548,46024
17934,132,36667,42267,73,49375,50170,59,19583,30247
17933,46,0,0,29,0,0,17,0,0
17931,2010,70072,75001,1425,73639,76818,585,26645,53399
17930,167,36875,49320,83,55625,70193,84,26458,28024
17929,575,58365,60309,395,61917,63020,180,36786,43739
17925,121,65625,71373,101,80250,73554,20,0,27960
17923,152,48750,52692,103,60050,59674,49,33542,37043
17922,1948,77163,97576,1599,83810,104750,349,41250,57984
17921,2667,57225,62494,1590,70735,80752,1077,24288,34584
17920,145,37232,50781,96,49500,59577,49,34375,33547
17901,9912,45198,60819,6110,58953,71557,3802,29695,40648
17889,893,70245,92245,729,83750,103305,164,0,33898
17888,173,55313,68406,123,80625,80817,50,32083,32572
17887,256,48821,47921,181,0,43661,75,0,35675
17886,470,45859,58243,296,47188,67886,174,21535,27919
17885,96,68750,70022,84,77885,76227,12,0,26583
17884,84,45625,42655,64,0,43527,20,19286,21955
17881,596,53611,59740,372,55455,65917,224,36875,40888
17880,42,54464,56614,30,69000,60487,12,0,0
17878,562,69400,81062,491,71250,83835,71,24375,39555
17876,725,57153,69882,432,85455,92205,293,25197,32841
17872,4281,39653,53528,2512,50976,63598,1769,21288,35607
17870,5595,66158,81566,3537,79652,97304,2058,31855,49690
17868,545,57875,73169,387,62054,79556,158,36250,46355
17867,66,36250,48170,30,56667,79670,36,25000,21919
17866,3587,40941,51611,2045,51719,65713,1542,23675,29032
17865,22,0,46491,10,87500,86490,12,0,13158
17864,695,58836,79571,565,66528,87294,130,34375,43784
17862,130,41000,52586,106,0,51806,24,0,56033
17861,79,57452,86249,65,87750,100428,14,21250,20421
17860,916,72813,84579,708,80750,95900,208,28125,30900
17859,1130,61452,74687,816,77625,85072,314,31184,42223
17857,3149,64424,72956,2089,74606,82119,1060,39643,51076
17856,1385,67043,84079,1023,79554,96874,362,42500,44485
17855,340,65714,71957,253,74219,81005,87,29844,42899
17853,1171,54086,69170,944,62594,75014,227,33015,40611
17851,3638,39081,48149,2214,54375,59188,1424,21429,28418
17850,298,44500,59849,189,41917,60732,109,35096,47507
17847,4892,51815,65752,3139,67978,74782,1753,30043,45322
17846,1543,53948,64374,996,72105,78608,547,30552,35431
17845,639,54183,65721,483,60938,70310,156,26786,42987
17844,3806,55232,75465,2766,63519,86630,1040,30484,41281
17842,3382,56114,73456,2438,65859,78172,944,30052,55734
17841,1722,48229,62825,1400,53649,67147,322,31250,36780
17840,239,59028,61596,179,58361,60850,60,78357,63822
17837,6758,53801,90664,3673,87852,119460,3085,28761,55958
17836,79,53750,68952,54,56786,76648,25,50417,52324
17835,96,71250,79245,64,73750,89708,32,54286,46991
17834,1510,51757,61678,941,58264,73602,569,34097,40678
17832,310,34167,48421,175,54583,62426,135,23894,25126
17830,821,59034,76756,609,66875,85635,212,26731,47127
17829,96,70938,77540,74,76875,88243,22,0,37655
17827,315,56875,64745,254,50417,63487,61,42292,59451
17824,1641,77578,85048,1141,101292,105520,500,22833,32082
17823,490,64881,72766,407,71319,78740,83,31719,40425
17822,0,0,0,0,0,0,0,0,0
17821,7638,61194,85642,4897,77017,105889,2741,29089,45796
17820,2221,60349,77176,1517,74669,89485,704,31719,45309
17815,11612,52824,70273,6348,74785,89892,5264,31761,44034
17814,1830,51762,71059,1141,69205,87451,689,34650,42309
17813,753,58125,60512,605,63250,64862,148,22917,32079
17812,613,56875,64951,414,61154,70630,199,25125,47867
17810,652,60086,67315,486,67353,76568,166,29605,37807
17801,6878,45313,62198,4338,61311,77913,2540,23643,31593
17779,88,0,86100,49,0,0,39,0,0
17778,62,0,46340,43,56875,57172,19,0,21826
17777,2884,53793,71107,1839,69753,85997,1045,31037,41672
17776,119,53750,59971,76,59167,61884,43,41250,52581
17774,572,60417,79946,384,72500,88027,188,37727,58455
17772,1043,73313,85820,662,72750,85661,381,0,83247
17771,1289,57361,79889,910,70769,95885,379,27981,36169
17768,164,55357,75586,105,68438,93757,59,33125,38639
17767,23,33250,33413,8,0,0,15,0,0
17765,428,65417,67673,347,57056,64402,81,24917,45491
17764,1102,36422,43936,667,43233,53269,435,19362,26691
17763,128,46250,47776,49,48750,46827,79,0,46997
17762,238,85833,95264,162,115000,117402,76,49688,46091
17760,232,61250,74157,170,66250,80194,62,0,57605
17758,397,49531,71207,248,57917,65388,149,34583,79346
17756,4279,66426,74098,2934,74959,84828,1345,33125,46062
17754,4971,64175,84724,3533,81484,99507,1438,37394,47011
17752,1690,53000,64904,1216,61554,74702,474,27917,35181
17751,2744,60278,70469,2029,67481,79834,715,26250,41206
17750,86,0,77385,63,116146,89344,23,0,44630
17749,114,62750,63546,81,68750,74179,33,37188,37445
17748,84,40938,46140,48,0,50485,36,41250,35028
17747,1088,60750,78035,871,67014,85711,217,30750,42886
17745,7249,47681,62661,4244,62875,78031,3005,27072,38026
17744,1194,52402,63522,840,64091,68987,354,30500,44481
17742,19,28194,53247,9,0,0,10,0,74520
17740,4856,57675,71436,3326,66750,84190,1530,35852,39876
17739,17,0,157000,6,0,379283,11,0,35755
17737,2791,58964,69743,1938,67350,78926,853,34146,43491
17731,95,84750,123652,64,106250,140028,31,0,84381
17730,98,0,26942,42,0,0,56,0,0
17729,35,36250,43794,15,69375,72427,20,25000,20905
17728,2015,61719,74834,1483,72313,84393,532,31000,39273
17727,49,39453,65159,39,39766,72115,10,25000,38040
17724,1905,47557,56495,1437,59327,63139,468,23889,33798
17723,24,38571,55579,13,0,61154,11,35625,46600
17721,662,46167,54250,410,58958,63849,252,30637,36486
17702,4420,58082,70753,2963,73561,79310,1457,36074,45697
17701,17885,46406,62277,10402,58609,73938,7483,28160,41820
17606,259,39018,35376,42,0,0,217,0,28254
17603,25687,61678,78106,15415,76983,92907,10272,39596,52678
17602,18712,60387,78933,12304,70089,89254,6408,42605,56006
17601,21439,80488,108120,15052,95783,126338,6387,47226,61191
17584,4032,85486,99600,3077,91162,103059,955,54063,79393
17582,797,85450,89477,578,95972,102853,219,0,48177
17581,302,62500,69313,210,83846,90634,92,0,17795
17579,2116,73598,90902,1649,79716,102609,467,41534,47413
17578,2630,69024,90928,2016,77625,103465,614,32692,48760
17576,2,0,0,2,0,0,0,0,0
17572,1288,72750,88481,840,103636,117864,448,0,32094
17570,57,0,52226,21,0,0,36,0,0
17569,2135,80497,98228,1714,85241,107982,421,50986,53160
17566,4103,63691,81409,3063,75778,93525,1040,47083,42863
17565,789,92375,118556,692,102143,111853,97,48594,166373
17563,1148,73452,96757,894,81563,110064,254,34375,46820
17562,1434,86094,107416,1217,88341,115639,217,52969,58488
17560,1939,68750,81391,1350,78000,96964,589,22083,43538
17557,5350,64861,78012,3963,78353,92154,1387,28659,35280
17555,2264,72500,119852,1995,80175,122782,269,24635,93910
17554,2874,71712,74880,1815,80448,85890,1059,36326,54688
17552,8582,75523,91584,6256,87791,103411,2326,39854,57067
17551,4200,60429,72308,2273,79109,97094,1927,28858,40294
17550,246,55556,61624,147,78206,72003,99,33288,46210
17547,3037,70663,83508,2231,78237,91654,806,42339,55246
17545,8634,70033,86578,6044,86400,96746,2590,39758,57819
17543,17510,75946,110475,12713,95548,129603,4797,37871,55531
17540,3505,71641,80422,2623,81057,89124,882,39741,52198
17538,2921,85470,87515,2110,98963,103355,811,26616,40015
17536,1065,70042,78442,985,69375,78576,80,63750,70090
17535,720,100150,109768,617,100725,117080,103,46528,62394
17532,1197,70398,78847,884,75259,85197,313,63616,57600
17529,1357,65636,83296,1108,68571,91101,249,41875,48567
17527,1764,82917,93669,1389,90194,101772,375,44191,57383
17522,13413,61829,78472,9526,72768,90560,3887,36805,46045
17520,1904,78169,86051,1447,81414,92582,457,56908,60160
17519,2352,86483,113270,1977,88407,123008,375,41914,61058
17518,485,61544,92999,441,65972,98552,44,0,27993
17517,5474,78169,86544,4078,88415,95842,1396,32042,55425
17516,2017,80125,89899,1439,96306,103913,578,35167,52963
17512,7347,48791,68850,4624,66324,84816,2723,31469,38276
17509,1398,71827,100958,1121,83313,113435,277,45250,45398
17508,106,48462,56208,84,70682,69120,22,0,0
17507,63,0,0,49,0,0,14,0,0
17505,401,79063,101412,372,82321,102143,29,0,0
17502,1042,86985,95555,880,90061,101450,162,50543,55824
17501,1861,64303,79641,1268,81649,85022,593,25506,56689
17408,9584,68052,84739,6381,85733,102020,3203,35089,47650
17407,988,99932,107463,821,101992,113746,167,50139,60827
17406,8962,71477,86445,6238,82521,97840,2724,47090,55033
17404,14447,64692,78898,9250,75464,90621,5197,40704,49396
17403,14768,57056,79083,8942,69760,91844,5826,32619,55315
17402,13767,72299,89975,9351,88720,105387,4416,38355,51904
17401,6669,31497,46597,3455,31162,41031,3214,27169,46255
17372,1498,62119,74434,1052,75833,84967,446,39886,47835
17371,100,82500,74348,84,85417,76500,16,49286,53438
17370,2202,74053,81109,1492,93475,96363,710,41992,47214
17368,2467,64219,83468,1672,85270,97992,795,34807,48322
17366,2259,69447,78185,1648,80941,86306,611,45122,47127
17365,949,74682,84448,717,79464,94601,232,63068,51677
17364,1434,61481,72823,989,76343,82858,445,40599,43721
17363,3333,82607,102931,2597,100346,117163,736,27074,43091
17362,5034,78315,90410,3928,84159,98775,1106,37303,54679
17361,2594,86013,98118,1904,94489,117058,690,26911,40248
17360,2585,83078,99862,1871,97802,114949,714,45431,55045
17356,8650,70145,87178,5793,87466,104746,2857,44555,48538
17355,152,57500,82130,96,0,87671,56,71500,68952
17353,1278,72333,80675,959,93441,94449,319,31076,33329
17352,578,82197,84793,456,90000,91957,122,44375,53323
17350,5031,60215,74103,3588,68670,83408,1443,33563,45872
17349,2670,93137,108792,1997,104871,123132,673,50775,60152
17347,2546,81842,88455,1935,92215,100101,611,37566,46999
17345,3342,64792,73182,2229,77535,84067,1113,47423,48478
17344,1487,52616,61115,904,77705,79899,583,22144,30920
17343,38,0,76100,18,0,0,20,0,0
17340,4334,74583,83808,3078,87173,98010,1256,40050,44539
17339,2934,76609,102225,1978,94250,109137,956,48616,83452
17331,21175,66536,79637,14427,81514,93580,6748,36056,45704
17329,887,87452,103738,762,98579,110777,125,44007,46231
17327,3185,79420,89994,2261,88063,96296,924,43813,63656
17325,10853,69601,86997,7113,91587,104391,3740,36326,48562
17324,1598,64167,77891,1249,72802,88093,349,30404,36737
17322,2340,91293,105389,1956,96450,113557,384,50833,58256
17321,883,92639,100136,667,96458,101675,216,0,90066
17320,3086,75000,87101,2282,87311,100204,804,42852,48162
17319,4448,79746,86436,3191,84264,97482,1257,44126,55583
17318,126,65000,61516,107,64688,60997,19,0,0
17317,205,71458,77516,161,79375,85102,44,41250,46175
17316,3153,84505,95814,2492,92816,105750,661,40656,52582
17315,10799,67716,82687,7449,80108,91504,3350,41636,61010
17314,2124,78582,85762,1570,82245,94344,554,37683,48082
17313,4624,55598,72264,3231,64983,77916,1393,40908,54636
17311,104,58077,55381,51,77679,71308,53,0,40055
17309,901,67574,71266,559,87524,87826,342,35263,44199
17307,2409,67860,77509,1791,84417,89119,618,35800,41184
17306,97,87583,84042,82,87833,84699,15,0,74860
17304,1128,71182,80747,825,84063,92173,303,43250,47247
17302,1062,60625,77080,765,63958,82975,297,52083,59470
17301,1571,73125,84918,1125,80573,91743,446,45172,64537
17272,163,44432,39393,113,52522,46988,50,16488,18754
17271,101,66563,76565,82,70357,83010,19,34375,48747
17270,28,0,0,28,0,0,0,0,0
17268,11652,58607,71479,7750,70988,83371,3902,34810,44424
17267,1123,67361,82099,828,75833,92336,295,36736,44625
17266,185,61477,68948,133,72813,79830,52,30455,31550
17265,269,63802,78749,228,63125,83039,41,41161,42298
17264,946,49539,62571,671,58750,72156,275,28472,35625
17263,233,73031,89070,205,0,93343,28,0,0
17262,543,59766,63453,407,69327,67128,136,49167,44433
17261,0,0,0,0,0,0,0,0,0
17260,442,38625,52006,315,50313,61807,127,18403,27015
17257,11708,53814,68971,6864,75480,85937,4844,36156,42060
17256,56,0,0,56,0,0,0,0,0
17255,469,48644,65176,363,56250,74174,106,23333,24862
17254,36,0,0,36,0,0,0,0,0
17253,150,62917,61770,97,73250,73710,53,43125,39838
17252,1330,54405,70326,1003,76133,81150,327,33603,36658
17251,32,0,67459,22,85625,78423,10,0,0
17250,33,0,0,0,0,0,33,0,0
17249,132,57222,67554,101,70750,75523,31,24107,30897
17247,195,47875,96836,89,58125,62701,106,0,125497
17246,155,61906,60134,136,62295,66646,19,0,0
17244,840,60469,72155,593,70861,83448,247,40771,42264
17243,512,58077,72565,340,72250,85142,172,21406,45855
17241,4629,60258,74941,3339,70869,84624,1290,34462,42939
17240,1442,67766,78396,1040,72317,85273,402,37031,52280
17239,63,56458,75965,39,76563,91092,24,51944,51383
17238,632,57045,68345,486,61786,75273,146,37500,41706
17237,747,60679,70580,517,70042,73944,230,44706,51119
17236,3101,69982,79414,2219,79122,90236,882,33864,48637
17235,335,64404,67840,320,64229,67196,15,0,0
17233,2303,52633,58350,1509,63218,68847,794,25278,33563
17229,569,53875,68411,370,62083,76051,199,29276,52964
17228,411,67679,71602,312,74583,77227,99,50288,52913
17225,7596,73877,99536,5917,81517,111192,1679,46331,54218
17224,983,97774,83221,747,98281,89414,236,0,58137
17223,133,43472,44941,100,43056,41339,33,45417,36673
17222,4635,66146,73611,3067,75324,85811,1568,32033,44509
17221,256,46000,78396,159,65078,100846,97,34688,39204
17220,221,39063,46580,173,53950,52345,48,15000,23094
17219,271,47679,47345,147,54757,70813,124,0,19524
17217,64,59583,54870,48,68667,61123,16,0,36113
17215,88,57222,82265,65,97917,96282,23,35313,34478
17214,424,38864,74921,207,0,99175,217,28118,48707
17213,242,64671,68229,197,65536,73009,45,22125,39660
17212,243,78438,87076,187,80917,96314,56,37500,46254
17211,173,46607,54764,109,65625,71433,64,17333,26373
17210,60,42857,59593,31,0,91358,29,21908,25634
17202,11519,81302,97331,9048,93832,106729,2471,40806,53442
17201,11719,51467,63829,6660,59118,76414,5059,38290,43558
17120,0,0,0,0,0,0,0,0,0
17113,3741,53947,64793,2653,62674,69173,1088,35307,50479
17112,14817,86463,106282,10798,103057,121996,4019,51717,61086
17111,12874,72275,91174,8034,89188,106300,4840,44512,58993
17110,10560,68675,89902,6307,90450,111025,4253,41611,55495
17109,10499,56149,68644,6048,68855,81592,4451,39216,48121
17104,7512,39181,50618,4817,37858,51960,2695,34685,42957
17103,4634,36667,47479,2727,42260,53681,1907,30494,35082
17102,4351,45110,63835,1171,66691,82460,3180,38284,56514
17101,1725,45920,45676,100,0,50015,1625,45401,45409
17099,553,55871,59626,420,56167,60288,133,51339,57536
17098,982,51724,58578,644,57895,65694,338,31923,40411
17097,269,46250,60200,195,57917,71467,74,25357,28424
17094,1022,47738,59672,696,63092,71645,326,25815,30128
17093,514,62438,67372,263,66536,68580,251,61561,63055
17090,2672,68750,76165,1765,84779,88819,907,43221,48172
17088,303,85402,83641,251,86920,88557,52,43712,59910
17087,980,79097,82896,750,85313,92365,230,39167,49372
17086,767,74107,79828,576,76912,89563,191,30313,44910
17084,1734,53772,74242,1261,63566,85440,473,31902,40405
17083,39,133606,122700,39,133606,122700,0,0,0
17082,1166,60284,73214,874,71371,82063,292,30750,39838
17081,191,37604,40609,83,55568,57387,108,28580,27715
17080,111,52188,75656,78,65000,87359,33,38438,47994
17078,8635,66460,82988,5689,82758,98621,2946,36978,49578
17077,0,0,0,0,0,0,0,0,0
17076,25,0,0,25,0,0,0,0,0
17075,68,65000,77991,59,76875,85449,9,30625,29100
17074,2966,66377,75908,2105,76935,85142,861,27336,39670
17073,1995,76052,94441,1623,77160,103951,372,33103,42302
17072,139,0,33786,70,41250,35620,69,0,0
17071,46,68750,74222,26,103750,103150,20,0,36615
17070,7394,72430,87184,4706,88357,101693,2688,46071,57943
17069,55,0,52440,30,69375,63767,25,18542,37544
17068,1644,72969,82844,1268,76667,90258,376,37143,46326
17067,5750,63924,78177,4073,74710,89089,1677,38765,47530
17066,2267,42863,55408,1461,57049,66420,806,21419,28630
17065,1517,58696,73912,894,78125,89269,623,35982,49654
17064,244,96250,118566,205,98958,125128,39,87981,84072
17063,1328,50673,67468,891,64934,79039,437,27031,38636
17062,1595,73036,87888,1187,91563,102121,408,33036,45011
17061,2965,52716,66072,2046,71786,77778,919,33250,38369
17060,378,51833,61158,261,61875,70745,117,24479,34211
17059,3226,46926,65222,2012,71227,81187,1214,31667,34812
17058,568,50500,61527,382,58750,74017,186,21000,29934
17057,9845,66271,79867,5974,80305,98162,3871,39891,48561
17056,41,76875,81480,20,0,0,21,0,64048
17055,16147,77729,96521,10020,95122,116413,6127,44380,61917
17053,2254,70857,87293,1417,89063,100083,837,39750,64213
17052,584,60000,70216,442,71250,79852,142,24583,34106
17051,2016,54508,61484,1551,63317,67482,465,33162,40122
17050,15464,91989,119728,10823,112135,137894,4641,53203,72566
17049,1101,70701,88021,851,73380,99386,250,15833,21155
17048,1555,54494,65523,1074,64196,75335,481,34583,42379
17047,893,66397,75910,683,74893,87470,210,22019,33910
17046,11901,50033,62324,7871,56543,69686,4030,27551,39682
17045,1410,64537,84780,1027,79875,93638,383,32917,55304
17044,9178,50836,61760,5940,56567,68321,3238,30452,42061
17043,2752,63857,85178,1269,83147,115177,1483,49837,57835
17042,14804,60078,77700,9822,76359,92089,4982,37126,46398
17041,93,159766,160606,93,159766,160606,0,0,0
17040,931,73828,91333,683,81442,96781,248,49167,71445
17039,41,0,0,30,0,0,11,0,0
17038,3429,62669,72495,2200,87647,91182,1229,30856,34116
17037,310,49464,58431,236,51818,66132,74,28750,33509
17036,9200,84820,124105,5881,117460,152555,3319,52656,70745
17035,398,43929,47859,283,43125,51403,115,25208,30238
17034,1063,45822,52720,560,52222,61699,503,38466,40702
17033,6864,61722,104812,4657,85372,125897,2207,41524,58004
17032,3228,66538,81493,2308,85921,94183,920,33824,43499
17030,390,34750,61233,207,64338,85720,183,9411,25292
17029,29,0,0,29,0,0,0,0,0
17028,1585,72608,87396,1029,85733,105296,556,36714,45727
17027,87,67188,82217,79,90078,83243,8,0,0
17026,1492,95174,102532,1173,108657,115248,319,51680,54085
17025,7347,71750,86934,4478,86167,106078,2869,47981,53764
17024,720,75063,84371,513,83750,97194,207,39028,51881
17023,1318,65192,74551,994,74375,83711,324,33077,39872
17022,12054,68763,86953,8436,86645,100555,3618,41947,52362
17021,408,40000,60630,257,49750,71000,151,23875,40680
17020,3639,77161,90461,2618,91667,99000,1021,38646,64212
17019,7429,78054,97211,5597,89891,112013,1832,33685,48350
17018,1897,70404,86605,1155,89543,106915,742,45147,54658
17017,658,60385,77916,491,70893,90832,167,31042,39541
17016,472,69231,71441,340,81042,75828,132,0,60143
17015,8307,81749,109699,6305,99665,124232,2002,39184,50525
17013,14599,59977,79232,8800,76233,94066,5799,42299,51131
17011,13802,78861,95684,8852,96449,112427,4950,48399,62860
17010,75,0,0,75,0,0,0,0,0
17009,840,67647,68540,574,81071,79471,266,29318,39780
17007,2158,85000,102179,1650,110146,119185,508,43547,45233
17006,325,50368,72723,249,56458,71747,76,30000,74828
17005,124,54167,65915,82,53500,69563,42,53125,52245
17004,1623,52969,67389,1357,63150,73755,266,23617,31851
17003,4472,75942,87921,3294,89900,99319,1178,37000,52088
17002,219,58906,83918,203,58073,83615,16,0,61094
16950,1272,41090,54616,880,47500,62151,392,17583,29709
16948,589,42566,59501,401,59583,73148,188,21875,29323
16947,1697,52097,64422,1143,61326,77427,554,23500,35315
16946,1003,39890,56605,637,55524,66761,366,31538,35566
16943,172,47500,57143,119,51875,60982,53,26250,36358
16942,295,42083,65754,226,44643,73155,69,28250,37309
16941,33,41563,55242,23,49250,73126,10,0,13480
16940,88,46667,52577,68,53333,58069,20,0,28745
16939,129,36750,51066,106,46667,45625,23,35750,42074
16938,352,61635,72147,222,62200,68358,130,0,76837
16937,69,64464,57677,67,64821,59373,2,0,0
16936,857,56756,69716,610,62500,77120,247,31797,46220
16935,486,60833,75735,344,75000,87162,142,27917,43892
16933,2682,48750,62480,1673,70174,74756,1009,24911,39740
16932,322,51875,61999,214,65200,69594,108,0,46208
16930,462,55938,71340,350,67679,79707,112,28000,43563
16929,956,54786,72080,733,57614,76507,223,41964,51315
16928,546,55208,67787,399,59034,74904,147,33068,44291
16927,203,42404,57318,159,45139,62199,44,38333,39684
16926,340,59167,77972,259,78125,90956,81,34375,35610
16925,1269,56031,69285,949,63021,75487,320,35652,43008
16923,600,54038,57553,453,61964,66220,147,21094,28439
16922,812,42024,53460,496,58107,69774,316,20000,26621
16921,248,40417,47442,149,46653,56916,99,33277,32134
16920,768,52727,63478,496,69306,77571,272,19722,32867
16917,483,54375,67623,308,68250,73706,175,27260,51689
16915,2377,55196,70644,1515,68648,89157,862,30300,36413
16914,945,54361,70162,705,63417,77528,240,40385,42980
16912,832,63152,76402,589,78344,95472,243,20865,28483
16911,193,77159,77984,134,85000,94285,59,32574,36895
16901,4230,52464,66373,2716,61250,78291,1514,31176,41381
16882,145,70060,69643,93,72321,87774,52,36500,37096
16881,1020,38939,55661,787,57645,57769,233,18819,31262
16879,198,41696,51599,137,48438,61415,61,0,28056
16878,665,53583,61453,512,55417,67953,153,20547,34347
16877,847,75417,97146,631,91103,115332,216,0,36894
16876,105,40417,49684,79,63125,59018,26,17500,19638
16875,1524,55000,84556,1180,62188,90554,344,35250,55670
16874,539,60607,65241,370,65000,74366,169,32813,42118
16872,410,60500,72110,340,64545,75717,70,41250,45904
16871,34,61528,57965,28,61667,62586,6,0,36400
16870,2692,107948,144568,2197,116477,161712,495,46440,65026
16868,405,0,89056,155,58083,66200,250,0,103226
16866,3929,45319,62396,2162,66995,85086,1767,25941,31276
16865,716,99912,124230,559,127641,145469,157,33142,47374
16863,205,43984,53700,137,64313,65242,68,16250,19896
16861,160,22500,40986,82,43125,61480,78,17652,18605
16860,243,63246,53006,31,0,0,212,62946,49946
16859,199,59464,68837,133,74063,80159,66,0,43741
16858,1490,60797,68613,1088,67472,79461,402,28772,35015
16855,83,0,32917,20,0,0,63,0,0
16854,272,58500,64155,151,66625,77921,121,35625,46976
16853,96,0,45061,39,59028,64336,57,23393,26505
16852,101,40179,61997,55,71875,96515,46,16250,20726
16851,343,91328,97128,176,170938,144924,167,34803,46755
16849,92,29868,35902,52,44000,43562,40,28289,25945
16848,176,53750,59090,77,72292,77205,99,38472,40540
16847,106,63409,160533,77,0,60930,29,63750,62734
16845,334,58333,67241,221,63942,77592,113,40703,43095
16844,989,74760,77529,739,84408,87627,250,33542,44337
16843,238,38500,43723,118,67667,64973,120,20625,21236
16841,2246,62946,82223,1682,76518,94231,564,31786,43310
16840,177,72054,80756,141,71875,87679,36,0,41500
16839,201,57031,64345,175,64191,69040,26,12031,16315
16838,750,49674,59944,529,56979,64038,221,34375,47618
16837,73,33750,35640,57,50234,39770,16,0,0
16836,459,53750,59517,310,61310,65992,149,30865,41744
16835,94,62143,79544,79,65625,86166,15,47813,44667
16834,240,93302,78381,196,94340,90158,44,0,25920
16833,2227,48285,58817,1475,53157,64618,752,30667,44073
16832,136,83750,78920,102,88929,86807,34,0,52615
16830,5782,47294,68369,3624,60216,81786,2158,27806,43665
16829,289,53188,66056,214,63929,79028,75,27604,29044
16828,2049,65223,98131,1427,84050,109748,622,32045,65382
16827,1805,108142,123803,1298,116731,142736,507,83897,75332
16826,187,58958,61523,91,87946,75600,96,36000,39181
16825,155,60619,54634,137,60837,59209,18,0,0
16823,11699,65654,77578,7437,85713,94601,4262,36352,45708
16822,729,54375,70812,500,72667,85676,229,23173,36615
16821,120,54167,67075,82,81250,84267,38,0,0
16820,481,65875,85375,388,73750,96472,93,38750,37666
16803,10083,60758,85189,5055,90230,120603,5028,29601,48927
16802,0,0,0,0,0,0,0,0,0
16801,18116,50828,74756,7374,106556,124724,10742,30439,39792
16750,189,81563,72475,138,102760,84878,51,37750,38914
16749,1662,49353,61476,1141,60040,67606,521,25443,39132
16748,1086,42857,54681,729,53618,63901,357,25516,33905
16746,475,52277,60798,294,60250,70929,181,33472,42199
16745,276,46731,58816,192,53750,63737,84,27027,44713
16744,100,46538,58509,93,45104,52271,7,0,0
16743,1617,57153,74106,1144,69750,86746,473,26250,38433
16740,440,44079,57551,259,62788,73114,181,24688,34330
16738,601,65202,68733,359,73625,83488,242,31042,41960
16735,2670,46214,60419,1600,59000,74529,1070,27500,37593
16734,118,47500,56179,74,54167,65982,44,31250,35066
16733,57,34750,58419,31,87917,87368,26,18750,21938
16732,108,53971,55729,61,59583,71136,47,0,35732
16731,1101,53050,63117,653,70781,77282,448,34313,40291
16730,48,36429,44715,18,61000,68094,30,34375,30687
16729,295,47798,54657,194,49706,60655,101,33125,40168
16728,14,72500,71536,6,73750,89750,8,63750,57875
16727,54,74792,86067,51,74635,83396,3,0,0
16726,240,60357,83131,193,68438,87334,47,48438,65872
16725,59,67656,78208,45,62583,53278,14,0,0
16724,50,43750,51514,39,44792,55749,11,29375,33655
16720,493,49063,64145,310,58125,76269,183,30927,40889
16701,7220,45963,61639,4364,58889,72390,2856,24748,40559
16699,0,0,0,0,0,0,0,0,0
16695,415,75341,72514,360,77121,78626,55,20625,27785
16694,76,34286,39621,46,55263,49009,30,18750,21203
16693,1450,55238,69049,1030,75222,81760,420,25227,31886
16692,363,53375,59319,212,58214,67699,151,0,44884
16691,159,40625,60018,75,63750,77017,84,28833,43202
16689,198,54250,58716,152,56364,61574,46,34688,40698
16686,5269,52721,64497,3396,70163,76782,1873,29521,40022
16685,94,115135,94306,73,115845,108363,21,29375,40795
16683,124,60000,67181,77,69792,80182,47,44464,45513
16682,16,0,49056,5,0,0,11,0,0
16680,138,49107,71176,88,85313,90450,50,42917,37254
16679,285,39261,45586,210,43750,51697,75,19861,26755
16678,1077,49203,55552,737,54729,64907,340,23851,32849
16677,118,15909,23367,67,0,29891,51,15398,14796
16674,244,50556,59113,173,57159,67464,71,32813,34239
16673,2165,61709,72622,1546,75486,85463,619,27548,37149
16672,82,42917,55578,56,0,63066,26,28750,26550
16671,186,53056,61957,137,61250,68346,49,27250,43761
16670,12,0,52725,7,0,0,5,0,0
16669,866,58000,63836,598,68182,70111,268,30278,45911
16668,1406,58500,62728,952,65972,71916,454,32500,39467
16667,553,39515,52712,374,47500,61601,179,16311,33861
16666,1469,42145,55396,829,61392,64160,640,23971,33290
16665,120,43333,75513,70,136250,105774,50,33750,31252
16664,687,60347,69739,534,65313,76904,153,27917,38285
16662,2331,56285,69640,1628,68750,81628,703,27713,39629
16661,346,46053,54040,247,50057,59017,99,28990,36508
16659,88,37778,47459,61,50893,53616,27,9554,23111
16657,565,53221,63853,439,55750,66826,126,32250,43625
16656,483,39770,53200,367,50875,61019,116,23125,28266
16655,644,52969,69066,448,68095,80939,196,42500,38557
16652,5961,51447,68968,3739,69186,82403,2222,37596,44510
16651,1368,52870,64884,947,66938,76906,421,25433,33075
16650,674,45395,57981,455,58472,69289,219,22656,31641
16648,6267,65029,83220,3945,84971,104701,2322,35992,46692
16647,301,58813,68920,205,70313,79447,96,40500,46440
16646,930,49000,63819,619,52946,66445,311,33036,56307
16645,83,58036,54318,52,75000,65379,31,24276,35765
16641,1128,41127,57805,658,62115,69724,470,28476,36172
16640,299,55982,66356,213,60938,69686,86,38125,49676
16639,617,60083,63907,491,63146,68365,126,34375,45682
16638,14,96250,84600,11,98125,99864,3,0,0
16637,1124,54167,63054,652,70179,76444,472,0,41233
16636,296,74074,78966,244,74444,84797,52,26250,44106
16635,5331,56541,75336,3321,74625,91674,2010,35316,45894
16634,146,51500,53808,95,64375,63165,51,45375,33496
16633,120,59250,58649,112,50625,50876,8,53333,39000
16631,40,0,69225,31,0,83942,9,0,0
16630,1965,55027,63366,1200,69703,80102,765,26997,35569
16627,880,45000,57741,595,60938,70046,285,20545,29597
16625,1616,46548,58231,1070,59375,72019,546,22750,29232
16624,75,62917,68360,53,71875,79460,22,41250,41618
16623,216,51667,67425,166,61250,76992,50,26944,33402
16622,56,46250,65354,41,67679,81271,15,21563,21847
16621,280,59868,69275,209,73403,80174,71,34688,34294
16620,136,48750,61437,94,60000,73823,42,23750,30107
16619,129,51719,76149,87,95268,96908,42,26875,26824
16617,1166,53241,81713,713,80078,81972,453,34018,79694
16616,69,32292,40943,49,37188,49394,20,9773,15635
16613,520,71786,79903,392,91250,90135,128,36833,47973
16611,1041,54563,69261,751,67639,79252,290,40833,39140
16602,12156,43190,61239,7499,58246,74987,4657,26721,36351
16601,13477,46320,66091,8222,63614,79014,5255,22810,40612
16563,0,0,0,0,0,0,0,0,0
16546,0,0,0,0,0,0,0,0,0
16511,4604,51443,68590,3165,63589,73843,1439,33886,53460
16510,9982,56463,71220,6888,72551,81974,3094,26667,42929
16509,11852,60561,75976,6890,76288,94603,4962,37355,48773
16508,6913,50747,65692,3847,65536,81223,3066,34844,43682
16507,3699,34145,42715,1661,42791,49553,2038,22288,32091
16506,9967,70856,93284,6614,87534,115553,3353,32389,47029
16505,7615,61924,89374,4167,81645,113980,3448,39341,57058
16504,6874,43289,55716,4015,63576,69452,2859,28469,34126
16503,5628,26540,37468,3174,32014,38663,2454,20744,33092
16502,6974,30902,42062,3345,41457,49914,3629,22944,33168
16501,1163,11516,16740,53,13807,15998,1110,11343,16708
16444,0,0,0,0,0,0,0,0,0
16443,461,49438,71616,322,61250,90335,139,0,27792
16442,1185,64256,83568,912,70000,88503,273,34464,58380
16441,3994,69527,84352,2978,76858,90574,1016,39196,63489
16440,378,60263,66878,252,68125,77900,126,31000,39766
16438,3176,53032,66110,2091,63910,78037,1085,24882,39989
16436,283,39938,54234,226,45250,54152,57,0,50904
16435,751,51550,58900,543,60250,66337,208,31250,36362
16434,949,48224,60908,748,50417,64609,201,0,45060
16433,2034,60032,72862,1527,63877,81420,507,29550,37901
16428,4795,63616,80208,3035,74330,93471,1760,41382,54276
16427,63,44750,50270,27,32188,43763,36,38750,48717
16426,1458,63889,68556,994,81667,79333,464,33182,40047
16424,1995,49750,68245,1231,62287,84429,764,29449,39203
16423,1714,59028,70589,1078,63571,74435,636,49524,59372
16422,134,38333,50125,85,70268,61844,49,23516,27235
16421,1022,68784,77001,678,83214,89986,344,0,32142
16420,223,38125,47818,165,39750,49767,58,30556,36043
16417,3417,67225,76736,2461,78607,90373,956,28963,37862
16416,80,60417,54569,42,38333,53671,38,60917,55471
16415,3229,96366,112825,2600,102574,122495,629,35907,64180
16412,4347,54641,72507,2640,74967,88692,1707,32131,44440
16411,562,75571,77878,405,82438,88931,157,50139,41538
16410,725,80708,95018,614,90694,103165,111,39250,44830
16407,4698,45717,62233,3043,57228,75262,1655,25389,37398
16406,1319,55445,63051,930,59643,68480,389,39107,48153
16405,308,65000,77116,229,74861,89965,79,29063,36051
16404,1256,52500,59428,893,62446,68009,363,23583,33883
16403,2537,58203,76015,1694,70104,87229,843,37961,49541
16402,326,60500,73501,198,66250,89963,128,46458,47455
16401,1641,51470,63628,1094,66528,74674,547,28813,39018
16374,816,43250,58199,506,56875,70400,310,31364,38053
16373,1302,57000,70583,909,71563,83346,393,30250,38130
16372,242,43750,56649,142,51923,66082,100,19569,38629
16371,1382,46552,55085,898,60643,69174,484,21944,27331
16370,145,42188,46783,85,45625,46218,60,35000,47583
16365,8175,51091,66393,4954,67844,80621,3221,31206,41903
16364,475,63542,68868,367,67109,73226,108,27069,46670
16362,391,58750,73970,286,68500,80363,105,40469,40950
16361,5,0,0,5,0,0,0,0,0
16360,592,50556,63340,454,58333,68528,138,31875,44845
16354,4515,44321,57051,2839,54792,65973,1676,27121,38102
16353,1450,45270,53946,826,57500,61881,624,31154,42097
16352,75,59375,88323,45,67917,77182,30,35000,104200
16351,671,40801,52659,409,46484,57726,262,27667,41425
16350,873,47617,59444,623,52813,66968,250,26875,37389
16347,833,41679,49110,544,44808,56406,289,28490,33524
16346,1620,52304,59397,977,61719,71580,643,25373,38133
16345,1509,80337,103507,1150,91875,107341,359,31908,90512
16344,174,48571,54324,106,57000,65896,68,24423,26828
16343,295,54821,60468,193,66620,63284,102,41570,41314
16342,867,63304,70478,569,64156,72353,298,48750,63853
16341,763,51331,59913,526,57500,66626,237,28750,41504
16340,734,57969,63292,527,68882,73332,207,29688,36605
16335,11767,49555,66479,7255,63975,80501,4512,28400,41010
16334,156,68571,71884,101,62917,68064,55,105163,78898
16333,121,44750,72287,80,80000,96516,41,19375,24798
16332,8,183000,145000,8,183000,145000,0,0,0
16331,23,67969,64448,12,66250,71117,11,0,0
16329,204,59706,68849,166,65000,76452,38,22000,24503
16328,61,42083,56702,47,46250,57987,14,34167,28007
16327,1075,62431,73791,839,72120,83360,236,27143,37489
16326,131,49954,118159,105,75729,140720,26,29167,27046
16323,6667,51135,66270,4386,63438,78495,2281,27185,40423
16322,47,27188,37253,20,55938,53115,27,0,25504
16321,26,0,43046,3,0,0,23,0,42883
16319,527,52426,68774,377,67917,80184,150,38974,39718
16317,549,49406,56260,396,56333,64777,153,33304,33904
16316,2292,59212,70529,1302,76154,84542,990,40724,49932
16314,2188,56596,65850,1535,62275,73921,653,34572,42954
16313,762,47115,59580,518,52778,67958,244,23654,32178
16312,0,0,0,0,0,0,0,0,0
16311,200,67500,70326,138,84000,82991,62,31250,42137
16301,6462,47072,62183,3906,58373,71444,2556,27322,45519
16263,103,72865,62051,90,73542,68313,13,0,0
16262,1222,58913,75325,858,81108,89115,364,36908,40717
16260,150,44038,63541,72,0,94904,78,23452,34591
16259,871,48506,60820,636,58125,67818,235,25871,35017
16258,773,49250,58442,468,71786,72766,305,20417,33152
16256,510,41500,58374,434,46731,62198,76,23333,36075
16255,682,47381,60742,463,64519,69928,219,30703,37594
16254,1436,55435,67136,924,66071,80199,512,31902,40595
16253,57,59375,67798,25,67083,83728,32,0,55350
16250,166,0,48853,142,24643,46225,24,0,27171
16249,812,59947,71952,562,79167,82046,250,32750,45003
16248,1249,48963,54376,800,59444,64544,449,25893,34602
16246,73,38438,58344,66,42500,58817,7,17188,18843
16245,102,45417,45143,49,60139,58104,53,34063,33160
16244,158,58971,60068,144,40833,55401,14,0,0
16242,1824,48902,61744,1242,65000,74215,582,24091,32790
16240,639,49837,62040,411,62750,74174,228,24677,37648
16239,590,40833,44514,393,45101,46584,197,25083,34915
16238,190,67019,76139,119,81607,88985,71,65250,52930
16236,112,0,32271,64,67917,51231,48,0,0
16235,526,67037,76301,378,81250,90271,148,30139,39389
16233,548,69688,84324,387,83615,102061,161,17750,25498
16232,1689,48021,63532,1190,54231,70671,499,33008,40311
16230,196,42917,48685,134,50000,56103,62,21250,29521
16229,2197,67462,92212,1538,79853,106770,659,36713,54958
16228,175,41750,53900,102,60000,65605,73,28750,37134
16226,3505,51592,61913,2249,65319,74883,1256,22833,37402
16224,446,64583,72107,370,68203,76854,76,38333,39001
16223,80,32000,37228,41,46563,51485,39,18523,19582
16222,1016,49653,62444,786,58846,68664,230,24500,39310
16218,463,60156,73874,355,72634,81415,108,31250,49086
16217,84,40208,44064,42,45208,51214,42,31563,36914
16214,4170,43188,62778,2104,76500,92046,2066,20913,30138
16213,62,38750,49011,27,47250,57019,35,35179,42834
16212,145,37250,42837,71,58750,60179,74,23056,24622
16211,34,36250,46588,22,55000,54768,12,30714,31592
16210,322,46000,69857,207,70865,93101,115,19205,26985
16201,6987,55758,72773,4674,72170,85006,2313,30146,45742
16161,307,38170,44871,129,47917,54486,178,32188,37748
16160,496,35795,42721,255,37440,53810,241,25856,29451
16159,2305,58420,74221,1584,75896,78890,721,34234,63191
16157,1363,54676,69402,916,69400,82024,447,32760,42701
16156,1241,57050,69794,887,71450,80272,354,31337,41564
16155,49,22426,30639,10,0,0,39,21691,23228
16154,974,64250,69731,694,82031,81624,280,36000,39571
16153,992,55862,69435,617,79313,86505,375,33309,40234
16151,31,56406,53606,21,57321,57695,10,48750,45010
16150,3118,52222,63991,1956,71610,80868,1162,24421,34352
16148,7566,59662,75334,4649,77394,93941,2917,32024,44126
16146,6214,31837,43973,3534,50160,54447,2680,21650,27484
16145,1330,49825,63443,873,63750,74040,457,29438,39130
16143,979,57669,76702,690,78571,88561,289,42153,45242
16142,2010,62500,89255,1398,74914,106051,612,35608,46108
16141,691,55729,68287,513,61689,78894,178,27500,33012
16140,107,63859,60994,70,89722,79189,37,21042,26576
16137,4443,58408,70549,3046,75539,83928,1397,29233,38534
16136,354,55179,57389,207,58125,60571,147,49583,51557
16134,1680,46641,58003,1183,51215,66059,497,26406,36849
16133,579,65250,81067,448,75000,89557,131,40750,48831
16132,154,29625,39043,65,0,38643,89,30337,39336
16131,348,61136,78907,249,67969,92470,99,27292,38182
16130,886,47200,60038,625,54531,68016,261,26250,38149
16127,5409,60394,79802,3344,80313,101311,2065,31238,41861
16125,7056,49790,63815,4605,63787,73570,2451,30722,42757
16124,711,50060,65864,503,60250,73702,208,32763,45145
16123,965,89915,127650,777,97917,139838,188,54000,72673
16121,2197,25261,39490,1235,28906,45588,962,18885,30161
16120,986,60278,66304,756,63167,69975,230,50417,45865
16117,7626,56800,67947,4805,70559,81605,2821,34844,43345
16116,1233,53169,67458,932,59821,79349,301,21992,29416
16115,1375,60273,81156,922,80189,95816,453,31042,45251
16114,220,63571,76405,170,66167,86009,50,35000,43754
16113,192,84167,102589,144,87778,113218,48,45000,66171
16112,639,75156,91551,455,89489,110052,184,26716,39388
16111,501,46094,54701,361,59688,63931,140,25000,29436
16110,149,67250,109532,117,73750,92011,32,0,171619
16105,6947,62763,83757,4310,83177,107825,2637,31051,42950
16102,2281,45299,56905,1517,58348,68308,764,23814,29495
16101,13832,42917,56342,8528,55865,69186,5304,24779,34273
16066,12656,108249,132002,8776,127045,152278,3880,63670,83611
16063,3420,63598,86447,1954,102534,114051,1466,41654,48528
16061,1160,65732,75262,816,77917,85421,344,46250,49456
16059,3375,79393,105295,2305,102813,127318,1070,42500,57021
16057,4669,53750,69455,2490,84667,94043,2179,26470,37561
16056,2006,62059,78464,1223,85938,100967,783,35275,41703
16055,3357,83275,98832,2583,103642,112383,774,44545,52146
16054,174,44000,57212,111,52083,61670,63,34375,45790
16053,1720,79630,95425,1233,93201,114273,487,44104,44860
16052,1023,70045,78343,753,80274,90525,270,38661,41133
16051,1229,63988,76646,824,85865,93124,405,31971,41698
16050,549,58750,65953,402,69022,73024,147,33482,38133
16049,1203,49331,63097,825,63083,75644,378,26558,32973
16048,42,80938,90967,39,81406,94313,3,0,0
16046,6354,110367,150653,4529,130532,174617,1825,65856,90343
16045,423,66705,74886,328,83667,85167,95,38750,37912
16041,876,55682,68773,646,68393,79865,230,19327,35782
16040,356,65972,73048,275,79063,82628,81,21806,27056
16038,1369,69931,88936,982,81919,94769,387,40063,72112
16037,1779,83607,99894,1328,98438,113254,451,45893,53808
16036,137,49583,62236,107,68542,71216,30,20000,29417
16035,33,117656,100258,33,117656,97991,0,0,0
16034,777,82321,76201,624,88125,82539,153,32813,41646
16033,2908,81432,89615,2031,85547,100415,877,54009,57430
16030,117,50313,58296,87,58594,64871,30,23750,31250
16029,402,46923,55873,277,47607,59938,125,38558,42614
16028,754,47125,64945,487,65625,82022,267,21641,31941
16027,101,48125,74607,75,59063,83232,26,41364,40958
16025,2034,70615,89606,1411,83239,108082,623,33661,44705
16024,102,68750,77970,82,85000,86191,20,24583,28330
16023,1818,49000,67141,1160,72212,85182,658,23716,31299
16022,155,63281,89659,119,63281,103913,36,20000,32186
16020,402,54821,69747,295,64306,73757,107,41458,51605
16002,6398,63310,80962,4401,78641,97204,1997,27396,41364
16001,17616,55214,71375,9819,76379,93049,7797,31033,41432
15963,4596,48266,65467,2934,72660,78673,1662,27474,40036
15962,93,44375,63012,66,73750,70336,27,38750,42004
15961,326,53000,67819,231,61750,74782,95,23875,43033
15960,124,52763,58526,62,44000,61358,62,53289,55694
15958,809,63641,77180,640,74444,84895,169,32411,38170
15957,218,67386,74600,181,83125,82652,37,0,33532
15956,1239,42351,57058,714,64630,66805,525,24671,42640
15955,931,45982,62208,669,58194,71223,262,30714,35053
15954,1079,41250,51622,668,55000,67372,411,16017,24017
15953,21,0,0,21,0,0,0,0,0
15952,552,56016,71351,466,63462,79885,86,11157,12490
15951,262,34452,47734,135,48901,61808,127,31890,32773
15949,205,43618,53797,136,60625,66464,69,25250,28829
15948,191,58523,50725,169,68625,52791,22,0,0
15946,2828,50714,62394,1839,67109,75674,989,27543,34177
15945,18,0,41133,8,0,0,10,0,0
15944,1184,59741,76293,868,65577,86771,316,32685,40393
15943,1640,40897,52136,1025,56326,66476,615,16567,24855
15942,851,66520,87415,632,79722,102222,219,38603,39117
15940,707,78021,82152,481,86033,95336,226,37500,52171
15938,982,52905,64024,718,64868,74579,264,21250,31605
15937,297,48536,57609,162,71926,76695,135,36488,34706
15936,689,57813,58580,511,75365,70344,178,22396,23767
15935,1276,66574,74649,1014,71981,82103,262,28349,35192
15934,13,0,0,13,0,0,0,0,0
15931,3788,55670,69200,2340,75872,86539,1448,37645,40229
15930,81,33079,35041,65,33567,40263,16,0,0
15929,25,0,23436,6,0,0,19,0,0
15928,979,57404,83439,612,91786,107792,367,33494,42830
15927,422,45455,52269,209,78194,80992,213,0,22708
15926,1081,55170,67525,746,72000,80299,335,24196,38263
15925,63,63125,69708,46,70833,81996,17,31875,33147
15924,414,59500,60220,262,63269,67262,152,42813,48082
15923,652,54375,76276,480,79063,83968,172,26250,33193
15922,118,26475,33581,50,36607,43366,68,0,0
15921,46,42500,36774,7,0,0,39,42880,38015
15920,310,60893,72594,208,71964,95093,102,23587,26713
15909,2022,52333,63842,1388,61724,73354,634,29844,37961
15906,4864,33658,47768,2794,39507,59973,2070,22124,29537
15905,8973,56309,73395,5569,74830,93088,3404,32226,40190
15904,6782,57212,74439,3837,78838,100457,2945,26903,38403
15902,5149,35883,46113,2822,47153,57473,2327,22286,29907
15901,2094,19022,26740,667,36511,39037,1427,13945,20728
15870,544,48816,63122,341,66406,76630,203,31838,38308
15868,620,55417,80818,416,68468,106266,204,19808,25866
15866,81,54583,66732,48,69000,77060,33,26875,48915
15865,591,40560,49028,341,51250,60245,250,27292,30183
15864,621,48958,58119,441,58542,68320,180,23000,28593
15863,91,41607,51319,52,56250,57312,39,24107,42605
15861,76,35625,43826,38,45000,52497,38,28929,34639
15860,511,56118,63745,316,67717,72397,195,29688,47033
15857,5997,54970,68370,3594,73866,82291,2403,27272,43286
15856,372,51053,67162,253,65208,79875,119,40221,40134
15853,2967,54081,64544,1731,63850,79870,1236,31474,38147
15851,2645,50308,62116,1691,65199,74903,954,26226,36222
15849,540,51250,65901,341,65820,79994,199,32847,37034
15848,371,42813,58522,237,58375,66474,134,24926,43316
15847,132,38594,42876,87,44792,49867,45,26458,29080
15846,1558,73230,85264,1111,79688,91835,447,40486,65831
15845,1439,48011,58764,814,58542,67960,625,33939,40211
15841,169,37813,47238,142,43382,51002,27,0,15963
15840,828,50887,70924,545,59728,67904,283,31181,74296
15834,2113,40675,49337,1236,50663,60870,877,26098,30955
15832,132,33333,42854,75,45625,56969,57,19028,24281
15829,518,61250,90702,391,62969,101151,127,30313,41641
15828,122,31667,47631,49,58750,71092,73,24250,31884
15827,122,68438,64443,85,75792,76096,37,0,37668
15825,3817,57960,73970,2552,66419,85613,1265,33523,46745
15824,2101,50838,63770,1311,64769,77419,790,30409,37688
15823,524,54338,64417,315,72938,80234,209,31875,38294
15821,61,45341,47689,36,46111,56000,25,36563,35716
15801,7800,53634,63384,4803,66928,75690,2997,32080,40235
15784,23,68750,151357,16,76250,73100,7,0,330229
15783,35,53194,66683,28,54167,80350,7,0,0
15781,42,48125,58071,26,60714,71577,16,27917,36125
15780,57,60536,59039,54,61071,60044,3,0,0
15779,140,62857,62104,133,64107,64644,7,0,0
15778,65,78125,86628,54,102500,96015,11,21250,25155
15777,42,0,41350,26,48636,54581,16,0,0
15776,29,33750,53672,18,0,74139,11,0,0
15775,368,42256,51666,255,58006,57413,113,33698,38399
15774,1133,64750,80730,859,70474,88161,274,36633,54573
15773,222,53235,62553,182,57500,68497,40,25833,32518
15772,599,47768,61473,429,65040,74212,170,14840,22906
15771,370,47059,58829,247,52969,72175,123,24934,31907
15770,88,63056,62083,61,80750,77820,27,19821,26530
15767,6005,43653,58218,3738,57253,71829,2267,25893,34455
15765,610,70333,80669,480,79583,84295,130,43676,65608
15764,74,50227,103441,59,51719,124475,15,0,20713
15762,364,74500,76443,304,84211,83578,60,32750,31635
15761,39,37750,37908,25,38750,52052,14,0,0
15760,54,48056,48309,48,0,25615,6,0,0
15759,1083,57583,67273,823,67208,74326,260,24479,41203
15757,605,40515,51256,452,46364,55944,153,29250,35756
15756,83,36563,42014,34,36750,52188,49,36375,34955
15754,209,74811,65646,157,72841,59176,52,0,0
15753,177,45179,51827,123,54063,61708,54,21667,27900
15752,14,0,0,14,0,0,0,0,0
15750,80,32500,31703,71,32875,33306,9,0,0
15748,2923,52155,63767,1999,63293,73875,924,28140,36665
15747,700,46875,57626,503,59688,69538,197,22279,27090
15746,46,31389,38872,23,56250,56791,23,0,20952
15745,97,0,53394,64,82778,70034,33,9087,11394
15744,48,42000,61927,33,67813,78845,15,0,24700
15742,337,47321,79150,251,59028,95938,86,23281,26020
15741,25,59792,70308,22,73333,72005,3,0,0
15739,199,62188,62675,163,64896,67952,36,26667,38783
15738,90,36250,44540,42,52917,60476,48,14808,25902
15737,45,40417,38389,28,0,59236,17,0,0
15736,335,56250,60996,217,66520,71654,118,34750,39047
15734,187,34886,36319,135,34432,36288,52,45469,35542
15733,85,15341,26760,31,31750,28632,54,14306,18428
15732,626,50000,64210,470,57188,72134,156,23542,38516
15731,164,47791,49037,131,48750,54013,33,34250,0
15730,50,50833,41354,37,53250,45268,13,40313,30215
15729,576,50688,64502,345,67125,79642,231,17819,41888
15728,1289,51103,69180,880,62600,81787,409,21773,37652
15727,70,53750,50279,49,66458,53500,21,30893,40348
15725,603,51250,64905,402,54583,68443,201,38239,54633
15724,864,49653,64715,639,58021,74272,225,24931,31697
15723,12,0,0,0,0,0,12,0,0
15722,844,56429,66226,551,74196,82010,293,30559,34057
15721,86,46875,55749,56,43750,53298,30,46875,55163
15717,4368,59942,70096,2845,72507,81398,1523,37917,46025
15716,322,25703,62941,230,0,46263,92,0,96874
15715,198,41250,47390,118,42955,51263,80,31000,40461
15714,1925,41331,51405,1181,54338,63964,744,17685,26659
15713,117,0,43114,117,0,43114,0,0,0
15712,88,0,61905,60,112600,82878,28,14559,16961
15711,174,58750,59305,119,72188,68842,55,36875,38204
15710,66,55167,59738,32,93333,83422,34,0,37450
15701,13486,46471,66500,6537,78078,91626,6949,24761,41825
15698,318,42759,56576,196,0,57463,122,42845,55152
15697,1350,57955,71616,795,82321,90364,555,41008,43681
15696,114,52500,64796,84,60625,70817,30,43750,40397
15695,146,0,81642,113,0,93504,33,0,35179
15693,50,0,0,50,0,0,0,0,0
15692,428,41806,51806,247,0,55034,181,41979,47402
15691,0,0,0,0,0,0,0,0,0
15690,4034,47042,57526,2488,53409,66485,1546,32273,40145
15689,79,82396,72678,67,81146,63691,12,0,0
15688,406,68714,80169,258,93684,105530,148,33750,35958
15687,478,54643,63693,338,60577,74222,140,23333,38273
15686,367,63995,67683,329,63614,65701,38,108167,81950
15684,295,48750,58179,250,48525,58824,45,58558,54558
15683,3582,51239,65798,2092,70833,80238,1490,20500,33473
15681,1977,58371,69288,1348,73188,82559,629,27375,38634
15680,117,38457,43126,38,42500,58655,79,38457,35657
15679,1273,51109,63303,628,74643,83720,645,0,42706
15678,254,77609,74292,198,79674,80473,56,50972,50888
15677,158,36786,56958,76,73214,68757,82,35682,45330
15676,263,0,76555,187,109514,96921,76,25313,26446
15675,389,54750,59571,316,60455,64590,73,40417,34107
15673,596,52361,74212,335,74511,84814,261,31161,60082
15672,1406,67039,87767,980,80379,98669,426,32500,61581
15671,253,64375,67938,202,66223,76336,51,45508,34673
15670,1324,78500,76090,996,80323,79230,328,37647,45907
15668,5423,101938,136159,4205,117390,151569,1218,50341,80616
15666,7218,50877,61809,4495,64116,76235,2723,29012,35784
15665,479,46328,60318,297,62569,67472,182,0,34591
15663,226,51875,66179,152,59167,79052,74,28750,39736
15662,280,68187,59847,245,68413,65143,35,0,0
15661,297,65649,65549,247,65841,69710,50,25385,41080
15660,216,70000,69883,143,88875,80064,73,45598,46000
15658,4125,67425,101557,2775,84681,121757,1350,35268,57316
15656,4074,65074,75652,2818,74620,84832,1256,38889,48274
15655,102,0,74998,57,0,72986,45,0,77547
15650,11495,56735,75212,6963,74953,89179,4532,32227,50016
15647,159,66705,71220,117,59196,71620,42,0,0
15646,104,69286,70179,95,80568,73921,9,0,0
15644,8678,55564,67752,5038,73349,84321,3640,28770,42883
15642,18578,74035,90924,12556,96751,110728,6022,37284,48218
15641,235,48068,54231,139,65673,69437,96,23333,30591
15640,211,86850,83370,165,89219,93242,46,20833,32633
15639,936,66698,76798,661,67261,89153,275,32422,44297
15638,66,56250,50917,12,0,0,54,0,0
15637,490,64038,66464,378,75595,76127,112,20250,25256
15636,1743,122679,130812,1462,133306,145929,281,0,47005
15635,79,0,39099,9,0,0,70,26250,33770
15634,193,0,31954,55,65987,62116,138,13971,19933
15633,241,36797,43542,115,0,49065,126,20156,20930
15632,3595,77261,113366,2267,111841,148513,1328,35902,51290
15631,440,45900,52747,263,55938,60031,177,28828,34058
15629,309,48090,47557,201,48309,48232,108,34286,41306
15628,245,53601,57956,159,54353,60564,86,47000,53135
15627,2639,52712,64609,1535,63520,80330,1104,32326,39752
15626,2433,65287,87656,1545,110216,117346,888,21685,34372
15625,27,0,0,15,0,0,12,0,0
15624,186,0,58290,78,127833,114250,108,16210,17875
15623,326,47359,56416,245,45547,51488,81,0,43199
15622,491,93669,92027,354,96786,101686,137,38839,67070
15621,30,0,0,30,0,0,0,0,0
15620,268,41607,42807,87,61875,68032,181,26607,28107
15618,1096,48362,57936,733,59362,65547,363,24083,40516
15617,152,55000,73411,82,65833,63105,70,0,83580
15616,0,0,0,0,0,0,0,0,0
15615,139,106719,112445,139,106719,112445,0,0,0
15613,5527,60702,81049,3957,72128,93077,1570,31357,46901
15612,170,0,36126,102,74583,54884,68,0,7991
15611,259,31793,44893,83,64542,61201,176,26875,32284
15610,1806,61351,70468,1294,67614,79714,512,45180,44236
15601,24492,60984,80868,14921,85592,102037,9571,31987,45728
15564,23,53125,59026,13,102813,91477,10,14167,16840
15563,1286,51167,64102,885,63938,77983,401,22031,32350
15562,81,101875,103915,77,103125,107194,4,0,0
15561,87,46083,56949,62,65833,67860,25,33162,29148
15560,57,34028,56160,36,51250,70039,21,24688,30667
15559,720,57656,71562,499,72396,85134,221,30625,39442
15558,772,57614,59752,602,65156,65720,170,19563,34741
15557,1447,47781,62341,949,62798,71455,498,28667,43711
15555,30,50833,50543,19,65417,67021,11,0,0
15554,1142,53077,67103,660,78952,87625,482,18487,38926
15552,2289,50457,63120,1456,59071,73208,833,36080,43028
15551,267,55673,61320,193,60991,71381,74,27143,35078
15550,721,52589,63977,468,68289,73071,253,27083,43010
15547,284,51198,80108,227,51555,78451,57,41875,66342
15546,204,0,47807,77,85673,96788,127,0,0
15545,1134,49052,59773,834,56974,68046,300,23750,33857
15544,48,63065,54640,48,63065,54640,0,0,0
15542,451,46442,62075,341,46406,67932,110,27857,31841
15541,1358,54926,69458,914,69274,79213,444,25938,44413
15540,127,58199,65769,97,58125,73421,30,30625,31397
15539,125,0,67228,104,91875,77062,21,0,0
15538,283,53250,90593,191,61146,69945,92,32500,131209
15537,3518,47180,64579,2137,64239,77947,1381,27196,37591
15536,146,60833,65490,100,66667,75243,46,26250,37570
15535,830,48750,61424,574,59405,71325,256,29643,34880
15534,383,51193,71131,231,52266,90000,152,0,41073
15533,520,42717,58698,326,46111,70303,194,26029,35923
15532,61,51250,59275,37,32083,41616,24,91111,82646
15531,1539,42644,56241,1092,52857,64711,447,22380,33253
15530,2047,58480,74068,1496,67287,83975,551,31313,46739
15522,4961,54975,64589,2953,71544,78381,2008,28938,42677
15521,675,47298,67394,528,53942,71833,147,21420,49484
15520,104,57083,62053,104,57083,62053,0,0,0
15510,8,0,0,8,0,0,0,0,0
15502,44,93056,79714,23,93194,87670,21,0,71000
15501,6378,51524,66993,4201,62437,77034,2177,30354,46283
15492,53,0,35787,48,0,36500,5,0,0
15490,207,0,59734,119,42813,43450,88,0,78553
15489,144,29556,50147,76,0,70033,68,27222,23178
15486,974,56202,62906,579,76544,78677,395,29514,39458
15484,169,81117,78925,169,81117,78925,0,0,0
15483,186,42414,65948,111,61250,81904,75,40163,39756
15482,142,38365,56896,37,0,103022,105,33304,40643
15480,941,32536,52468,530,56014,68646,411,20532,25693
15479,905,71086,178635,751,71947,203971,154,34167,49132
15478,2379,59469,78768,1616,70787,91025,763,34477,43612
15477,382,52188,64862,181,72125,83646,201,43938,45947
15476,22,0,0,22,0,0,0,0,0
15475,551,42563,55887,361,52679,67715,190,26750,31036
15474,683,52946,69909,474,55781,80874,209,32438,37499
15473,1639,63710,66715,1109,74750,77697,530,30625,42458
15472,90,43158,41818,55,44309,57689,35,0,16877
15470,296,75750,95299,220,92794,115120,76,30625,35982
15469,1085,36329,53449,766,42115,63943,319,25917,25359
15468,1073,56019,57945,821,62879,62742,252,27619,31179
15467,59,58250,54458,44,60833,57498,15,34750,43693
15466,192,52500,61666,131,52404,65592,61,67563,53238
15464,588,48750,79055,353,99306,102109,235,35551,42314
15463,45,0,0,45,0,0,0,0,0
15462,97,0,49406,59,78203,65149,38,0,0
15461,1709,43510,52899,1058,58721,60724,651,28661,34294
15460,55,0,53169,45,82574,60300,10,19286,21080
15459,559,67386,65918,353,77734,78616,206,31029,43454
15458,997,63117,62712,753,63524,68534,244,29891,41447
15456,1257,38534,47014,819,48803,54771,438,25476,30268
15455,138,61750,50646,99,63750,62891,39,0,0
15454,48,38816,36752,34,0,0,14,0,0
15451,470,29361,76606,313,29792,39189,157,0,147103
15450,92,120833,269729,31,0,0,61,0,0
15449,94,56667,55311,83,60104,59200,11,0,0
15448,93,64028,62425,68,65938,71563,25,0,0
15447,51,0,0,36,0,0,15,0,0
15446,80,0,57555,35,0,0,45,41250,49638
15445,1194,49891,77814,649,79267,102398,545,31215,47609
15444,198,0,63002,122,101090,89594,76,0,0
15443,8,0,0,0,0,0,8,0,0
15442,912,41797,62540,622,64107,78318,290,19750,27713
15440,62,61786,67805,49,61607,73812,13,0,0
15438,873,64219,75103,621,85066,84728,252,37917,47937
15437,803,66950,69853,397,83068,81761,406,65549,58209
15436,1103,47875,56531,717,52434,59716,386,36818,46813
15435,170,48611,57380,127,51473,66598,43,26853,30153
15434,132,46500,52295,82,52500,58609,50,28000,32290
15433,298,36458,48198,214,45938,58367,84,15800,22290
15432,210,50417,58004,122,59500,69687,88,27143,40222
15431,1812,51840,67652,1136,61413,75507,676,30263,41629
15430,139,50750,61682,130,51500,63061,9,0,0
15429,139,0,53599,64,0,51497,75,0,55392
15428,745,62361,71677,568,72083,80076,177,30536,43947
15427,418,44688,69973,296,61429,81310,122,28125,40799
15425,8518,45931,61019,5397,58664,71640,3121,20686,39783
15424,936,35268,52425,542,49375,62750,394,21098,36290
15423,791,48050,75446,598,66324,88432,193,24659,28849
15422,79,0,54880,38,116071,102121,41,13807,11095
15421,23,0,0,15,0,0,8,0,0
15420,74,37188,42657,52,0,48140,22,0,0
15419,1594,36122,50719,704,54500,75169,890,22396,30680
15417,3556,47829,58776,2235,57679,66579,1321,25602,40435
15413,149,0,42931,83,0,58492,66,20988,20553
15412,209,49821,53584,105,59821,67358,104,26250,38979
15411,271,51375,64990,185,61250,80505,86,25658,25219
15410,522,65119,61945,302,67440,77827,220,0,38946
15401,13513,48176,67117,7528,65556,86669,5985,27249,38919
15380,300,49915,64377,164,89375,78401,136,47778,42232
15379,42,63750,62167,29,59583,64924,13,42813,36131
15378,21,0,0,21,0,0,0,0,0
15377,250,68438,110308,203,87708,115147,47,0,44317
15376,607,63125,107266,439,85625,89189,168,32250,152638
15370,4959,54797,71005,2948,73170,86518,2011,27321,46606
15368,174,34464,50048,122,52750,54539,52,25455,36781
15367,3058,150800,195072,2743,159883,207540,315,41920,78973
15366,245,33957,50038,47,150474,125955,198,33633,32017
15364,320,66250,106508,235,85804,129428,85,34313,43141
15363,208,46694,74728,141,46169,59874,67,0,105987
15362,357,62639,69794,218,79688,81372,139,29315,50001
15361,91,0,78226,78,0,70495,13,0,0
15360,679,77321,95263,555,87292,106769,124,39375,42850
15359,82,85192,73389,55,0,64100,27,0,70859
15358,400,73158,64811,254,85323,79735,146,23571,30669
15357,602,66250,71138,440,73500,77490,162,43056,49959
15353,71,47679,74920,36,106250,105919,35,32014,43034
15352,451,52516,60075,265,49375,69838,186,52649,44637
15351,373,58342,44736,262,58061,47542,111,0,21708
15350,170,56346,58151,101,64219,64759,69,49886,44652
15349,634,60962,72040,424,75909,83671,210,23750,40718
15348,65,31042,45311,34,0,48415,31,40250,41906
15347,132,89141,100874,114,0,113276,18,0,0
15346,210,49500,75079,168,65000,77933,42,30833,39652
15345,564,53571,65127,374,60000,74587,190,27055,40309
15344,719,61898,74525,508,81100,80921,211,31469,58859
15342,2265,70339,81947,1517,90017,96403,748,37939,51344
15341,333,64063,75422,235,64563,75996,98,54464,64953
15340,519,79728,95689,419,104896,109848,100,0,36365
15338,674,49615,88169,530,48846,97528,144,23500,38875
15337,174,64722,80169,138,66250,85443,36,35000,47417
15334,54,78158,86507,48,78553,92431,6,0,0
15333,738,39938,67235,505,62404,84103,233,16250,25303
15332,3781,64129,83220,2299,88494,104933,1482,36739,45443
15331,314,42375,70018,203,50724,76735,111,33750,52250
15330,2070,84444,99526,1624,92308,108825,446,48929,61493
15329,616,65000,79730,495,74375,82846,121,47031,66263
15327,622,62222,77178,461,69306,87629,161,33295,45295
15325,172,32206,41825,105,0,52738,67,19764,24721
15324,315,31991,44974,192,44375,54572,123,25875,28922
15323,1687,67981,85013,1235,77536,91438,452,36000,63667
15322,732,63750,89068,472,74327,112806,260,25000,32858
15321,575,99514,102595,442,107813,105301,133,44306,93602
15320,2331,52861,63634,1476,76769,83546,855,18258,27757
15317,15790,91586,112749,11121,109355,131673,4669,47746,65020
15316,53,0,46668,45,0,49987,8,0,0
15315,222,48333,49614,176,48958,47923,46,0,48728
15314,1433,53068,61431,920,69728,74420,513,26979,36684
15313,137,58125,81238,104,71250,97282,33,23750,30673
15312,1602,65625,87433,1157,71941,98188,445,43657,54955
15311,542,85655,88706,457,87232,94507,85,41458,53188
15310,111,68750,70124,84,88750,75537,27,58375,47578
15301,20833,61031,78415,12169,79409,97178,8664,39085,49447
15290,0,0,0,0,0,0,0,0,0
15260,0,0,0,0,0,0,0,0,0
15243,5483,93449,120118,3639,116516,147350,1844,44654,65832
15241,7950,119421,154028,6050,143029,181865,1900,42027,63045
15239,8326,81657,93788,6117,93587,106389,2209,43590,54125
15238,5314,102038,170167,3520,150259,212930,1794,45558,82819
15237,17741,87964,110136,11098,122862,138776,6643,50059,61244
15236,12721,69805,85749,8123,91053,102409,4598,41727,55128
15235,14976,56566,74016,9075,67856,84152,5901,39258,55952
15234,6149,66792,81197,3539,79930,94653,2610,46211,58875
15233,1482,49375,65596,435,68403,95050,1047,33083,51544
15232,6496,59139,88550,1765,98313,155976,4731,46321,63105
15229,6108,71971,84902,3873,95648,102159,2235,41950,52896
15228,7115,118371,143418,4832,147083,175287,2283,46550,73418
15227,11965,63415,81358,6979,78888,90320,4986,41945,61298
15226,6404,64181,71810,3219,82832,87163,3185,47856,55066
15225,558,46563,53069,219,64226,66993,339,37862,42648
15224,5871,52356,72419,1991,69529,92469,3880,43393,60812
15223,3289,50528,58658,1666,67838,71726,1623,35717,42038
15222,2865,105054,131559,696,188214,198742,2169,84893,109893
15221,15992,43907,62955,6551,65808,82442,9441,32324,48080
15220,8342,72645,83207,4477,90759,100525,3865,51003,62066
15219,5307,27949,48969,2300,37877,58046,3007,22132,40682
15218,6828,59542,78307,3017,91213,109770,3811,37795,51582
15217,12000,74744,117088,5809,123815,181044,6191,38330,55783
15216,10647,63094,82630,5342,88412,109014,5305,42150,54256
15215,5624,76752,129474,3508,107554,153807,2116,45825,87661
15214,6071,50167,62323,3367,62030,74586,2704,37679,45110
15213,10267,23342,44351,1866,59113,99095,8401,18615,31841
15212,13991,48304,64412,5825,66616,82480,8166,33584,50362
15211,5776,60611,85276,2003,75074,118990,3773,52018,66120
15210,11412,39848,52578,6398,46138,60346,5014,30218,39183
15209,5738,62826,75460,3227,79826,91832,2511,42005,52156
15208,4354,48664,88420,2036,61100,119260,2318,34522,59773
15207,4981,43764,56823,2485,63982,69123,2496,26300,40832
15206,14846,52450,79837,6116,83750,108713,8730,36005,58604
15205,10050,61888,76313,5145,82540,97351,4905,40588,52996
15204,3584,41531,52694,2129,48345,64217,1455,25436,34438
15203,5853,49231,76954,1525,50080,99535,4328,47923,68571
15202,9899,53292,72144,4371,86623,99990,5528,36415,48712
15201,6769,72244,95003,2422,81629,106398,4347,65370,87478
15148,1140,34464,45340,503,49408,63453,637,20037,28906
15147,7980,54842,68980,4164,71092,86319,3816,40064,48632
15146,12122,70700,80367,7843,89315,94337,4279,42153,53449
15145,3186,35250,44617,1815,45276,52767,1371,24790,30711
15144,1877,58965,73670,1175,71715,85362,702,33616,52870
15143,8757,102958,162607,6422,128364,190308,2335,55313,85290
15142,441,"250,000+",280807,340,"250,000+",287377,101,"250,000+",258692
15140,1557,34882,42087,763,40938,50039,794,25192,29958
15139,3244,67944,101574,1554,117500,151661,1690,41287,54903
15137,4726,44774,83056,2777,65592,106593,1949,32101,46884
15136,9832,52168,74047,5586,67458,90403,4246,34666,50059
15135,2110,64231,83372,1360,81000,98865,750,36241,48860
15133,2877,59537,66402,1705,75150,78296,1172,40729,44643
15132,9977,30026,43478,4673,40202,55113,5304,23136,31436
15131,3890,50855,72600,2201,71929,85827,1689,34125,53445
15129,4407,74038,88537,3006,90357,103462,1401,43148,55960
15126,3176,83827,90796,1722,116173,122207,1454,48068,52173
15122,8314,53887,69027,5118,71778,83177,3196,32624,40676
15120,8638,42918,60560,4617,63730,80723,4021,26938,36048
15116,6005,77026,94503,4250,94912,108690,1755,42047,59645
15112,1494,36891,48420,695,60875,62399,799,31269,34178
15110,2246,35264,45096,1277,37486,49958,969,24441,38100
15108,17387,75499,98986,11469,97815,118495,5918,45936,58394
15106,9768,59072,77221,4668,87705,104604,5100,41292,50550
15104,4046,31318,49594,1920,42367,70673,2126,22790,28593
15102,13019,86171,100710,8545,109769,121997,4474,37141,57477
15101,10485,85097,110800,7001,114271,135206,3484,44755,58662
15090,9269,121353,161069,6546,150263,190931,2723,57488,85972
15089,2996,56000,65338,2018,65800,77087,978,26473,40377
15088,174,43750,48916,123,45795,54152,51,30625,30478
15087,38,77500,70268,38,77500,70268,0,0,0
15086,188,0,161712,123,132917,163951,65,0,157475
15085,3284,65918,74545,2355,72173,88250,929,27042,37406
15084,4702,46126,62502,2618,67222,84266,2084,25727,32743
15083,396,47813,76566,211,60139,109174,185,30042,35979
15082,82,0,51545,41,61181,83398,41,0,0
15081,151,66023,72207,91,74821,82551,60,51429,55445
15078,141,65813,70850,125,65813,71046,16,0,0
15077,85,77125,80702,63,83250,85892,22,0,65841
15076,321,65365,63797,202,67083,79504,119,0,30714
15075,20,0,0,10,0,0,10,0,0
15074,3771,44530,58307,2319,54354,73105,1452,25116,30658
15072,8,0,0,0,0,0,8,0,0
15071,4967,83454,103177,3234,108464,124911,1733,47212,60164
15068,16994,52793,67452,10229,73178,85055,6765,28919,37412
15067,1117,46315,58112,742,57794,67806,375,33875,37785
15066,5631,48456,63068,3530,64042,76473,2101,27594,37438
15065,5088,56929,72187,3287,73737,87753,1801,34330,41623
15064,120,67167,92248,59,127639,118266,61,66406,66474
15063,4960,59572,74092,3093,74738,89976,1867,31250,44405
15062,3430,45658,60426,1982,73375,79793,1448,24244,33054
15061,5256,60865,67504,3253,76755,82961,2003,29980,40161
15060,347,54219,67403,246,58654,70911,101,51083,57504
15059,1724,60955,63666,1138,60429,72063,586,28452,35889
15057,6153,84588,105105,4506,111618,123761,1647,39327,51419
15056,566,46346,61425,266,61371,78651,300,37857,45118
15055,562,55156,66214,360,77813,76679,202,40375,42264
15054,132,0,51652,66,31912,45459,66,0,53306
15053,50,37000,37982,41,42679,42573,9,0,0
15052,1254,58676,66664,845,67545,74240,409,37202,46082
15051,229,59946,74020,132,67222,90671,97,41615,51359
15050,1006,70700,83269,829,80871,90788,177,30521,48056
15049,524,47794,56628,244,55192,70732,280,35682,43509
15047,36,0,0,20,0,0,16,0,0
15046,1105,65625,79497,748,86983,94672,357,39963,45175
15045,1853,45716,55292,1130,51196,63351,723,29506,35898
15044,10609,111809,159589,8179,129078,169106,2430,46222,122676
15043,897,75052,84916,678,88846,94683,219,42969,52730
15042,3588,60671,83915,2567,69539,97370,1021,36294,47219
15038,150,78125,83240,133,78656,91020,17,0,0
15037,4382,65261,84280,2887,76871,101258,1495,36422,49194
15035,980,50625,64250,535,77841,84096,445,35486,39526
15034,928,32770,53511,428,53462,83118,500,23985,27847
15033,2207,40437,44552,1410,55690,54714,797,15179,26124
15031,231,58558,63808,75,96133,102165,156,0,43363
15030,551,54464,60354,283,70568,62119,268,34464,54994
15028,68,38750,53479,38,53500,72279,30,0,26553
15027,1169,56927,69677,600,77167,93506,569,26151,41453
15026,1393,82590,98417,789,93456,107868,604,59348,80504
15025,6793,63815,96441,4349,92625,117639,2444,36118,58119
15024,3534,74146,91732,2299,100291,112828,1235,44315,51662
15022,4127,49726,66050,2308,68015,87989,1819,28853,36076
15021,3108,61371,77167,2078,73768,91123,1030,32143,46282
15020,17,0,0,9,0,0,8,0,0
15019,715,46940,64247,426,74821,88379,289,25353,28675
15018,546,35616,54764,293,80724,81120,253,23359,24240
15017,7035,70812,96322,3897,102018,117738,3138,43097,64429
15015,490,121389,144772,367,144028,167742,123,60893,76165
15014,1450,41188,47439,762,51500,54452,688,32750,39205
15012,6883,60864,77628,4130,82273,95558,2753,36250,50194
15010,11363,61560,76001,6927,81256,92840,4436,33210,46599
15009,6509,67303,89137,4145,94509,109807,2364,37585,50855
15007,167,63625,70419,98,66250,57008,69,0,89465
15006,131,106484,105434,106,107135,105645,25,0,0
15005,3948,71393,98170,2692,85577,114409,1256,41213,61954
15004,138,72619,66654,78,74167,73673,60,47700,42763
15003,5104,50317,65734,2725,67188,82908,2379,38076,44178
15001,14093,58250,74914,8920,74552,91489,5173,31032,41894
14905,3686,65662,81371,2348,75125,95198,1338,39333,53944
14904,6478,45912,57285,3660,62376,67845,2818,26922,37537
14903,3122,60631,97886,1834,78295,100625,1288,45492,90247
14901,5384,33783,50383,2852,42771,56577,2532,21904,39604
14898,570,47222,61189,457,50144,62747,113,42917,47414
14897,305,43546,54081,239,43797,56275,66,26833,32956
14895,4285,48778,75033,2411,69366,76102,1874,29784,72178
14894,420,59565,70022,294,67857,72863,126,37143,49546
14893,0,0,0,0,0,0,0,0,0
14892,3193,49899,66660,2183,55423,75229,1010,28716,42643
14891,1964,51563,67425,1041,64375,82120,923,33578,47941
14889,579,58365,68077,389,66193,73047,190,36667,50898
14886,2819,59616,80027,1965,74083,94011,854,38581,46634
14885,269,57721,65288,210,67250,72856,59,45139,38354
14884,128,59375,77570,75,66250,90543,53,54583,59211
14883,1935,58388,74185,1373,66625,85294,562,35368,42416
14882,1555,86165,115349,1134,105571,132931,421,64250,55248
14881,93,83906,120187,51,0,178525,42,0,0
14880,841,48625,53579,557,63698,65320,284,0,25914
14879,956,50463,61260,706,60556,68059,250,31591,39523
14878,198,73750,115358,110,62500,76605,88,76250,158993
14877,207,42750,66279,142,53125,70718,65,37813,55548
14874,113,63021,65398,63,64896,74632,50,44405,53766
14873,850,51613,62258,559,55430,68677,291,33250,47862
14872,229,85114,87319,163,85947,88781,66,40000,83709
14871,1931,66830,84227,1343,82409,93166,588,42300,57784
14870,4164,77171,100974,2838,98155,120196,1326,44715,56174
14869,494,61184,69237,343,71932,77050,151,35875,42425
14867,2480,63083,75738,1605,72446,79790,875,48969,67192
14865,1131,39861,55761,659,71659,71083,472,19619,32457
14864,417,55625,64239,246,75833,76837,171,36991,41081
14861,486,51667,63136,320,56500,66191,166,35000,56757
14860,547,62054,64210,288,62344,76048,259,52750,48615
14859,388,64000,69016,338,54167,71207,50,21023,31566
14858,439,68125,75214,322,76522,84199,117,24671,35349
14856,108,0,24033,16,0,0,92,0,23815
14855,278,41000,54142,212,54286,61225,66,24500,31297
14854,14,0,0,0,0,0,14,0,0
14853,0,0,0,0,0,0,0,0,0
14850,26184,56794,86054,11520,95021,129347,14664,33897,48918
14847,945,58162,67103,552,69583,81395,393,34954,44927
14846,385,56146,61879,232,76667,75994,153,28542,35932
14845,8901,62063,79606,5572,79916,95376,3329,36427,49393
14843,5477,47783,57558,3360,60691,67043,2117,27595,38007
14842,259,57703,60593,227,58634,65365,32,0,26744
14841,295,65598,77758,178,72222,97767,117,0,47316
14840,1312,59028,84188,885,71688,99948,427,32533,49539
14839,346,61522,74778,246,62024,78901,100,51000,60148
14838,751,67188,76522,507,71938,82188,244,38333,57042
14837,2126,56908,72928,1499,66229,83161,627,32560,44841
14836,382,62079,74093,234,88750,89059,148,60658,48470
14830,8640,63710,87243,5190,86376,111959,3450,33674,47122
14827,81,57112,64906,35,0,0,46,56944,55698
14826,886,57738,64978,674,63194,71332,212,36923,40467
14825,326,71716,85944,252,72108,96311,74,35000,45195
14824,254,48500,77719,197,50982,85364,57,40469,46012
14823,1437,53801,74322,970,72574,93441,467,25859,33864
14822,437,56705,69058,295,67596,78249,142,49038,49481
14821,1230,60571,69005,958,76350,77356,272,24808,35364
14820,306,53500,65760,240,62500,73483,66,31500,33802
14819,262,54000,63031,182,63750,58751,80,43750,67641
14818,845,75670,81628,682,78429,83717,163,44663,51197
14817,1009,66799,75516,645,70917,79415,364,45654,49443
14816,200,65625,81442,167,75917,87977,33,0,48370
14815,348,47885,64247,221,67266,80341,127,30583,31769
14814,717,89837,113068,483,103829,138686,234,0,54523
14813,891,53646,64910,520,58750,75201,371,29485,42382
14812,1214,55357,66911,798,67586,69946,416,42500,56949
14810,5328,41759,59696,2889,60481,69804,2439,28948,45822
14809,941,47259,64424,682,50556,67602,259,34044,50085
14808,218,54286,66944,160,75000,76588,58,15833,25690
14807,1226,56951,67423,781,71979,80203,445,37697,41242
14806,855,56094,71860,589,68523,85489,266,35469,40293
14805,426,44231,60557,248,48333,75303,178,37019,38070
14804,668,72000,73970,495,80481,81644,173,42159,47162
14803,339,51250,64832,215,57321,77632,124,36250,41777
14802,359,34107,51707,136,73750,87359,223,17679,29964
14801,1953,54707,63267,1318,61541,72809,635,31472,38948
14788,5,0,0,5,0,0,0,0,0
14787,2344,39451,59212,1075,73536,88149,1269,22052,34221
14784,358,81250,74777,262,88043,84186,96,35781,46428
14783,106,34412,80692,69,65625,64525,37,32596,110841
14782,970,46875,52702,700,60167,63111,270,18068,23512
14781,778,51500,59252,478,70833,75887,300,21000,32385
14779,2783,35853,51482,1649,43040,60566,1134,22428,33255
14778,0,0,0,0,0,0,0,0,0
14777,264,54167,86611,189,53750,69001,75,0,126847
14775,993,48523,70218,665,60195,87740,328,23092,29325
14774,29,0,144772,27,160515,119933,2,0,0
14772,1656,57656,67312,1134,72308,80036,522,31571,36193
14770,1198,51883,65024,852,65417,76775,346,26087,33310
14769,454,52045,58407,295,60096,67524,159,50250,40631
14767,788,57361,72512,597,58274,75166,191,29375,55164
14760,8024,47782,61826,4450,64704,72544,3574,25450,46446
14757,1268,60536,81975,795,75893,85971,473,30268,73721
14756,28,0,0,0,0,0,28,0,0
14755,1225,51412,60783,807,59083,69284,418,33375,40001
14754,245,53438,62149,164,65500,78575,81,21771,26059
14753,545,34464,52343,320,61154,69136,225,20721,26734
14752,158,38000,62696,115,0,62230,43,49125,63944
14750,1993,57841,93427,1232,87174,110141,761,26338,64453
14748,220,27157,64715,155,34583,78965,65,18472,20489
14747,768,54545,78008,539,75417,98764,229,19696,25651
14744,436,69063,70983,334,80897,79447,102,35667,38259
14743,833,39558,53722,659,47031,57383,174,28500,31666
14742,78,63125,69819,32,0,92553,46,59063,54002
14741,741,64327,72750,519,70461,81188,222,34063,48126
14740,440,58947,71294,273,74938,91446,167,26806,35914
14739,1094,42292,50898,662,53056,60596,432,25952,34973
14738,1439,49830,55391,904,51902,60007,535,33984,45516
14737,1732,48316,60268,1150,61979,70605,582,31667,37879
14736,74,53750,79507,61,0,87513,13,42188,41938
14735,1077,47750,56610,807,60673,61843,270,27375,38704
14733,1465,49153,57329,931,57760,65140,534,33587,38377
14732,87,54327,52593,70,60156,59129,17,31406,25682
14731,569,62813,79089,401,73828,89598,168,31964,53136
14729,443,65156,70740,262,71346,75424,181,55893,59233
14728,501,56490,67416,298,67988,79296,203,51063,46399
14727,2306,53264,67092,1495,73487,80787,811,26953,38183
14726,560,44464,54697,445,53819,58424,115,32708,37895
14724,844,58594,72014,673,68958,78188,171,33854,44076
14723,441,65096,72145,309,82417,81966,132,35417,47205
14722,49,0,0,0,0,0,49,0,0
14721,84,0,37231,66,24125,37005,18,0,36533
14720,318,43929,46578,184,60511,58601,134,20000,29074
14719,1429,51511,61862,881,61741,73264,548,25556,40757
14718,733,53885,63986,484,69773,76475,249,29219,35316
14717,241,38750,49157,114,48929,59877,127,24107,36702
14716,825,37250,47998,476,47083,60112,349,21767,27381
14715,1121,41996,52142,710,48462,57816,411,27188,36071
14714,252,80313,80541,198,85938,86227,54,41111,46502
14712,1452,63567,92480,901,89821,110568,551,43200,58641
14711,678,57800,64892,500,69167,74077,178,32500,36943
14710,1312,58537,77211,939,70156,86556,373,39583,50300
14709,587,50515,73635,414,56250,84933,173,41771,42157
14708,74,76875,71551,67,77109,73321,7,0,50971
14707,47,47321,63868,15,46964,49360,32,0,70669
14706,2649,60118,75185,1737,79652,92944,912,28102,37540
14701,17234,42558,54389,9605,56250,65185,7629,24642,37622
14627,0,0,0,0,0,0,0,0,0
14626,12894,72662,82050,7735,85971,99341,5159,43331,52581
14625,4440,86463,101222,2799,108906,125281,1641,48315,57336
14624,14914,75932,87191,10487,90145,97269,4427,48663,59095
14623,8044,54245,62978,4073,70498,79494,3971,33069,44081
14622,5836,57351,76660,3411,76607,91658,2425,35642,54744
14621,12939,27582,41040,7037,32094,47647,5902,21172,29251
14620,11514,51127,68378,3853,76437,92705,7661,40440,55730
14619,5471,47657,65580,3297,53890,73572,2174,40227,46600
14618,8185,105750,156076,5790,125833,185124,2395,53657,81042
14617,9413,69981,89065,6030,92500,110862,3383,36430,46016
14616,11492,53697,66028,6665,60843,75515,4827,36773,49388
14615,7280,44678,59569,3791,55261,69574,3489,36261,46614
14614,59,0,41380,16,0,0,43,0,0
14613,5449,31977,43124,3543,35393,44818,1906,24362,35342
14612,15066,63901,83517,9492,82976,96173,5574,33842,56830
14611,6547,26417,40014,3810,33404,46726,2737,20143,27654
14610,6956,63981,106962,2928,119500,165737,4028,46362,63399
14609,17346,49478,63098,9957,59941,70604,7389,35616,50152
14608,5431,28599,44502,2151,37071,51948,3280,25625,39002
14607,10201,48270,66633,2032,87500,108164,8169,41945,55874
14606,11044,48812,60933,7273,58545,67912,3771,30827,41765
14605,4095,23196,44375,2245,32044,52725,1850,13733,32106
14604,1764,67800,78004,425,74278,92946,1339,55576,73261
14592,26,0,85277,26,0,85277,0,0,0
14591,676,66875,85563,487,57344,82515,189,49583,84283
14590,2424,51531,62874,1517,60393,73839,907,29076,40955
14589,3082,71852,93725,2151,91283,109581,931,30154,48256
14588,75,0,77299,52,115400,97777,23,0,0
14586,4349,96053,96021,3138,108222,107332,1211,43381,64391
14585,28,47000,45371,13,51250,51815,15,33750,34220
14580,22569,80495,100710,14640,103482,122714,7929,44152,56688
14572,2012,52675,65319,1406,62885,74256,606,24432,36551
14571,531,60417,75460,353,64028,85270,178,36667,54283
14569,2710,58523,72615,1631,68878,84863,1079,38979,51769
14568,2403,86098,94947,1906,90851,104138,497,38403,56627
14564,6074,94393,123218,4346,122360,145198,1728,49426,60283
14561,1091,70436,75646,871,73021,78506,220,36983,56957
14560,991,61276,69603,672,65081,78378,319,47610,48522
14559,7250,77280,96498,5322,96875,110709,1928,33929,49120
14555,618,54821,67132,313,62875,75246,305,52589,57814
14551,2341,51449,68505,1325,67007,84473,1016,30428,43543
14550,564,50081,54913,341,63625,69255,223,23705,30251
14549,47,53150,51536,17,0,60647,30,0,0
14548,1667,66647,81840,1163,79851,91414,504,47833,49944
14546,1955,70258,78847,1209,86005,88556,746,56201,57990
14545,86,93676,85708,70,93333,88260,16,51667,53100
14544,858,54138,63394,585,58060,70776,273,48472,47146
14543,1277,100017,100292,911,106902,108333,366,68000,74157
14542,46,60714,54924,31,62054,69884,15,0,0
14541,960,67935,83283,728,70435,88806,232,45000,57061
14539,35,0,66923,9,0,0,26,0,51696
14537,60,36316,47023,50,0,48098,10,0,0
14536,297,44653,52411,162,67000,70512,135,16797,29120
14534,11972,119961,164690,9302,139322,189296,2670,51830,76315
14533,933,57009,71329,612,78060,84154,321,32277,41008
14532,1638,60000,69161,1082,78333,79941,556,33750,44568
14530,2099,53155,60068,1407,60250,66569,692,28684,42953
14529,6,0,0,6,0,0,0,0,0
14527,4809,52961,72110,2968,78118,90519,1841,30817,39715
14526,7924,83050,102591,5183,113232,124406,2741,42246,57932
14525,1038,70938,78099,713,82083,86548,325,48170,53133
14522,4162,62628,85635,2808,80525,98530,1354,32869,52060
14521,1085,49464,72446,665,68073,90651,420,30917,42079
14519,4957,76778,94231,3245,86013,111953,1712,49207,56602
14517,1215,55380,61256,750,67938,69167,465,37375,45751
14516,888,64470,73524,641,71141,84610,247,32188,41131
14514,2627,71795,87825,1774,86071,105428,853,48598,49534
14513,5611,51450,67288,3424,63663,77394,2187,29745,46270
14512,1833,58169,76388,1262,68780,89758,571,34476,40835
14511,156,56333,52342,71,80446,76027,85,33438,32559
14510,1992,51897,63764,1066,66554,71468,926,33578,52494
14507,358,59722,76114,258,74643,84184,100,30417,48414
14506,432,0,115778,252,149792,168285,180,0,42268
14505,2132,64538,71796,1406,70441,82883,726,41649,47668
14504,692,53229,61457,404,57500,69206,288,41250,44890
14502,4333,76808,84795,3154,89590,99003,1179,30958,42768
14489,2600,53625,63932,1725,71068,75478,875,32061,36957
14487,2320,73780,84334,1708,87635,91710,612,47333,57000
14486,158,69911,104767,119,77917,116965,39,61750,63249
14485,1551,58932,77069,919,84728,100234,632,34722,42988
14482,3562,61136,73223,2096,77148,95685,1466,35464,39576
14481,773,67583,77308,544,74615,85915,229,34583,41637
14480,384,75921,76567,323,67961,74777,61,0,0
14479,70,67708,57729,46,0,51724,24,0,0
14478,307,90912,112314,239,91958,92706,68,69265,181231
14477,609,70417,87354,505,78155,90099,104,57833,63617
14476,941,69943,86177,770,76875,93053,171,0,44052
14475,135,92708,108052,99,106417,125844,36,0,30817
14472,3416,109841,131400,2593,125456,151338,823,50817,65452
14471,1045,63068,71142,685,74861,83859,360,50511,45501
14470,3159,58132,77176,2210,67222,88730,949,36734,45045
14469,2489,59698,76264,1733,76233,89402,756,40595,42956
14468,6753,78829,87505,4877,90145,98505,1876,41218,54854
14467,3959,74253,80870,2732,84702,92942,1227,38683,50075
14466,643,79410,77912,471,82520,84448,172,0,58529
14464,2866,59756,77390,2057,74477,91113,809,35440,37625
14462,228,73704,77438,194,74907,81808,34,46071,47003
14456,8127,55617,70955,4486,67379,89056,3641,36695,45710
14454,3309,47351,75343,1802,87297,109142,1507,21845,32913
14450,17801,91747,109344,12170,109060,127402,5631,47631,68445
14445,3426,57826,69192,1665,69880,80629,1761,43619,57057
14441,101,43750,48619,74,45000,50247,27,33250,33041
14437,4266,55271,68855,2631,69753,84602,1635,29848,38721
14435,1091,68188,118128,666,87885,108180,425,41518,132329
14433,1516,50296,58976,996,61313,72785,520,21771,27300
14432,1961,67156,80407,1258,76569,89170,703,31414,58820
14428,2858,78796,92739,1993,89861,107201,865,53036,54558
14427,865,57695,60680,565,68977,69322,300,28500,41360
14425,4898,66445,88231,3159,72269,102150,1739,45019,51038
14424,12424,66487,94236,7321,96365,122253,5103,34416,50683
14423,1870,58559,72574,1208,77917,86882,662,34110,41202
14422,850,67892,74916,550,78426,89368,300,41875,44742
14420,7457,56849,72724,4489,73560,89762,2968,31142,43123
14418,423,38969,58980,273,0,62967,150,38625,51724
14416,1397,72067,81253,1039,80938,94594,358,39375,40147
14415,61,0,47452,32,76250,66828,29,0,26076
14414,3037,60341,84827,1921,87358,99218,1116,41818,57012
14411,5244,45423,59502,2812,62533,74938,2432,33341,38264
14305,7420,39107,58382,4388,52330,71687,3032,22732,36508
14304,12858,56780,70162,7729,70551,83942,5129,38430,46182
14303,2645,35254,54476,1229,35536,51540,1416,32197,55422
14302,148,25000,3208,0,0,0,148,25000,3208
14301,5735,31244,44781,2714,42976,53461,3021,22986,34418
14261,6,0,0,0,0,0,6,0,0
14228,9738,57386,77708,5360,85795,103152,4378,32711,44531
14227,9767,56206,66219,5451,80142,83662,4316,36068,43097
14226,12728,71218,100785,7848,91330,125556,4880,35115,58961
14225,15675,53307,64368,8335,62410,74928,7340,40398,49361
14224,18064,68292,80279,10870,86556,98136,7194,42446,50599
14223,9981,69023,82875,5961,85567,101926,4020,39097,52390
14222,6649,70215,98445,2093,126637,151769,4556,54882,71263
14221,23397,84676,113912,14251,116053,148999,9146,42064,57085
14220,9451,61186,69065,5732,73290,79222,3719,42159,49489
14219,5553,55585,65591,3238,68504,76817,2315,37382,47010
14218,7880,41325,54700,4183,50522,65710,3697,28781,38814
14217,11033,59133,73654,5651,81935,96456,5382,38502,48296
14216,10561,58210,81205,4818,87590,111015,5743,39844,52934
14215,16795,37436,50766,9937,51971,60987,6858,24764,32011
14214,7701,51914,69483,3784,71983,88423,3917,34013,48895
14213,8851,42050,58248,4356,40078,61671,4495,36887,51470
14212,4650,24756,41972,2491,30245,49433,2159,19019,28666
14211,9187,27429,43863,5170,32500,50155,4017,20446,31436
14210,6465,43317,52233,3403,58981,66856,3062,25813,31982
14209,3664,41062,55621,1357,44522,69821,2307,38320,47007
14208,4200,33140,45159,1945,42449,54911,2255,22174,35810
14207,9386,30187,48110,5485,33740,50098,3901,20492,41248
14206,8985,40005,53769,4980,53029,64166,4005,28963,38327
14204,4287,22989,39337,1711,36678,54392,2576,16391,29011
14203,1275,39236,52882,221,46964,85042,1054,24551,44498
14202,2034,49776,88073,625,65089,116727,1409,48451,75287
14201,5414,29814,48266,2088,31958,61737,3326,26549,37998
14174,2358,77348,97798,1695,99886,112329,663,36734,59337
14173,71,88125,73589,21,0,0,50,0,60446
14172,1266,52857,75064,832,72857,89742,434,32750,45134
14171,852,63409,68396,568,67625,76798,284,39444,45783
14170,910,80617,112420,675,97522,130320,235,59297,58815
14169,82,50938,41733,7,0,0,75,51120,42521
14168,5,0,0,5,0,0,0,0,0
14167,654,59958,76875,496,66000,79671,158,52794,55492
14150,18904,58954,70564,10700,77380,88140,8204,37007,46165
14145,592,74028,87833,438,83472,97617,154,46786,52353
14143,442,67500,75734,329,74904,86543,113,32277,44262
14141,3182,58042,77542,1951,78950,95162,1231,35412,46126
14139,790,76842,88185,531,81409,101660,259,55720,54229
14138,718,46720,70584,495,53021,84327,223,26637,36006
14136,2035,60673,71658,1301,77188,87509,734,27428,39767
14135,30,0,156003,26,0,172077,4,0,0
14134,51,49896,76229,41,0,87146,10,0,0
14132,2390,78558,82549,1573,96126,98308,817,37750,47656
14131,2059,72896,93746,1575,88601,106030,484,49211,50287
14130,80,57778,55406,67,58750,56822,13,0,0
14129,549,65417,72423,410,69444,82811,139,31719,39745
14127,12518,89049,116534,8487,119211,146045,4031,41763,52353
14126,247,0,89591,125,86420,88709,122,63077,73484
14125,1353,54080,70421,935,63828,76611,418,29593,48875
14120,18972,69119,81336,11985,85826,98249,6987,34506,48458
14113,251,54602,67365,144,78750,83117,107,36750,43081
14112,50,0,0,33,0,0,17,0,0
14111,1229,61908,72812,813,79250,89327,416,36471,36865
14109,0,0,0,0,0,0,0,0,0
14108,2062,57908,77754,1473,77560,92197,589,31540,40744
14105,1849,65139,74388,1403,79740,83830,446,32000,37974
14103,4593,52768,66313,3209,67375,76199,1384,34236,40261
14102,505,117686,120443,403,114148,122846,102,118085,100197
14101,707,53750,64053,522,60607,70289,185,27007,41690
14098,1173,56549,71373,894,57273,74386,279,28875,37940
14094,20909,60823,76262,12597,78621,93344,8312,38624,46865
14092,4961,57679,76580,2932,90495,101074,2029,32201,40592
14091,547,55724,91251,368,43409,61258,179,0,146983
14086,13874,82093,103198,9031,98390,124127,4843,48855,59342
14085,2818,97181,103632,2079,114363,117330,739,44313,64747
14082,184,62222,91032,118,75625,96441,66,0,81362
14081,1232,42625,58288,694,45000,64725,538,36765,46705
14080,1855,59698,87763,1163,86891,117280,692,26932,36883
14075,18976,69974,89792,11632,95019,114354,7344,37317,48311
14072,8797,90386,103643,6019,106258,121280,2778,51188,61528
14070,2126,47571,63220,1238,61339,76125,888,27763,38053
14069,255,71250,75885,210,80081,79829,45,0,54947
14068,2627,100029,135435,1731,132725,170435,896,51500,66268
14067,1937,80405,83294,1404,87115,86931,533,42074,64393
14066,506,56250,62741,325,64306,72288,181,31750,41823
14065,640,59432,63232,448,61453,67437,192,43375,45076
14063,5091,60011,76064,3172,84113,91843,1919,31488,47998
14062,1375,55446,66296,958,64634,74501,417,31382,44417
14061,122,45000,64561,98,46875,69520,24,30833,37413
14060,239,37021,57031,150,37325,62085,89,0,45210
14059,4177,69747,116964,2893,94653,144485,1284,50317,52977
14058,747,70625,80435,578,86607,90580,169,34063,41141
14057,3365,76813,93707,2206,95156,112066,1159,43972,52976
14055,651,50417,72454,329,72426,100400,322,29611,41075
14054,590,59375,70911,444,62292,78765,146,39167,40638
14052,7294,85976,105868,5106,106692,123240,2188,44486,63763
14051,7569,112580,133679,5417,140625,158279,2152,39109,68994
14048,6479,38604,54626,3871,53944,64070,2608,24951,35579
14047,2598,64444,80691,1858,76909,91941,740,26528,43077
14043,10988,63377,75773,6462,71071,85219,4526,46680,58221
14042,1798,49295,60017,1256,54167,64831,542,28750,39198
14041,73,0,72314,31,0,105797,42,0,45162
14040,733,66563,82613,495,73306,101191,238,32857,38939
14039,31,0,47271,18,68333,68094,13,17083,18431
14037,315,59650,76405,280,61250,76333,35,52625,53757
14036,2299,79157,89396,1577,92839,102984,722,39462,58714
14035,35,75813,75243,28,76250,82286,7,0,0
14034,591,64297,70973,405,78125,83725,186,26667,40667
14033,633,67438,83696,460,66375,88385,173,64632,67104
14032,3631,126798,168114,2931,132336,172164,700,93750,150103
14031,4144,85655,120245,2583,115135,152862,1561,47917,60963
14030,692,76452,83272,456,81042,92843,236,47321,54398
14028,621,60030,80354,421,78365,89727,200,0,60625
14026,323,58661,67380,140,96500,104198,183,29653,39214
14025,1664,76220,90273,1215,82607,102586,449,40231,55270
14024,562,63125,77561,386,72400,81109,176,40962,65832
14020,9811,53634,66856,5342,70714,82292,4469,32305,45451
14013,653,58393,62747,417,70268,74363,236,25938,36899
14012,923,59109,72058,685,59930,79034,238,35000,46456
14011,2832,67877,83889,1880,84894,99299,952,40446,51824
14009,2602,53348,75137,1601,78861,98720,1001,29309,34822
14008,596,61389,80683,442,97083,94896,154,26543,39010
14006,4155,56017,70093,2647,68486,78306,1508,38173,51612
14005,841,81319,97857,622,88308,112666,219,47188,50415
14004,4118,73431,79128,3049,85464,88886,1069,41641,46879
14001,4024,64586,83663,2595,76017,96932,1429,33634,57419
13905,11154,44466,65292,5063,67285,83748,6091,27089,48193
13904,3782,51404,62620,2469,53807,72009,1313,31051,41022
13903,7878,51152,71190,4815,68617,84295,3063,35908,47574
13902,0,0,0,0,0,0,0,0,0
13901,7958,46269,70471,4451,67573,84909,3507,22938,47861
13865,2791,54673,63653,1816,79402,77983,975,21799,36319
13864,646,42380,58492,328,55900,67645,318,40960,49051
13863,237,43250,60354,158,53750,65366,79,34659,49124
13862,1667,50938,66933,1099,57039,75019,568,35608,46488
13861,257,47277,64138,106,57500,87595,151,46405,47672
13860,5,0,0,5,0,0,0,0,0
13859,57,85156,91532,39,97841,111787,18,0,0
13856,2687,42386,53713,1696,51420,63505,991,21743,32003
13850,9372,64036,98944,5728,90182,122652,3644,32256,57697
13849,1976,46944,57852,1125,58772,70545,851,33438,38024
13847,17,0,87065,10,0,0,7,0,0
13846,226,27188,44718,147,52708,48080,79,23320,38461
13845,71,0,0,71,0,0,0,0,0
13844,250,55000,65088,196,55500,63629,54,21000,31531
13843,856,56157,63536,641,62102,71607,215,28393,32799
13842,205,60729,86319,140,79423,105976,65,0,43978
13841,231,43527,68385,171,43990,73425,60,28333,48980
13839,505,56467,61680,384,46429,60046,121,49306,50455
13838,1525,44375,55239,964,63276,65498,561,29375,33405
13835,543,57946,64211,370,70000,77279,173,21534,32794
13834,92,73889,51296,42,0,0,50,0,28610
13833,1349,44922,62002,979,53083,68312,370,31970,38716
13832,219,49107,61217,159,58750,70256,60,23125,33913
13830,2235,50647,63421,1416,70479,74199,819,24821,40089
13827,5227,58773,73754,3088,75393,88009,2139,31573,51212
13826,0,0,0,0,0,0,0,0,0
13825,1280,54464,65548,862,69044,78871,418,28617,34816
13820,8082,54008,66426,4471,68564,81861,3611,36747,44720
13815,5874,46991,68455,3202,68750,85961,2672,26175,40637
13813,363,70791,68925,302,71020,72549,61,0,50985
13812,963,63984,79534,669,76023,95218,294,42500,41424
13811,1571,69688,82126,1170,87589,95280,401,33281,41861
13810,588,80500,96834,422,88878,102916,166,48500,76019
13809,734,48200,60311,432,59813,76777,302,35833,34788
13808,551,57039,104927,400,69167,109739,151,31042,88817
13807,545,64180,83247,379,85469,101032,166,18333,40042
13806,103,0,63369,65,0,77815,38,14444,24047
13804,126,59318,57029,68,57727,56397,58,60139,53716
13803,1425,61639,69647,1117,66198,75336,308,37500,43544
13802,491,0,52301,139,66838,82785,352,0,39926
13801,655,55820,72689,480,69286,84225,175,38750,38811
13797,889,61771,72697,681,63438,73758,208,0,60454
13796,502,47384,67762,316,67857,87420,186,30000,33673
13795,1418,47460,69117,719,76023,83080,699,41628,53384
13794,19,34688,36442,19,26750,31226,0,0,0
13790,7793,47184,62607,4186,62841,80737,3607,25572,38499
13788,381,61250,80116,246,81250,91914,135,41719,44879
13787,1321,52421,61615,814,70500,76919,507,26625,31878
13786,235,40485,49553,136,42202,69572,99,13850,21220
13784,84,61802,63517,79,61948,65558,5,0,0
13783,1203,41932,57749,679,62578,76920,524,21277,31497
13782,315,59063,76192,193,85625,95902,122,40000,43245
13780,291,64271,64846,162,76250,81009,129,40302,40396
13778,2337,59054,68260,1523,76806,81461,814,29120,39464
13777,167,58854,81565,143,58646,81004,24,0,84904
13776,236,62250,68818,142,78750,85330,94,26250,36639
13775,778,57941,74695,553,70804,84498,225,37039,47760
13774,96,57600,46552,86,57850,46553,10,0,0
13760,18825,56814,74015,11318,73876,91725,7507,34543,44840
13757,581,63173,68178,339,73831,77496,242,47083,51617
13756,248,61667,66399,144,0,84890,104,0,40796
13755,413,62530,69915,302,64940,79835,111,0,38077
13754,1254,42000,57105,812,54688,69891,442,22885,31574
13753,1729,56858,71980,976,79091,89724,753,28491,43558
13752,321,54844,77542,176,78333,92490,145,41777,51357
13751,76,44655,48057,63,57981,57016,13,0,0
13750,359,44375,73056,237,66993,91339,122,0,30678
13748,1607,54117,67920,1062,66528,82353,545,30820,37589
13746,736,52727,72357,540,76750,87003,196,32619,31980
13744,458,63333,72178,349,61607,76721,109,50750,53608
13743,1527,64767,80483,1068,82365,89574,459,34901,51984
13740,237,61250,103977,142,107500,142018,95,37083,45112
13739,374,56250,71319,202,68750,94139,172,40769,43500
13736,834,58804,77807,606,64554,89224,228,33194,36505
13734,741,57180,60438,532,69030,68630,209,32868,37373
13733,2501,49320,56999,1352,59231,69185,1149,35410,39548
13732,3156,79955,93533,2284,99028,108050,872,35486,50673
13731,482,65500,75956,296,93250,90624,186,33864,46181
13730,1260,59495,73013,714,65117,68949,546,54737,66719
13697,753,43837,62659,528,39800,65716,225,44115,48556
13696,35,0,0,19,0,0,16,0,0
13695,40,0,77913,40,0,77913,0,0,0
13694,594,56563,75998,378,91250,93846,216,21304,36406
13693,182,47794,52637,151,55125,58342,31,15096,16632
13692,63,0,223530,49,0,281312,14,26250,21293
13691,1243,57772,68285,758,67095,75487,485,46688,53824
13690,284,43194,55373,167,49141,66579,117,29583,36734
13687,219,50703,66154,150,65441,66523,69,43625,56167
13685,1083,77589,84722,583,88838,90964,500,66429,76154
13684,400,48000,55445,248,53333,60563,152,28636,33218
13682,272,80833,87515,214,76250,82150,58,76667,87781
13681,412,49479,61516,310,49643,55978,102,19868,60134
13680,505,55250,72746,372,66953,85194,133,33640,35676
13679,597,64727,80602,470,67685,85902,127,44306,58546
13678,216,42593,58812,54,0,0,162,28375,55506
13677,1,0,0,1,0,0,0,0,0
13676,5419,48834,69609,2812,83977,96562,2607,23415,38692
13675,57,0,84161,57,0,84161,0,0,0
13674,72,44451,50151,31,51369,56661,41,0,0
13673,896,52267,72684,621,57212,78712,275,38958,52211
13672,180,61212,72237,123,62303,75328,57,51875,48949
13670,198,40000,50018,161,41838,53796,37,19792,25730
13669,5962,53915,65992,3855,64578,76645,2107,25886,39328
13668,1419,84107,87061,983,95408,100374,436,41786,50012
13667,1153,41806,54459,764,39831,56005,389,35898,47064
13666,80,45500,53530,67,47083,52355,13,0,20531
13665,281,55408,59112,180,57011,72491,101,19549,27152
13664,143,73472,77589,95,84125,89293,48,41667,51181
13662,7394,52365,67199,3960,65917,83237,3434,31786,45323
13661,547,73155,83775,430,73824,88860,117,49556,53528
13660,587,59375,70119,424,75294,76806,163,29375,40221
13659,150,57000,60913,113,61250,67268,37,38750,40978
13658,878,65103,75497,642,65789,83333,236,34750,51944
13656,942,50667,69557,640,56818,71061,302,33864,62976
13655,1292,41941,60083,799,57288,75201,493,0,35581
13654,839,49338,66179,569,58347,75612,270,32500,40514
13652,594,54815,74558,410,62500,78331,184,40294,59172
13651,63,86250,103590,41,111023,112954,22,57500,86141
13650,632,70556,78748,470,74500,83134,162,42500,60361
13648,860,51300,63032,567,55868,70452,293,35625,43595
13647,54,0,47187,27,0,0,27,0,0
13646,775,53110,67473,470,56364,78020,305,32446,45278
13643,8,0,0,8,0,0,0,0,0
13642,4039,40813,57099,2401,51626,69451,1638,27364,35891
13641,20,63000,47585,20,63000,47585,0,0,0
13640,143,55208,78128,89,65893,94648,54,42222,50900
13639,92,0,52620,54,0,52415,38,38750,52911
13638,163,39564,45739,105,41083,45468,58,0,0
13637,1541,56323,70777,989,55433,67422,552,56164,72563
13636,71,50625,67438,57,53750,69235,14,0,57579
13635,428,55167,63073,292,57308,66489,136,32396,45986
13634,1459,66681,82816,1158,85795,90782,301,40197,49762
13633,106,41250,58102,74,77500,73742,32,0,21931
13630,534,29934,55705,373,39760,65126,161,21250,26485
13628,89,53750,64109,53,76094,76425,36,45278,45978
13626,868,61797,74687,611,66063,72566,257,46875,76011
13625,636,58214,68243,467,70302,76265,169,26250,41350
13624,2009,71932,79686,1345,79420,92712,664,26103,49570
13623,9,0,50089,6,0,0,3,0,0
13622,795,66382,79991,564,80833,92798,231,39958,44236
13621,200,65909,66056,114,66591,70906,86,0,52210
13620,849,50344,62142,596,55648,72635,253,20313,34558
13619,4219,54627,65771,2788,67446,75410,1431,30739,41159
13618,697,59922,70412,433,76116,84997,264,40227,44637
13617,3908,67278,77640,2318,90819,100865,1590,34000,43278
13616,844,45625,67371,535,52713,70739,309,37417,47747
13615,387,85781,85628,284,89412,96708,103,46083,54466
13614,135,30757,50931,95,0,55755,40,25500,19270
13613,1057,45688,62575,694,52569,72596,363,37979,40468
13612,978,65833,75053,674,68429,81620,304,33333,59137
13608,639,55417,64766,487,67697,73280,152,33125,32675
13607,798,50583,153756,392,87000,271503,406,27813,39508
13606,1026,63565,67790,707,83451,83983,319,0,25191
13605,2003,56550,67722,1345,77958,79740,658,33203,39500
13603,3297,50653,56831,2739,53856,60183,558,34342,40221
13602,136,0,59761,136,0,59761,0,0,0
13601,15206,49569,66134,9047,62819,80579,6159,30482,40964
13502,12745,48411,66207,7547,61931,74518,5198,34258,50612
13501,13583,44426,62863,8466,52849,72504,5117,28040,42384
13495,800,51895,59160,505,58170,62812,295,42321,42499
13494,110,63571,73191,70,87000,88219,40,30833,35490
13493,815,54107,61200,585,68516,71180,230,29583,31617
13492,4787,72256,86763,3176,81213,98210,1611,38234,58719
13491,1248,54773,73412,840,69625,85858,408,28519,45701
13490,541,74982,88061,432,75833,87361,109,57083,66972
13489,229,54625,61900,164,66250,69659,65,30417,41046
13488,29,78281,89434,25,51875,81388,4,0,0
13486,340,70417,80984,217,86750,96773,123,27639,53130
13485,456,57083,62824,327,58964,70823,129,32083,38327
13484,45,0,0,26,0,0,19,0,0
13483,97,82902,74551,87,83080,73921,10,0,0
13480,1385,56616,70802,910,74722,86003,475,30188,40664
13478,1310,64587,78604,1021,81114,89345,289,24095,33203
13477,475,61250,126963,312,104565,169259,163,41343,43548
13476,1398,62326,76979,916,91838,97933,482,22500,36313
13475,4,0,0,4,0,0,0,0,0
13473,383,75386,82458,320,53750,80900,63,46875,55537
13472,40,0,0,40,0,0,0,0,0
13471,1321,53327,63295,986,53696,65144,335,38856,46535
13470,285,48750,64627,165,54792,76399,120,35625,48090
13469,471,90917,113073,357,108150,132542,114,0,48400
13468,178,54167,66962,122,76667,81253,56,28750,35829
13464,573,47514,63143,388,48380,62314,185,27969,60216
13461,1307,66466,79984,849,88281,99837,458,29342,37496
13460,1648,50722,69518,1224,55000,77833,424,28235,37191
13459,929,58438,75047,646,66364,82841,283,30341,44913
13456,1574,77946,97438,1097,95905,111778,477,52848,60834
13454,353,83625,70899,256,100376,85467,97,24063,32452
13452,1819,50524,62559,1193,63906,71600,626,30203,41734
13450,43,54750,76930,25,122813,94356,18,53833,52728
13441,118,47619,53321,39,0,0,79,37351,39947
13440,16866,56796,68995,10126,74119,83462,6740,33977,42402
13439,1456,49375,63575,1033,57356,69872,423,28281,39578
13438,1269,59358,76271,881,67891,86143,388,38654,44116
13437,121,61875,62949,96,65625,66183,25,47917,45620
13436,29,42813,61483,11,84375,83018,18,22500,48322
13435,92,70750,78275,82,71125,80248,10,47500,52340
13433,637,42083,53801,401,39196,56517,236,28906,44312
13431,732,76818,95366,517,97679,99828,215,51438,80633
13428,726,53851,63274,443,69663,79749,283,19321,28465
13425,859,53674,77752,523,73795,106624,336,21235,29036
13424,863,59358,79640,521,86016,106520,342,29167,37524
13421,5550,53918,69639,3017,71250,87180,2533,35829,46087
13420,522,90179,82955,364,93275,99402,158,36923,43180
13418,87,0,75786,77,58958,68758,10,0,0
13417,1565,41549,54739,764,70192,75932,801,27886,31527
13416,819,60375,69853,585,76490,82817,234,30714,34355
13415,10,91667,133150,10,91667,133150,0,0,0
13413,6565,74975,107338,4034,101932,132679,2531,43931,65298
13411,1251,54414,67787,825,66528,70824,426,38750,57577
13410,160,0,44876,84,58167,74151,76,25000,10500
13409,778,58500,63823,567,64010,72315,211,26875,36230
13408,870,50250,64939,516,75938,77997,354,33750,41661
13407,1946,59722,65768,1240,72193,80409,706,31912,37285
13406,295,49028,60367,163,81023,80347,132,17033,32998
13404,63,0,37594,26,43125,42850,37,20804,30930
13403,1874,91457,99235,1262,103674,115842,612,50756,63983
13402,693,62135,72493,380,78036,78572,313,54716,64163
13368,466,49268,58624,331,49792,64745,135,29886,43176
13367,3491,56929,72978,2408,72500,81863,1083,37096,49025
13365,3155,54682,77232,2082,72797,91949,1073,30784,44746
13364,120,68167,69785,91,68972,81549,29,30804,32869
13363,915,67216,89081,701,78597,103677,214,32273,37304
13362,44,0,75639,25,0,108140,19,0,0
13361,233,57083,67588,174,72500,78367,59,32188,35800
13360,36,0,90994,25,0,120296,11,0,24400
13357,4469,59894,67680,2770,74821,79455,1699,30175,43443
13355,440,62381,146163,342,61429,160937,98,0,84028
13354,1441,76607,85745,1058,88162,94807,383,48385,59707
13353,11,0,61727,7,90938,78514,4,0,0
13352,10,0,0,0,0,0,10,0,0
13350,4403,55018,67221,2250,87929,88836,2153,32261,43874
13348,541,66589,83860,407,73646,95183,134,36111,48186
13346,1951,49814,75071,1056,87941,101292,895,34738,43739
13345,68,49500,71909,45,98036,93896,23,20938,28891
13343,662,60636,75624,465,66250,78064,197,43646,66934
13342,94,71250,73139,67,71875,74518,27,0,69715
13341,75,0,78141,44,119063,124780,31,0,0
13340,3156,63800,80653,2122,76056,92180,1034,34625,51452
13339,2213,49283,63166,1475,58634,71655,738,29710,39790
13338,579,56339,69660,314,82500,83035,265,29688,47550
13337,339,53125,97115,142,104107,159008,197,37316,49709
13335,515,53250,63466,349,59306,67935,166,45197,50442
13334,423,60368,59824,305,61964,68521,118,19545,31119
13333,22,0,37223,10,76250,66920,12,0,0
13332,1023,54830,72338,722,61071,79228,301,31779,50520
13331,33,0,161885,29,0,176641,4,0,0
13329,1674,45741,56585,1058,60673,67871,616,26418,31460
13328,662,93200,97127,498,104167,102810,164,38750,79868
13327,671,58220,66230,482,62500,73221,189,0,46099
13326,2237,66385,96077,1377,87250,117164,860,41912,61990
13325,365,49464,62299,259,54732,68385,106,27292,36529
13324,877,59732,70395,617,71477,77178,260,31250,48740
13323,4353,80827,93507,2641,108171,117595,1712,37741,50946
13322,390,70000,79958,269,79095,90424,121,56250,53844
13321,401,50617,49830,71,51573,56099,330,49286,48275
13320,766,61288,72630,581,71964,78796,185,38083,45505
13319,417,43750,50861,252,63553,59851,165,0,30390
13318,507,71125,80415,415,74044,83253,92,51667,57161
13317,1430,46346,64977,855,65521,81313,575,33565,37222
13316,2817,51918,63922,1631,69735,82390,1186,26080,33804
13315,576,63854,73445,410,79300,83380,166,47813,46904
13314,103,60417,78223,68,77917,96443,35,30417,42826
13313,181,46438,61472,148,46786,63164,33,45625,46155
13312,167,70750,72449,106,86538,93126,61,35536,36516
13310,326,52273,65534,188,69167,85316,138,36500,38585
13309,2435,60268,72247,1435,73397,90941,1000,32143,40986
13308,1372,67156,81847,1168,72703,84477,204,21934,33915
13305,108,38971,53499,72,48417,64882,36,0,0
13304,744,78382,92341,559,92917,105571,185,34327,52195
13303,574,73679,82112,404,71250,81479,170,74009,82200
13302,576,49205,58563,362,60625,67286,214,34444,38133
13301,63,103365,101424,63,103365,101424,0,0,0
13290,0,0,0,0,0,0,0,0,0
13224,3721,66463,88779,2293,96518,102213,1428,43352,59585
13219,6036,71126,85477,3829,89750,101587,2207,47101,53061
13215,5504,88294,108812,3651,109076,130926,1853,44025,62907
13214,2827,69987,91287,1634,98155,107580,1193,42311,65389
13212,8990,63410,77347,5576,82292,90452,3414,40300,51176
13211,2386,59534,70032,1477,65218,81633,909,40136,47856
13210,7493,33346,49815,2781,48273,67560,4712,22641,36857
13209,5530,54545,65737,3392,61086,72686,2138,38913,51494
13208,8503,40515,53833,4877,46679,62260,3626,31064,37157
13207,5346,50885,65268,3435,59089,73683,1911,37281,45620
13206,8023,48698,63246,4046,53102,75685,3977,42116,49225
13205,7029,32237,46487,3935,44019,56629,3094,19495,31491
13204,8037,35431,48413,3757,33972,45914,4280,33617,47304
13203,7579,39129,58714,3247,57514,77820,4332,28967,43115
13202,2882,17031,38318,1074,14416,35065,1808,19833,39981
13167,1206,66538,75683,832,86071,89768,374,36667,40184
13166,2342,63922,80199,1489,82055,88783,853,30592,61055
13165,4208,55083,68476,2523,70159,84787,1685,30475,41155
13164,887,94324,94007,748,97125,103727,139,31250,34133
13163,131,68125,69359,84,89167,89936,47,0,30483
13162,148,0,77961,84,0,93168,64,0,58002
13160,818,74922,85730,583,86313,95951,235,50139,54977
13159,2118,77609,105022,1558,96161,121018,560,47679,56429
13158,652,73846,79032,445,84688,90660,207,31635,46836
13157,262,38250,48863,113,39375,57404,149,31477,42386
13156,717,51767,69027,503,51422,69100,214,41563,56362
13155,217,55859,73830,158,71250,86025,59,31250,41173
13153,172,0,76925,123,103625,91513,49,0,40306
13152,3401,87258,141874,2388,108906,172112,1013,39604,66354
13148,4890,51735,67986,2739,72039,82022,2151,32984,45815
13147,396,56875,61556,243,66699,74963,153,29583,38125
13146,789,56799,67075,599,61845,75209,190,25577,35695
13145,650,46667,58573,379,65231,65527,271,37716,43617
13144,505,49432,62573,359,54250,71344,146,30263,35545
13143,891,60594,67180,624,67333,77314,267,29191,41017
13142,2620,63333,86977,1862,77361,92776,758,38577,59239
13141,224,66591,75167,130,81429,91934,94,29886,49932
13140,1739,53958,72646,1137,67446,85483,602,34792,44127
13138,43,0,0,43,0,0,0,0,0
13136,161,48523,60926,97,51250,73980,64,28571,35398
13135,2430,64531,80035,1662,70734,90888,768,36250,50725
13134,48,92500,81127,32,108235,97419,16,0,45550
13132,1574,70278,79896,935,81164,84207,639,47027,69996
13131,1367,57156,78945,944,70800,93258,423,33250,41303
13126,13507,54759,73227,7979,72962,86283,5528,33571,50914
13124,42,61667,75881,26,82500,98023,16,0,39900
13123,74,0,0,74,0,0,0,0,0
13122,519,48693,58196,263,77266,82911,256,16667,31472
13120,786,65714,77363,506,80000,94318,280,39444,45164
13118,2090,63902,75437,1424,72935,83574,666,34167,52732
13117,119,35125,41518,69,48750,56932,50,14167,17714
13116,1362,63415,79483,890,85774,94198,472,34790,51449
13115,102,67500,87383,53,94375,109468,49,55536,56204
13114,2652,65086,79750,1788,75341,88629,864,45927,55707
13113,92,92500,82023,59,108125,99232,33,0,46279
13112,575,75717,84487,504,76010,84896,71,49028,72458
13111,591,40417,50284,495,44201,54124,96,18672,25618
13110,894,89615,98724,663,101359,107518,231,70313,72425
13108,2658,78300,95606,1812,92156,116869,846,32447,47623
13104,5965,107512,147718,4393,133829,175567,1572,45000,60169
13103,114,0,43075,68,0,40246,46,0,32524
13102,42,63750,60552,0,0,0,42,63750,60552
13101,887,61086,63025,633,58542,63519,254,34750,45821
13092,953,71149,78852,637,71228,80434,316,41944,69005
13090,11954,73890,90954,7568,88184,104161,4386,54829,64245
13088,10149,62077,77812,5023,81669,98259,5126,44583,55515
13087,95,162604,142833,77,164479,157757,18,73864,78989
13084,1548,75217,90217,1072,84573,102324,476,36768,61368
13083,820,69000,75571,564,83594,83336,256,60417,53728
13082,1653,74052,77386,1165,87109,88906,488,31900,44394
13081,490,87214,111418,372,96964,118555,118,59167,84031
13080,1320,61739,86552,872,69375,93871,448,37344,63119
13078,3798,92800,122656,2816,102949,135523,982,61316,79985
13077,2877,60331,80461,2031,64783,82212,846,34355,45772
13076,792,76875,89305,653,86198,97762,139,23274,28650
13074,1659,69792,72465,1176,75441,78336,483,28339,40769
13073,2682,60662,74345,1918,77264,83693,764,39659,47385
13072,349,55144,63214,235,55568,66329,114,36875,53546
13071,357,65625,83754,271,65893,89903,86,40938,51392
13069,9484,53941,69855,6453,57303,76200,3031,33771,48294
13068,2193,72228,88133,1323,74712,103417,870,58125,61180
13066,5253,100683,137207,3395,129517,174766,1858,48710,65033
13064,96,110625,142474,69,0,161762,27,63906,93185
13063,807,74946,113499,513,108281,144423,294,60438,59102
13062,14,0,0,14,0,0,0,0,0
13061,357,70402,80855,226,85294,96634,131,51058,52602
13060,1279,50840,62150,845,61875,72049,434,26563,37391
13057,6152,64219,76885,3292,80098,95487,2860,40884,51412
13054,531,85679,86832,447,84896,86918,84,85714,77901
13053,1774,65333,84828,1256,85714,97862,518,33306,49817
13052,615,52321,68674,416,67500,82134,199,28438,38496
13051,79,0,0,59,0,0,20,0,0
13045,10613,57420,72698,6370,75096,89431,4243,35193,43086
13044,1166,71023,95346,687,101940,113118,479,32188,67528
13042,941,72188,84045,662,78788,83717,279,38906,72492
13041,4608,84888,102059,3262,105708,117018,1346,55710,64006
13040,1001,58438,67706,694,63041,74011,307,31813,42293
13039,6621,93448,103937,4800,109414,118618,1821,48681,61779
13037,3589,77316,91977,2715,94250,106279,874,31402,46323
13036,3917,68807,83579,2454,79564,94680,1463,57662,60030
13035,3086,82277,118648,2082,105833,139066,1004,41855,72287
13034,768,78864,109435,513,94107,132050,255,48750,58510
13033,1321,67821,87933,974,81719,93536,347,41125,63203
13032,4577,62686,72533,3034,73852,82294,1543,37125,49202
13031,6485,77622,93789,4191,96165,115422,2294,37941,51438
13030,1396,68696,80281,934,79531,95348,462,38393,47350
13029,2801,80269,94645,2059,91750,106669,742,56842,55963
13028,409,75550,71172,311,90653,85031,98,25769,27193
13027,14058,79989,97339,9459,95972,113770,4599,42884,58182
13026,565,79955,90965,375,90694,100224,190,66250,69358
13024,0,0,0,0,0,0,0,0,0
13021,16548,51517,71023,9269,72346,89355,7279,32027,43471
13020,30,63750,68683,30,63750,68683,0,0,0
12998,186,44727,58858,108,66279,72321,78,43727,40218
12997,522,60781,82206,369,72560,88451,153,47969,58359
12996,929,69267,98240,742,83929,112610,187,31101,33865
12993,708,51645,77669,395,65461,101926,313,35739,43700
12992,1520,64688,90233,1045,73011,107212,475,28725,50709
12989,475,67917,79362,365,66250,81465,110,35357,42565
12987,121,95104,93579,97,96146,102173,24,50000,58842
12986,2529,56672,78120,1487,83966,97379,1042,34224,42100
12985,346,54167,65767,268,67857,75965,78,14716,21914
12983,3514,55054,73489,1792,82552,90961,1722,40510,51852
12981,1016,75978,81895,676,102917,98560,340,37059,47608
12980,487,51875,57660,297,57639,68389,190,35313,36387
12979,1136,44722,57619,624,62500,70428,512,25000,41120
12978,81,73969,70302,64,74500,83186,17,0,0
12977,0,0,0,0,0,0,0,0,0
12976,113,74583,87994,67,87344,106376,46,51875,61220
12975,141,54750,58245,66,54500,69576,75,32708,41793
12974,962,53417,70649,675,57482,78804,287,32880,44020
12973,49,49792,65065,34,83750,82032,15,30938,26607
12972,2614,84659,90305,1675,90388,93807,939,52847,81418
12970,113,78750,126583,69,96875,172730,44,36250,52948
12969,177,47292,55443,112,65577,72063,65,17014,26805
12967,451,51250,77740,276,65395,64391,175,31490,96231
12966,1085,53789,70617,767,67417,78926,318,34750,44491
12965,193,0,67315,134,72500,74512,59,0,48283
12964,27,61563,74300,16,81250,96694,11,0,41736
12962,2003,62176,77768,1362,74188,87052,641,43395,53039
12961,178,15995,18579,44,0,0,134,15543,15649
12960,255,39922,47442,171,51348,55098,84,35465,31854
12959,728,42984,49014,271,66442,70265,457,40951,36088
12958,955,65977,81223,642,72283,93043,313,0,54004
12957,608,48929,59350,418,49137,63214,190,43750,49931
12956,500,36023,44351,332,40449,46818,168,19844,26125
12955,181,63021,81675,111,66932,110501,70,35833,35966
12953,4789,52064,72962,3033,61840,86964,1756,34388,45545
12952,113,49792,59601,80,80250,80879,33,25000,2567
12950,292,63750,67103,237,66406,69538,55,0,49020
12946,2073,63055,90203,1183,58685,83796,890,47159,90790
12945,181,56181,77281,145,64375,89241,36,0,29108
12944,1564,55806,74902,901,68365,85466,663,36037,55656
12943,166,32206,50533,90,45417,55187,76,26750,36991
12942,312,90000,98773,203,91382,107445,109,0,82624
12941,594,77700,80985,365,81728,85016,229,47114,71162
12939,67,60875,83619,23,140208,127043,44,53750,60168
12937,719,46103,50435,495,49750,53676,224,28981,33436
12936,219,60458,65762,126,61833,75100,93,48977,51811
12935,621,54813,66377,387,66875,78573,234,29327,37353
12934,443,56797,60787,283,62235,66278,160,46250,47144
12933,28,73077,66879,28,73077,66879,0,0,0
12932,563,52039,74808,357,66806,94756,206,32639,34704
12930,267,64583,77233,209,64375,80833,58,26250,36812
12929,298,50385,60210,186,66458,72205,112,32500,38505
12928,854,70208,81970,653,82404,94381,201,17750,33577
12927,140,52500,61121,115,43906,60953,25,69792,61892
12926,971,46629,58121,656,58750,69738,315,18194,29495
12924,22,111944,102082,13,0,0,9,0,0
12923,253,53750,58951,183,64375,68816,70,19500,24639
12922,18,0,62544,10,81667,76480,8,0,0
12921,994,83462,92122,804,86389,97271,190,52727,50083
12920,1000,62059,86791,691,74637,101638,309,30781,46283
12919,1090,51932,66566,771,65625,76993,319,29034,35029
12918,1087,68125,102974,847,76875,91097,240,38333,44387
12917,516,56897,63721,336,63750,70379,180,48750,45197
12916,896,48750,55535,570,62824,60816,326,27321,35030
12914,373,48625,56558,283,51576,60959,90,20208,27372
12913,494,60476,77900,263,86458,101096,231,34519,49800
12912,856,57237,68959,519,68438,81530,337,38257,40282
12911,0,0,0,0,0,0,0,0,0
12910,658,44016,58013,485,55917,60198,173,27404,48724
12903,677,73018,83162,343,88073,101190,334,63611,64280
12901,13449,53456,72604,7142,71746,90739,6307,36729,47912
12887,1839,59375,68388,1163,76213,81811,676,25595,38647
12886,140,103125,78741,98,105698,96864,42,33929,36452
12885,1942,51552,63848,1180,64095,75694,762,30000,37728
12884,208,49722,65125,157,51125,68090,51,41875,49506
12883,2277,56784,71357,1356,56727,80581,921,34185,43338
12878,254,56250,65389,163,61705,71647,91,43750,47340
12874,97,114250,122729,77,124821,135245,20,75833,74545
12873,391,74271,86954,203,68565,85200,188,92969,86666
12872,47,0,0,43,0,0,4,0,0
12871,1710,71033,87080,1205,92969,105597,505,38750,40253
12870,786,50800,72446,507,58250,87922,279,32431,43023
12866,17437,88689,117772,10048,116166,147561,7389,58668,74378
12865,1345,57171,69611,838,65893,75665,507,47109,54298
12864,9,0,0,3,0,0,6,0,0
12863,311,79223,88399,225,91520,105071,86,0,44626
12862,0,0,0,0,0,0,0,0,0
12861,224,80556,85775,155,75625,95721,69,37083,50184
12860,253,74844,83371,123,98393,106833,130,70543,60002
12859,804,104539,102990,647,110034,103560,157,89554,69536
12858,62,88750,97563,49,103173,108429,13,0,56615
12857,282,64130,71275,221,71635,80833,61,21750,35969
12856,156,48958,55317,102,49625,67999,54,0,31361
12855,119,52054,62653,77,57083,75549,42,43125,39010
12853,794,45913,57036,475,61250,72075,319,31595,33182
12852,197,44688,63764,101,75156,80196,96,26667,44973
12851,163,64219,89536,116,63750,97489,47,48438,51834
12850,1096,86250,114977,841,84301,100129,255,68711,150057
12849,143,0,73216,93,96569,101760,50,0,0
12847,174,62778,69752,107,74327,89112,67,31563,36669
12846,1594,58902,78439,952,70526,91223,642,43198,54824
12845,2015,68343,83106,1312,97917,99055,703,46745,50619
12844,114,118804,157054,114,118804,157054,0,0,0
12843,206,45714,63284,144,55313,79361,62,18333,25945
12842,297,59063,69718,220,80714,80993,77,40750,37503
12841,111,53650,68368,35,80625,100446,76,53000,53595
12839,5577,52291,63718,2933,63042,79676,2644,33546,43464
12838,254,57222,68180,189,65089,67061,65,34779,59732
12837,416,64722,67096,315,63750,74842,101,0,32453
12836,292,69643,84267,148,53750,78018,144,67857,86797
12835,1158,63375,94720,805,77875,117061,353,30938,43155
12834,2416,72723,91101,1685,83938,102885,731,41106,57186
12833,1858,84437,132736,1214,90323,115570,644,55972,161621
12832,2814,45663,60396,1826,51600,66314,988,27383,43787
12831,6652,88507,104113,4731,102304,123683,1921,40979,48529
12828,3771,63169,81797,2619,75993,91439,1152,49109,49650
12827,1415,72825,84812,957,79353,92380,458,46406,66666
12824,422,68269,116338,247,110114,149297,175,54766,69296
12823,165,104911,88604,134,105107,86661,31,79531,77310
12822,2343,60818,68983,1744,66500,76545,599,36776,41679
12821,112,84643,69743,95,0,58673,17,0,0
12819,113,73125,87494,77,96875,104070,36,50577,44731
12817,1028,72778,88705,696,91765,104195,332,49907,54366
12816,2101,61463,74473,1218,70909,89121,883,29976,51879
12815,538,51333,69255,266,82857,93351,272,38100,44305
12814,690,95833,100930,329,117132,142871,361,64625,62706
12812,63,0,107673,20,87500,90995,43,160350,115430
12811,44,44833,53327,38,55357,56711,6,0,0
12810,257,59904,74766,202,62500,77123,55,30694,45260
12809,1434,57602,68468,938,60815,73620,496,40750,51552
12808,132,77500,84774,70,105000,118566,62,33750,46623
12804,11624,77663,100937,7258,103112,126087,4366,41632,57703
12803,3747,65196,75436,2204,77775,89180,1543,40020,53776
12801,6518,55573,71689,3457,71645,88120,3061,35759,48690
12792,60,65500,93815,30,0,146600,30,0,41030
12791,217,77344,76748,156,0,75842,61,83348,64374
12790,1560,76739,96059,1021,99087,111128,539,48550,51575
12789,851,64437,89307,494,88205,117691,357,48260,49111
12788,875,79784,152939,464,81250,120271,411,0,185900
12787,122,91389,88839,59,113207,104837,63,90787,73857
12786,207,111850,102318,89,166125,162612,118,60403,56842
12785,488,98750,94174,420,104773,103083,68,33654,35871
12784,15,0,0,15,0,0,0,0,0
12783,589,54219,70849,390,62500,79478,199,29180,39997
12781,106,83194,84806,79,105050,88865,27,0,0
12780,899,47288,71533,602,56444,82315,297,36686,48846
12779,770,31944,53457,501,44850,72931,269,11361,17188
12778,167,0,119792,149,0,126903,18,0,0
12777,378,110625,145946,290,122321,162302,88,48000,81465
12776,866,58409,88183,562,85786,100734,304,34632,61918
12775,828,82037,129050,507,95787,157724,321,68826,77851
12771,5729,50677,68918,3264,78661,84031,2465,28063,41920
12770,66,61786,80353,54,75000,89211,12,0,40500
12769,124,48056,57851,96,0,66168,28,0,29339
12768,307,67120,78239,239,71023,78401,68,0,70213
12767,76,77222,87332,61,91250,95067,15,75417,55873
12766,137,0,55638,50,0,97896,87,25733,31352
12765,416,71875,80770,294,71719,87961,122,26860,41634
12764,847,48832,69292,478,60370,73249,369,44638,58377
12763,300,34231,57420,155,68042,72787,145,19297,40994
12762,263,55898,59952,208,56091,57362,55,0,67445
12760,229,66985,85403,148,91346,109569,81,41875,41249
12759,693,31146,54612,574,32292,46183,119,0,87081
12758,1807,37423,56903,857,72358,75401,950,19107,40077
12754,2505,47083,68769,1511,58968,77197,994,20536,51537
12752,159,65446,80057,89,141750,114064,70,28750,36820
12751,382,38750,41530,214,32857,35052,168,53088,45221
12750,42,0,81145,32,0,68750,10,0,0
12749,172,74286,70320,105,0,96574,67,0,27564
12748,823,70911,86193,513,102694,104707,310,36929,54761
12747,815,50775,59869,559,62031,71551,256,21579,25957
12746,270,68056,73897,133,54013,75120,137,64531,66663
12745,127,0,70519,63,108727,109622,64,35714,32027
12743,123,80446,126965,108,80179,119355,15,0,116673
12742,55,0,58235,11,0,0,44,0,53430
12741,90,60417,68120,40,96667,107000,50,41000,37016
12740,780,74681,94754,461,71250,86701,319,0,105536
12738,135,67396,80269,88,110625,99028,47,0,43115
12737,668,97794,96649,451,105179,109819,217,69018,66211
12736,56,35238,37359,24,0,0,32,25000,26613
12734,330,47433,63155,186,76705,74465,144,46333,44456
12733,194,40227,43941,94,47639,58484,100,26757,30270
12732,410,26717,58512,264,0,74383,146,15946,28055
12729,659,47607,59950,432,0,68170,227,0,40144
12726,612,62336,91103,393,79635,109110,219,60572,52185
12725,54,90714,108869,29,90893,123193,25,0,92252
12724,91,0,107177,67,157902,141207,24,0,0
12723,751,64125,81330,381,92583,94020,370,57500,66955
12722,21,0,0,0,0,0,21,0,0
12721,1898,86797,97101,1459,101958,104080,439,45089,60250
12720,53,61927,60309,53,61927,60309,0,0,0
12719,553,66972,89562,303,78068,95299,250,66209,82168
12701,4199,45630,65163,2399,62423,79032,1800,30587,42506
12604,7,0,0,7,0,0,0,0,0
12603,16265,86155,108789,10847,109273,128536,5418,47832,64865
12601,16000,50007,88554,8305,73227,90573,7695,34798,84790
12594,1622,73333,92326,1175,101307,115815,447,16369,28028
12592,577,63958,115504,390,80341,132292,187,56514,80413
12590,13196,90103,108212,9350,104597,124611,3846,49969,62522
12589,4925,86821,104246,3795,95573,115626,1130,39315,53637
12586,4284,73333,92898,2914,90387,106815,1370,43423,59847
12585,340,86429,115830,250,119688,137162,90,61118,55317
12583,834,77692,104583,482,94286,134065,352,45000,56659
12582,1421,111659,137319,1193,123009,149219,228,0,59996
12581,917,74301,111958,599,98036,113887,318,60370,101300
12580,1679,73375,116282,1193,102917,134834,486,51818,64678
12578,874,89211,102376,606,121159,120287,268,43480,56942
12577,563,160717,159980,528,145000,163380,35,0,66226
12575,652,145769,150259,518,163077,168462,134,0,79161
12574,200,0,131707,96,206406,214095,104,0,0
12572,3862,85234,122776,2246,121563,161158,1616,44571,68407
12571,3953,90268,123500,2586,100221,134941,1367,53681,96893
12570,2334,103482,129485,1790,131071,149190,544,49583,60171
12569,3967,81997,102945,2628,100536,119466,1339,51991,67048
12567,1063,66435,107843,726,80638,126161,337,45893,65210
12566,4055,85884,110282,2951,100154,118691,1104,50625,78850
12565,499,51386,60183,244,58553,73120,255,24453,45884
12564,2829,94539,114836,2071,117754,132378,758,49500,62920
12563,2323,106161,113636,1883,113906,109957,440,71667,116430
12561,6477,73514,92350,3248,94754,126020,3229,35149,56229
12553,9701,85342,104809,6550,107017,126019,3151,41464,56891
12550,20156,65760,84330,13211,76666,96490,6945,38269,53779
12549,3820,100750,113383,2877,109606,128629,943,39021,46841
12548,514,67778,86399,326,112167,110400,188,50862,43371
12547,1137,95521,119890,813,110875,138886,324,51421,67075
12546,1244,67615,90944,693,92938,111345,551,33661,62889
12545,2138,80711,104894,969,111620,147305,1169,36793,67738
12543,1448,77125,89044,903,94112,111402,545,35430,49536
12542,2320,97663,123122,1635,116806,146517,685,41756,58698
12540,2943,105673,145643,2491,115225,154171,452,63600,89179
12538,5262,79536,100155,3524,95208,112891,1738,36111,69941
12534,7767,54159,74984,4502,65437,87146,3265,35306,55516
12533,8659,107539,142643,7143,120435,152097,1516,59808,92604
12531,1015,119435,139466,675,150179,170720,340,41848,75037
12530,24,0,0,24,0,0,0,0,0
12529,821,84293,130112,565,98099,150415,256,37407,82570
12528,5088,75590,89535,3122,95789,110265,1966,41841,53808
12527,0,0,0,0,0,0,0,0,0
12526,1611,70977,94725,1167,80951,107108,444,46786,56903
12525,1075,79105,98171,719,88491,118791,356,44048,48664
12524,6171,82842,101280,3590,104375,124375,2581,54821,67635
12523,817,75074,95387,520,80833,112776,297,38472,57227
12522,1994,60492,74764,1282,67986,86226,712,33008,42509
12521,698,62368,105913,476,71000,113467,222,58841,75485
12520,1108,108625,124594,821,120993,131388,287,60750,87236
12518,2348,84196,107819,1587,118199,132651,761,50659,53877
12517,170,84554,73333,67,120208,90616,103,0,55264
12516,763,111991,137103,543,137417,143906,220,41827,118691
12515,548,51848,89793,396,0,107563,152,24688,43498
12514,1205,108125,150712,869,115938,176562,336,41333,82486
12513,201,0,57202,110,66481,79864,91,32725,29810
12512,85,0,105135,85,62344,87008,0,0,0
12508,7349,79410,99795,4184,100096,117259,3165,52426,73610
12507,74,58750,83131,29,147917,156024,45,0,36156
12504,70,178693,179156,60,178693,179640,10,0,0
12503,226,75000,169810,158,83214,161994,68,70250,184204
12502,534,75238,118586,342,77381,138056,192,48750,83806
12501,812,65714,88093,557,72470,108414,255,26131,37137
12498,2451,53344,90802,1193,87139,123546,1258,31083,54788
12496,588,63077,81276,333,75781,100305,255,35375,54303
12495,61,51607,117638,23,0,161778,38,55250,90921
12494,386,118235,111875,241,119164,130612,145,72099,80732
12493,77,0,64217,10,0,0,67,0,0
12492,44,0,77914,27,108438,100478,17,37917,40335
12491,623,100951,104501,455,101821,116038,168,53162,64214
12490,21,0,0,0,0,0,21,0,0
12489,178,24205,48896,36,123750,122328,142,22330,30280
12487,1420,66360,107648,874,109375,138893,546,47063,54740
12486,577,90787,102001,384,110000,121673,193,65724,59832
12485,255,52625,70895,137,71953,107647,118,17500,25878
12484,1568,56500,77013,1132,58080,82250,436,45300,61823
12483,86,63200,73120,49,0,110133,37,0,17038
12482,182,0,79946,108,93432,87650,74,0,28073
12481,563,63472,88694,441,56540,88062,122,65637,80752
12480,203,93807,103221,120,133269,145703,83,21406,38564
12477,7566,62634,87955,4411,93245,112214,3155,30440,50736
12475,154,0,41236,72,61429,61318,82,18731,22352
12474,412,49141,85076,248,48750,95282,164,46250,65126
12473,247,64514,76070,168,81500,82764,79,37917,61835
12472,645,53563,65931,404,72069,72194,241,41359,37326
12471,307,25000,30010,37,0,0,270,25000,19169
12470,202,72500,74462,121,64716,66415,81,0,82895
12469,304,90227,82926,163,56458,83095,141,100446,82731
12468,429,58359,90958,259,88854,124823,170,0,38486
12466,908,69483,85656,602,85227,98047,306,36250,56677
12465,132,46563,79817,75,128542,124395,57,0,20561
12464,616,57326,68830,200,73125,96000,416,49896,55767
12463,761,59063,80955,384,88654,99948,377,0,60404
12461,544,82101,156704,325,72039,208777,219,81676,75719
12460,118,25500,64903,44,30000,79882,74,0,55997
12459,93,85341,101624,70,90417,124276,23,0,0
12458,1039,46118,64620,571,65871,84594,468,19547,39336
12457,485,51174,74101,234,62586,100191,251,0,48853
12456,276,72500,74689,244,78227,77371,32,0,0
12455,807,62153,66431,364,90313,100628,443,30679,38333
12454,145,50625,65497,111,52386,72912,34,34028,41291
12453,130,0,60982,130,0,60982,0,0,0
12452,94,80833,78048,71,80417,83800,23,0,53887
12451,470,62454,66056,320,71429,71269,150,61014,50202
12450,43,105260,74584,43,105260,74584,0,0,0
12449,1228,49286,73207,665,80417,91524,563,39095,50584
12448,189,116438,222988,119,114702,182406,70,0,291977
12446,1842,65731,78331,1347,72280,89280,495,40380,40358
12444,190,57969,83054,136,58750,92564,54,0,59102
12443,1604,102143,125511,1098,118333,135340,506,60208,97458
12442,470,24405,49934,160,0,102429,310,19500,22841
12441,82,45438,45467,42,0,44226,40,0,0
12440,603,93938,102489,378,99722,106681,225,81806,88667
12439,160,0,56846,132,0,59366,28,0,44968
12438,0,0,0,0,0,0,0,0,0
12436,129,0,67499,57,0,0,72,0,18904
12435,54,110250,86098,38,110125,86868,16,0,0
12434,445,37734,51395,220,70962,76221,225,18934,23935
12433,244,0,53550,116,0,74008,128,0,35009
12432,240,38132,36420,120,0,36780,120,38421,36061
12431,560,67098,87623,425,67448,92565,135,66836,72063
12430,698,56570,71284,492,68636,69236,206,55174,71234
12429,100,119583,127939,100,119583,127939,0,0,0
12428,2450,47240,65656,1487,59031,75746,963,27409,47118
12427,153,111031,167624,82,111750,126605,71,0,214997
12424,101,66042,73782,46,84722,99926,55,53563,51916
12423,437,65208,66206,301,80026,72955,136,32941,40432
12422,101,0,78977,75,0,96597,26,0,28150
12421,123,82639,143844,70,83241,116947,53,76339,179370
12420,145,101891,109674,116,90667,85158,29,98958,99614
12419,236,54554,82166,135,0,101496,101,54097,55354
12418,106,65833,106268,92,65000,109893,14,69000,68914
12417,213,84648,88142,155,83164,80571,58,0,36841
12416,190,29009,74394,63,0,0,127,0,96073
12414,4329,40643,60826,2207,60037,72292,2122,31781,46781
12413,1224,50458,74950,714,72768,91741,510,40374,40508
12412,190,70144,87665,176,70481,93996,14,0,0
12411,159,68482,70485,84,95385,86708,75,43170,47435
12410,226,27000,36521,94,0,42805,132,25000,29998
12409,334,96250,113654,209,130729,137774,125,73750,64744
12407,72,39028,42344,38,39500,45474,34,38438,38847
12406,330,42976,49499,141,0,65519,189,0,37548
12405,190,53281,66854,122,73864,84054,68,43654,35996
12404,1479,49941,85284,1058,78833,101406,421,28819,43382
12401,14269,57830,76558,7750,67539,89787,6519,39676,55155
12309,11110,109958,127874,7774,125718,147830,3336,67167,77896
12308,5381,49550,62041,2647,49035,69808,2734,45898,50438
12307,2348,30762,55100,1188,58722,84194,1160,16418,21706
12306,9852,67224,82067,6239,80446,96116,3613,43858,52276
12305,3017,36649,51092,556,71063,78596,2461,32721,43733
12304,8111,53940,68490,4328,66505,82466,3783,34388,49963
12303,11006,68949,90604,7313,89443,106316,3693,43285,54637
12302,10320,79199,91075,6085,99682,112766,4235,44973,56041
12222,0,0,0,0,0,0,0,0,0
12211,4205,117519,134516,3039,136778,153447,1166,49091,81410
12210,5545,44248,60955,2174,47433,75826,3371,41664,50598
12209,4072,60549,72646,2382,73125,84085,1690,44133,54734
12208,9668,63367,79318,3794,92500,116063,5874,39970,54005
12207,1211,23698,49759,241,16420,34201,970,25086,53625
12206,6315,36137,49280,3185,39792,56173,3130,25943,39666
12205,11175,75595,85767,6791,94624,98757,4384,44339,58300
12204,3421,58442,78455,1651,72981,96168,1770,51188,60707
12203,13666,64932,86466,5960,101045,121428,7706,46195,55316
12202,3961,33542,49123,1683,32703,54471,2278,32273,40156
12198,2837,76740,99288,1946,95227,116273,891,40562,54314
12197,805,69917,77961,587,75813,85794,218,41250,53086
12196,1371,117888,127241,1206,118544,129737,165,49464,50314
12195,135,0,84967,27,0,0,108,123099,98617
12194,57,43250,58379,29,44750,68034,28,41818,46461
12193,771,61012,81402,608,59000,84227,163,45341,49529
12192,680,81944,93988,460,88750,99636,220,65588,76075
12190,190,67083,65763,156,65833,66521,34,0,43903
12189,8565,49932,72437,4176,69042,88837,4389,39197,54395
12188,5042,70068,92875,3163,103248,114592,1879,46625,53818
12187,209,51831,59426,137,58102,64928,72,50357,40447
12186,2483,108180,137689,1763,127169,164285,720,59304,71705
12185,806,86250,108730,643,98583,123519,163,30938,41588
12184,2572,77138,109271,1728,92500,118544,844,46902,83050
12183,1303,49792,62673,511,57443,67188,792,45583,58070
12182,6002,55127,77117,3370,74473,88239,2632,33773,59631
12180,21563,59523,75138,11398,75657,93415,10165,39462,50411
12177,169,115114,93540,154,116818,99225,15,0,0
12176,129,0,71878,64,120833,108791,65,35469,35534
12175,277,73125,73916,174,73800,78602,103,44375,63081
12174,213,44569,71628,167,0,77343,46,0,31100
12173,787,70521,82715,586,78523,90533,201,47188,49470
12172,61,43920,47621,61,38173,36975,0,0,0
12170,1933,86275,96668,1458,88364,106721,475,0,45740
12169,170,0,91596,73,0,142063,97,35809,46958
12168,856,72438,94869,556,84888,114872,300,62619,57152
12167,1084,57292,66675,620,70761,77749,464,31250,49439
12166,468,53438,66535,291,62171,75358,177,38828,48203
12165,108,67500,76541,57,114750,109119,51,38750,37565
12164,106,76250,102298,74,93750,127857,32,45500,39428
12161,62,0,0,28,0,0,34,0,0
12160,328,71944,89551,226,65000,76122,102,0,108242
12159,3512,93512,143451,2306,152361,189507,1206,46458,55388
12158,2779,82179,111128,1729,117997,131464,1050,51930,66600
12157,1723,63862,94571,1216,82500,114132,507,31417,41305
12156,263,116544,121400,214,137969,133082,49,59338,62247
12155,870,47955,61479,561,60707,72611,309,27042,39753
12154,1343,82188,101747,1031,98345,112451,312,57614,60850
12153,316,73186,79921,288,73137,79363,28,105192,85657
12151,498,77132,90771,323,74583,94121,175,80914,84215
12150,310,71125,77460,184,80938,90513,126,0,52303
12149,939,57902,68308,609,68472,78078,330,28417,42063
12148,1735,111004,134507,1159,157917,171809,576,49100,53464
12147,224,65000,104334,110,122237,132918,114,53375,76754
12144,9260,77000,87391,4997,92529,100921,4263,54296,64949
12143,2112,65357,90619,1347,87552,108244,765,39306,51444
12140,679,100804,104837,478,120598,125928,201,42344,54680
12139,61,61607,73125,33,104063,97755,28,0,43943
12138,1312,67500,76379,807,82138,90211,505,40337,51020
12137,779,87961,98616,555,98068,107523,224,62750,75188
12136,267,110486,159872,205,130156,188881,62,44444,56092
12134,1652,54516,72838,1055,65276,83370,597,47515,52652
12132,137,108060,106034,113,0,89973,24,0,0
12131,40,38750,53865,24,48750,67021,16,23750,33338
12130,316,59919,79472,248,86071,89747,68,0,30093
12125,470,65577,76540,239,79625,104148,231,33920,44680
12124,174,65862,80074,126,0,89624,48,0,55006
12123,2107,93451,107912,1372,108838,123883,735,38787,73444
12122,2122,45800,62293,1179,59250,72409,943,30221,47320
12121,706,89084,98719,568,88094,97369,138,47708,72041
12120,301,85060,89675,193,106607,110536,108,35357,47594
12118,6999,81922,107193,4369,107817,139105,2630,39706,52183
12117,1394,64375,105631,899,70988,88759,495,48309,135930
12116,696,59167,99798,457,62250,117563,239,15739,59974
12115,33,0,161291,25,0,150440,8,0,0
12110,7442,83240,95637,4952,95783,110876,2490,54097,62581
12108,79,75179,67111,55,81719,85795,24,0,24296
12106,1062,83026,111556,662,105625,139645,400,62551,59483
12095,4980,57247,72171,3133,71548,82037,1847,31795,50263
12094,817,95099,99112,617,103322,96549,200,66563,86264
12093,711,51008,79607,455,64063,99597,256,27917,41770
12092,503,43828,56183,270,59483,73571,233,21743,31350
12090,2322,55316,77062,1421,83487,94377,901,41094,43988
12089,35,0,0,0,0,0,35,0,0
12087,342,57963,72779,285,60650,80846,57,36042,32440
12086,730,62500,69301,410,72292,86572,320,22500,40905
12085,162,32143,44859,76,0,70963,86,20625,21790
12084,2100,78049,98044,1068,116250,122274,1032,63698,71776
12083,1316,76081,87565,962,84716,102649,354,40345,43527
12078,9790,44144,59393,6109,50377,66568,3681,29602,42633
12077,2614,98393,133920,1618,137167,166286,996,49643,61367
12076,573,57188,65067,342,75000,76069,231,32813,43175
12075,939,82212,101151,639,94712,110554,300,56364,76482
12074,1134,85000,97291,784,105625,109640,350,47386,69266
12072,928,68030,83572,697,74044,94353,231,38603,45868
12071,107,57125,68179,84,57000,62048,23,53523,52570
12070,774,53472,87334,512,111250,111159,262,27273,37541
12069,111,0,93869,57,0,149416,54,38750,35237
12068,1130,65417,77053,744,84306,88676,386,41793,48333
12067,604,84716,101324,450,103438,117345,154,40769,53519
12066,801,71705,92887,511,82898,100949,290,46731,77736
12065,17303,100114,121797,11479,117102,144473,5824,54278,73333
12064,169,38438,44251,83,33295,43580,86,43500,40049
12063,355,71466,73010,255,0,67518,100,0,0
12062,622,70238,80496,409,75104,91096,213,49410,53723
12061,3944,97734,124178,2683,119673,145474,1261,61314,74367
12060,747,109688,134750,590,122031,150370,157,51250,66754
12059,717,85953,94813,558,86063,96663,159,72250,77964
12058,431,71449,76111,308,83750,87978,123,0,44556
12057,843,71151,77412,645,80040,88824,198,35682,34574
12056,834,85000,94052,600,96176,106466,234,43295,55547
12054,6971,113383,130479,4600,139922,158373,2371,58484,73689
12053,1655,82316,105482,1118,102500,123331,537,60333,64051
12052,731,84955,81414,474,104907,96159,257,43234,47082
12051,1695,67560,84633,1058,103906,110908,637,31074,39517
12047,9336,60444,80519,5374,69574,89902,3962,48005,62747
12046,488,81250,84889,286,117917,104800,202,0,55629
12045,196,54722,57292,98,41019,50061,98,66111,64522
12043,2939,55827,77243,1805,69386,88260,1134,38400,55848
12042,138,88816,89879,91,137878,112065,47,46146,46923
12041,211,94906,139990,192,97222,148910,19,0,0
12040,45,0,32602,30,0,34653,15,25000,0
12037,1764,69000,89878,1116,84672,107518,648,46250,57948
12036,85,59125,74986,50,78542,88484,35,0,43757
12035,234,62188,78632,189,73750,90486,45,27083,28127
12033,3501,77352,91104,2127,95846,116641,1374,39746,50532
12032,363,47950,61914,273,56635,70390,90,20714,31378
12031,77,58906,61365,38,63833,62966,39,0,59805
12029,479,85972,103616,287,100536,120951,192,0,73134
12028,275,69911,74221,218,68214,76007,57,41484,47567
12027,1515,102120,126596,1248,115556,134623,267,65208,79800
12025,2281,68281,87226,1633,79271,96091,648,33648,54047
12024,0,0,0,0,0,0,0,0,0
12023,928,90938,91998,748,97500,96960,180,67045,61720
12022,280,74167,81688,183,85938,99692,97,34926,44224
12020,14088,84403,101075,8504,104770,121338,5584,54236,65621
12019,6093,99196,120328,4272,118640,139940,1821,60332,65415
12018,2962,100156,107477,2115,114088,125589,847,42440,56778
12017,264,41250,75992,130,79063,120560,134,24247,32429
12015,1163,74821,101686,845,90720,121916,318,25000,43071
12010,11459,47750,66819,7206,59746,78724,4253,33941,40950
12009,2991,99050,123802,1979,112002,144411,1012,52907,73356
12008,188,108889,114075,142,108611,119518,46,0,82635
12007,10,0,0,0,0,0,10,0,0
11980,2319,92409,107856,1293,117044,128767,1026,51154,78414
11978,1210,97273,161675,788,115982,190175,422,61000,102782
11977,886,118036,163667,648,146314,191905,238,70833,86485
11976,851,175875,296659,571,243614,355561,280,51279,165752
11975,73,140750,139968,40,149167,181030,33,96094,90197
11973,0,0,0,0,0,0,0,0,0
11972,386,91711,95859,280,103542,101175,106,0,81814
11971,2521,85981,131612,1712,107788,147815,809,57829,92791
11970,160,21900,34258,68,0,0,92,0,0
11968,4302,118623,219113,2901,145609,279092,1401,62946,91982
11967,8533,91139,131137,6816,95953,143864,1717,45430,66678
11965,329,125283,118504,119,0,162279,210,71058,93698
11964,1046,97234,111314,706,125824,113216,340,0,85820
11963,2832,103929,169429,1797,113594,197934,1035,66719,116533
11962,122,71250,165268,86,0,193299,36,0,74261
11961,5693,75188,95928,3430,98575,121831,2263,41815,51839
11960,346,158750,182810,248,161389,199995,98,0,139319
11959,252,124853,132642,210,131900,147750,42,0,54024
11958,297,91678,120401,204,91908,131663,93,0,95698
11957,480,72885,170790,336,75592,215759,144,57813,65199
11956,157,104375,124640,102,119167,140738,55,63750,80536
11955,1599,70068,80590,946,89740,98298,653,59375,54765
11954,1311,102266,140699,950,123500,152970,361,78942,107592
11953,5592,81250,93027,3442,99346,110381,2150,46559,56894
11952,2144,91259,110685,1563,95213,129807,581,50417,59243
11951,4730,83975,93080,3499,89329,102902,1231,40716,60002
11950,4626,90714,100190,3802,95647,100727,824,65556,79440
11949,4807,101423,117685,3392,121608,137196,1415,47681,68599
11948,260,124043,141580,174,0,110703,86,0,0
11947,238,0,118439,57,0,166402,181,0,103335
11946,5923,92716,127029,4056,115172,144428,1867,46938,83196
11944,1954,66406,111428,1053,97639,141375,901,47198,73066
11942,2045,90107,121867,1422,114167,140194,623,64006,69563
11941,685,105469,132500,484,119792,137387,201,56042,118218
11940,1718,106051,145747,1360,111705,159666,358,74306,82383
11939,532,86900,119907,340,112500,136157,192,73125,91130
11937,6752,109375,179537,4422,132870,203938,2330,66324,132091
11935,1197,113569,172542,915,116528,188118,282,54231,111126
11934,2577,125815,131409,1920,129665,145842,657,60391,80876
11933,2871,69583,90835,1737,97266,114025,1134,38085,51532
11932,445,109402,188800,304,136250,227608,141,72083,97581
11931,20,0,0,20,0,0,0,0,0
11930,300,130625,195593,182,149545,181487,118,95000,217349
11901,10173,69353,85796,6635,78088,96007,3538,38488,52933
11804,1583,146507,178258,1269,169219,214092,314,22463,33436
11803,10076,155053,184400,8155,171910,212257,1921,44222,63951
11801,12872,118286,134340,10259,127316,147638,2613,42843,76548
11798,4345,84728,101943,3169,97863,111908,1176,45927,60788
11797,3097,180688,255736,2376,229091,307389,721,64219,85391
11796,1329,124716,123216,1031,140114,140082,298,34375,61493
11795,7969,134511,155865,6621,143321,164003,1348,75368,107069
11794,0,0,0,0,0,0,0,0,0
11793,10305,144182,157726,8311,160605,175626,1994,50208,73827
11792,2984,137895,155487,2334,176991,172531,650,0,88795
11791,8098,164483,230220,6896,190714,254632,1202,67594,86127
11790,4352,132500,166275,3178,151204,193580,1174,77024,87359
11789,2757,110156,115830,1725,124757,144342,1032,44944,63387
11788,5512,121648,140524,4164,143514,161008,1348,51691,69393
11787,11734,127235,159002,8828,153492,180413,2906,52892,88237
11786,1882,145463,160470,1536,154295,176564,346,37311,78583
11784,8185,87658,108087,6510,100881,116741,1675,46703,62481
11783,6952,144651,169355,5782,152161,176800,1170,90214,104227
11782,5288,125943,160640,3894,151227,190091,1394,58571,74834
11780,5707,131412,170113,4198,157659,200599,1509,45515,79283
11779,12525,100630,112880,8925,120411,129913,3600,49562,61789
11778,4265,99886,118902,2957,114462,135138,1308,60873,75238
11777,3526,118518,164044,2290,147500,200677,1236,73472,92315
11776,7859,107145,121027,5819,121411,138796,2040,50731,64774
11772,16981,92249,110504,11075,105414,130223,5906,44298,68101
11771,3647,116639,197878,2596,141935,231496,1051,53575,103752
11770,27,0,85596,10,157500,166330,17,0,38106
11769,3200,108372,134885,2144,152569,165853,1056,52544,67272
11768,7689,141815,186606,5612,167083,221616,2077,59570,89595
11767,4951,116998,146540,4068,133796,163646,883,53903,66178
11766,3877,123125,146419,3119,150050,161730,758,65038,73915
11765,279,"250,000+",444808,241,"250,000+",491070,38,0,137163
11764,4412,123906,151849,3562,140152,173132,850,41592,52470
11763,9480,95296,105460,6825,105028,116845,2655,48750,62876
11762,7740,145321,155661,6503,152013,170214,1237,62917,70552
11758,18658,122632,147558,14197,149428,169437,4461,51837,71642
11757,14426,100915,114890,10823,113511,125785,3603,49690,73431
11756,13955,120579,133826,11672,126063,140112,2283,78083,90186
11755,4077,115216,132707,3229,131386,149202,848,36467,60712
11754,7027,102089,128347,4562,141859,159503,2465,50273,67912
11753,4428,174400,242005,3660,189622,259969,768,84107,151770
11752,2984,122802,139641,2337,135712,154105,647,52109,75415
11751,5087,108340,127840,3464,131964,147164,1623,49536,81121
11749,1086,82500,104304,802,92500,108813,284,64583,61079
11747,7181,117210,168013,4879,149107,200984,2302,62549,95124
11746,21696,122944,159834,17198,136026,173479,4498,62759,91356
11743,15250,139619,188349,10846,163597,220545,4404,76000,101042
11742,4312,109426,130307,3175,124761,148478,1137,57684,70745
11741,8941,113762,127521,6494,128494,142179,2447,65580,79811
11740,3197,121033,149328,2317,159034,186326,880,42542,46893
11739,436,155608,208330,345,184375,250860,91,0,38543
11738,5360,119324,138696,4689,127014,144833,671,63992,80362
11735,11460,120516,138313,8287,146182,162198,3173,51466,67280
11733,5731,160163,210615,4520,179739,233888,1211,61760,101981
11732,1427,101875,140845,865,151845,192464,562,35250,60105
11731,10541,132450,154239,8161,142308,168010,2380,59511,95563
11730,4799,111372,131627,3179,135093,160817,1620,59730,72321
11729,8426,105104,118697,5954,120811,136027,2472,54481,66877
11727,10844,83802,104134,6815,103983,122031,4029,59229,64571
11726,5969,93438,107831,4725,97736,110968,1244,45800,73371
11725,9447,142921,174669,7832,161136,194197,1615,53709,75137
11724,959,"250,000+",293609,810,"250,000+",319457,149,0,123545
11722,9566,79432,98198,6798,91972,106553,2768,44577,63067
11721,2333,154144,214951,1820,168357,234729,513,104297,132133
11720,8967,109720,124787,7053,122123,137295,1914,52273,67146
11719,1109,90183,109507,733,130074,140419,376,37750,48393
11718,1022,135595,167084,825,148828,181513,197,81797,95541
11717,14710,89926,115208,12124,91125,117774,2586,47054,61584
11716,3524,107561,118372,2399,121069,133270,1125,55703,85789
11715,1640,102083,121629,1180,130556,147452,460,34958,55387
11714,7824,112205,135750,6131,127765,156320,1693,36061,54960
11713,2986,88173,118851,2122,110433,136588,864,50543,69123
11710,11177,142444,167465,9268,156118,181875,1909,49183,73675
11709,2572,115972,163353,1944,146250,190368,628,70529,75344
11706,18917,97495,119692,14086,111568,132200,4831,44175,65311
11705,2856,122708,146099,2301,138497,159489,555,70893,79490
11704,12761,104375,116629,9006,110132,129222,3755,60129,73669
11703,5284,105139,128889,3937,118113,144292,1347,50707,69372
11702,5461,120865,145133,3874,145577,163389,1587,65580,98866
11701,8720,85088,103615,5830,101330,122385,2890,39156,58455
11697,1295,116205,152227,924,138889,169363,371,74931,105608
11694,8069,87755,114854,4837,113890,142777,3232,52818,68649
11693,5210,52946,77184,3291,64646,83308,1919,35991,57070
11692,7408,53077,73727,5326,63424,83072,2082,30895,44643
11691,21163,52605,81358,14593,67474,93818,6570,23450,43343
11598,3902,151269,209020,3360,164779,229067,542,56505,76193
11596,3542,137688,190103,2811,158650,219294,731,52526,75146
11590,14617,113338,138088,11060,132366,156886,3557,45083,69276
11581,6908,126429,146981,5593,139136,162697,1315,62303,71745
11580,13015,118392,129851,10365,128983,142812,2650,45219,67189
11579,1899,160250,238924,1419,180054,265884,480,56250,145443
11577,4248,159388,220878,3433,174205,239972,815,74543,129278
11576,4451,203534,282603,3594,"250,000+",324044,857,64855,107075
11575,4365,90707,111060,3723,92125,113146,642,44192,79427
11572,10206,116224,140803,7754,132854,157465,2452,57833,78020
11570,10516,121592,166176,7214,171675,208757,3302,51537,69739
11569,555,0,176241,298,184286,235792,257,0,98397
11568,1067,224712,368270,832,230667,376488,235,164821,334541
11566,11422,152266,175710,9435,163431,190751,1987,63542,95828
11565,3278,130664,159412,2505,157417,182850,773,63467,83461
11563,7738,117988,148367,5574,150341,180670,2164,50750,58186
11561,15697,112522,139105,9106,131047,166370,6591,78486,95988
11560,2366,149865,267062,1849,192375,312020,517,53102,95917
11559,2427,96205,193721,1765,141750,241129,662,53459,65341
11558,2827,103508,128286,2072,135620,144697,755,51450,64669
11557,2658,137857,189333,2188,144803,206427,470,49048,88399
11556,0,0,0,0,0,0,0,0,0
11554,12339,109895,137328,9844,126584,154421,2495,46807,60844
11553,6943,83570,107060,5263,98242,112741,1680,32600,64423
11552,7206,129091,146000,5860,140924,153913,1346,61765,85278
11550,17038,70728,94695,12578,75250,93427,4460,45505,70052
11549,0,0,0,0,0,0,0,0,0
11548,477,131806,215279,359,204250,267876,118,0,50124
11547,214,48636,128781,144,65833,168950,70,37917,43900
11545,4485,140563,252842,3532,183889,290632,953,80763,101052
11542,10365,78242,106545,6844,98929,126939,3521,38423,59993
11530,9303,169323,230942,7436,196270,255217,1867,81830,122604
11520,14473,86070,108589,10155,101055,119208,4318,48333,70099
11518,4057,87596,122378,2419,112269,144387,1638,33281,84429
11516,2758,84421,128778,1928,126579,163773,830,34356,46574
11514,1709,97113,122735,1358,103125,132514,351,54519,68326
11510,11022,122090,138551,8819,140202,149971,2203,61321,80841
11509,742,135938,189507,517,139625,206591,225,72292,138558
11507,2419,121861,177436,1928,133594,193198,491,93977,111998
11501,7812,103809,124711,5010,124342,147753,2802,62414,77048
11451,0,0,0,0,0,0,0,0,0
11436,5496,72962,94392,4276,81702,98263,1220,47179,61186
11435,19310,69873,88634,13318,77552,95577,5992,53651,66437
11434,21510,65845,83921,14020,86969,99535,7490,36500,47715
11433,10655,62453,80032,8023,74060,88382,2632,26926,39823
11432,18790,66270,90626,14042,69187,97724,4748,44955,58684
11430,0,0,0,0,0,0,0,0,0
11429,8006,82532,97848,6217,99720,109541,1789,23401,44957
11428,6121,77466,94622,4924,87202,101850,1197,41767,56595
11427,7745,81688,105540,6189,91809,115896,1556,47596,56895
11426,6287,102770,119975,4887,118023,131850,1400,66385,73884
11425,0,0,0,0,0,0,0,0,0
11424,0,0,0,0,0,0,0,0,0
11423,9838,70990,89972,7037,84908,103173,2801,40438,50647
11422,9951,93397,107049,7760,95986,112119,2191,52462,72146
11421,11325,77738,97905,9256,80795,100148,2069,47068,64706
11420,13042,85190,102028,11099,88744,104334,1943,42757,64371
11419,12497,79589,93449,10628,82891,95388,1869,40580,60254
11418,11250,73856,94702,8618,79917,101209,2632,46452,56757
11417,8887,79210,94565,7315,85897,100255,1572,40658,47736
11416,7409,73471,88125,6156,77000,89773,1253,47841,63250
11415,7849,75476,104554,4035,96539,126553,3814,61651,79008
11414,11058,75599,105479,7201,94779,125328,3857,45800,62752
11413,12694,91836,108650,9981,99678,118282,2713,50238,57181
11412,11259,85235,101822,8551,97726,111780,2708,45822,51888
11411,6183,104269,118439,4828,121417,132618,1355,39327,59553
11385,35589,77044,90871,24436,77729,94498,11153,61664,71625
11379,13561,89700,107104,9847,108979,122595,3714,44771,56992
11378,12887,82326,99441,9304,91520,108775,3583,48105,63719
11377,31601,59910,79252,18893,68045,87548,12708,44283,59071
11375,32509,88117,116806,18714,113610,143881,13795,59092,77947
11374,19044,75266,93752,10932,96378,111204,8112,50521,67648
11373,31255,56835,73043,21778,61721,76848,9477,42647,54396
11372,23842,61239,82871,14255,65392,86130,9587,49609,69132
11371,0,0,0,0,0,0,0,0,0
11370,7550,67582,91315,5184,85705,104801,2366,48438,51893
11369,9566,61860,78247,6692,69964,82776,2874,50534,57925
11368,28163,56904,71465,22145,53897,68413,6018,34628,49446
11367,13930,64332,85658,10013,76487,96470,3917,36925,54400
11366,4514,91795,111591,3533,105063,121683,981,49631,67645
11365,15702,70102,87247,11059,79096,96461,4643,39723,59925
11364,13141,87135,103613,9439,99609,115547,3702,50469,65636
11363,2779,111094,141278,1937,135972,165452,842,64375,76461
11362,7153,92212,110938,5034,122643,126321,2119,54568,71887
11361,10659,86545,108796,7236,100887,121751,3423,70143,77543
11360,8293,84356,111102,4756,119318,133098,3537,54554,77721
11359,0,0,0,0,0,0,0,0,0
11358,12923,70777,94084,9362,81920,104164,3561,47244,60494
11357,14437,82858,106791,10211,91535,116703,4226,53969,75021
11356,7346,64324,85304,5912,66595,90427,1434,33719,51837
11355,28422,45527,66479,20307,50713,70330,8115,25295,45375
11354,20115,45838,67230,12856,52472,74668,7259,26759,51019
11351,0,0,0,0,0,0,0,0,0
11239,6771,29571,43455,3392,32306,55003,3379,21393,31004
11238,25443,100568,136836,11483,132250,168726,13960,85204,104324
11237,17383,57375,76385,8877,47510,63532,8506,70259,84028
11236,34018,74015,89086,25044,86556,98490,8974,36907,54220
11235,32492,56308,83018,20322,72400,101420,12170,31936,49319
11234,32227,84116,109876,24087,97307,120597,8140,43140,70193
11233,31811,48278,71104,18369,51145,76442,13442,38852,59705
11232,8936,74072,98875,5221,65684,92157,3715,72575,99561
11231,15871,108525,169055,9371,139421,202339,6500,68958,113179
11230,31254,57770,85020,20345,69748,103185,10909,27745,48395
11229,31099,66332,89740,21535,84598,105483,9564,32657,50509
11228,15473,76278,103981,11793,88250,113478,3680,37797,58719
11226,37483,60896,80354,22128,66968,89544,15355,45732,61727
11225,24177,65200,91135,12334,72284,100547,11843,53072,74343
11224,19272,35776,59226,12076,44534,73300,7196,15079,33339
11223,27709,56908,84634,20367,69462,96059,7342,23057,44285
11222,17941,96435,122507,7340,100780,136809,10601,90850,109885
11221,33067,65548,88596,17251,70166,89515,15816,56844,81880
11220,27849,55119,75144,19936,52573,72600,7913,41644,61027
11219,23871,41907,64234,18906,43675,65537,4965,29586,50145
11218,25219,78249,105235,16689,85861,119348,8530,62295,72084
11217,18627,122598,182618,8627,149832,237099,10000,94713,131270
11216,25771,77343,108890,11846,88470,125312,13925,66305,88986
11215,28714,144330,197323,16881,178309,242711,11833,96419,114376
11214,31717,57639,81908,22407,66036,91105,9310,35580,52628
11213,26377,48318,74892,14967,55479,86526,11410,38269,55570
11212,31207,29385,48008,15861,44200,63979,15346,15479,28438
11211,40821,90871,128607,21210,67094,124192,19611,106515,129217
11210,21851,70776,97562,15455,82174,110917,6396,43722,57367
11209,29186,79524,108104,16452,106084,133386,12734,53443,72757
11208,34368,45946,64676,24794,53413,71210,9574,26157,38023
11207,34010,42276,59078,20087,52977,67974,13923,22638,40284
11206,31489,43065,70179,18325,39139,61926,13164,49333,77611
11205,16779,62952,104376,8531,61677,117168,8248,63244,86022
11204,23520,54984,75987,18430,62049,82889,5090,26424,44593
11203,29249,57707,76911,19868,73514,88156,9381,32263,45234
11201,29262,139697,198854,13816,188987,264773,15446,109015,137214
11109,2777,169425,195918,1700,204617,239972,1077,107330,122485
11106,16975,71865,98884,7817,77329,107409,9158,64967,88339
11105,15274,86516,107029,8129,92952,116792,7145,73584,91826
11104,11281,75772,94487,5656,90561,110995,5625,63459,74901
11103,15575,81677,98170,7417,83517,103627,8158,77589,90249
11102,12960,81462,104415,5678,90231,121484,7282,74301,87553
11101,14951,89525,123847,7187,105240,145106,7764,73448,101884
11096,2558,59943,82488,1966,69340,92597,592,24182,35925
11050,11103,134473,210400,8251,173635,248390,2852,63359,96856
11042,0,0,0,0,0,0,0,0,0
11040,13078,132767,163186,11069,144473,176482,2009,52120,76822
11030,6277,210380,340827,5091,"250,000+",396008,1186,68750,100938
11024,1953,124837,200794,1694,131596,210930,259,58274,134464
11023,2964,108906,179424,2400,144038,201175,564,0,82121
11021,7623,106978,166860,4745,152660,214010,2878,60208,88411
11020,1848,160909,210336,1674,162159,212130,174,0,176097
11010,8089,113148,128233,6602,127299,137466,1487,54185,74832
11005,1609,75742,450531,739,179471,907171,870,49500,62649
11004,4808,97845,124334,3215,115378,146489,1593,71683,76606
11003,12270,103548,120800,10134,105987,126168,2136,47008,67229
11001,8733,124949,146902,7066,139874,161769,1667,61525,73795
10998,1081,89871,111532,955,89612,105785,126,53333,66210
10996,966,115587,125932,830,116196,130463,136,0,86881
10994,2619,154970,169947,1938,176754,199517,681,62060,84724
10993,1712,48400,67866,1075,58950,81089,637,33413,35366
10992,3043,97862,110460,2254,111932,129052,789,34250,52356
10990,7785,109684,129003,5651,131518,152996,2134,41864,63275
10989,3534,115000,138464,2458,136935,162954,1076,82500,79017
10988,215,90179,107444,166,113125,124910,49,39821,44686
10987,1376,130167,191883,958,174107,206021,418,66500,154953
10986,550,180875,184493,418,180250,202562,132,0,88061
10985,43,181116,162647,43,181116,162647,0,0,0
10984,910,138188,169572,674,137500,173413,236,0,137897
10983,1846,132400,178863,1478,160200,199917,368,71250,81241
10980,4845,110347,123387,3750,128958,140749,1095,45679,56317
10979,17,0,0,17,0,0,0,0,0
10977,15729,59253,92260,12692,65594,98505,3037,33467,53932
10976,687,62417,105938,409,132375,151146,278,25208,39426
10975,72,0,73786,8,0,0,64,0,69961
10974,1288,88135,118324,803,113906,145249,485,56774,70601
10973,837,93641,129084,670,130000,142763,167,49191,70041
10970,3677,92708,108973,2601,105195,127358,1076,48011,59361
10969,357,122109,141872,296,129167,151117,61,68438,82779
10968,1196,125833,147394,640,147885,179146,556,92105,109111
10965,5462,114595,140428,4106,135135,159531,1356,51484,75190
10964,563,138542,230562,361,219492,317404,202,0,75364
10963,1240,72534,106162,828,95705,100971,412,33415,112968
10962,1883,125288,158187,1379,153307,178888,504,56058,98877
10960,6025,104972,149622,3352,138793,188973,2673,67621,96711
10958,963,108831,110324,703,122747,127615,260,57941,62348
10956,9833,148341,173129,8145,165102,187143,1688,64048,97228
10954,9098,102763,130104,6429,130133,148419,2669,56015,82064
10953,36,0,0,36,0,0,0,0,0
10952,10005,56597,81616,8674,62105,86695,1331,26250,41662
10950,13043,75547,95494,11547,77590,98010,1496,46364,60692
10941,5061,79321,98671,3292,94613,112778,1769,59949,68728
10940,17920,67920,88840,11777,85136,103012,6143,35860,56591
10933,130,102955,99250,130,102955,99250,0,0,0
10932,33,0,0,15,0,0,18,0,0
10931,297,72574,90047,214,80795,105254,83,36908,47180
10930,3128,121310,133524,2403,131118,135391,725,75104,90991
10928,1726,74012,94236,815,98618,114780,911,60797,74594
10927,3608,66214,89444,2642,73232,97105,966,31429,56322
10926,1301,82019,104889,843,93188,118793,458,56991,77061
10925,1540,93659,98407,1029,114343,117935,511,47355,59084
10924,4541,97111,123936,3091,123287,153599,1450,26027,57401
10923,2614,91087,112071,1906,98938,122496,708,59188,70917
10922,663,81375,107148,439,118438,131848,224,51786,58739
10921,1369,95707,110763,985,104696,122218,384,64722,80542
10920,2931,123848,151653,2359,140906,169907,572,50476,70373
10919,497,79642,100462,448,79774,103636,49,0,71441
10918,4303,111163,128176,2916,142655,151395,1387,50677,74849
10917,492,119018,181181,444,138056,193651,48,68864,65829
10916,1346,100556,129529,1149,110054,137057,197,76385,78804
10915,26,0,0,0,0,0,26,0,0
10914,153,0,86301,144,0,86837,9,0,0
10913,1533,171464,193394,1296,182917,208656,237,50781,84535
10911,0,0,0,0,0,0,0,0,0
10910,0,0,0,0,0,0,0,0,0
10901,8722,100781,124034,5915,124456,150177,2807,45981,63817
10805,7990,72856,102512,5010,82500,116131,2980,50000,76606
10804,4881,191394,253155,4085,224792,288062,796,60588,69111
10803,4044,168071,251013,3242,191288,284050,802,63533,113691
10801,15125,68090,100614,9139,88526,122055,5986,34836,64358
10710,9875,85088,107101,6487,109478,130416,3388,41346,56455
10709,3479,135674,168352,2328,191250,214873,1151,52673,72206
10708,9163,108142,190835,5456,154733,259063,3707,78137,86539
10707,3964,113167,160879,2575,156393,208282,1389,46860,70522
10706,3215,148375,217163,2271,201637,270719,944,60000,82869
10705,14593,58683,84705,9224,66715,95634,5369,36154,60568
10704,11696,87397,101070,7825,97511,114089,3871,46140,65163
10703,7460,78457,94962,5188,89948,108511,2272,48276,59817
10701,23636,52657,77004,14870,59161,86580,8766,35423,53831
10607,2360,145667,160887,1678,171250,191833,682,43661,74609
10606,5766,81603,127182,4075,101156,140557,1691,61321,83495
10605,7645,119132,166510,5135,150771,198234,2510,57361,94156
10604,3794,95859,159821,2673,112847,185857,1121,60571,85858
10603,7097,111781,128927,4988,123558,144524,2109,54958,85255
10601,5126,86250,125938,2270,106932,139014,2856,69881,114737
10598,10514,129370,153734,8098,145566,177648,2416,45208,67813
10597,272,242500,270076,229,"250,000+",301905,43,0,0
10596,400,81711,100864,272,95313,110417,128,80395,72320
10595,2347,104112,148181,1585,150785,187009,762,41207,56633
10594,1641,169740,182791,1339,191685,206597,302,72381,72254
10591,9356,98349,147702,5990,124159,179063,3366,65222,89027
10590,2665,139735,198694,2231,158884,215774,434,0,107089
10589,3701,104464,151135,2127,158798,214146,1574,54324,65794
10588,1196,113500,129829,891,114135,139364,305,95878,101974
10583,13947,205564,311238,11009,"250,000+",366252,2938,55397,101120
10580,5992,202588,318770,4394,"250,000+",393256,1598,70500,108409
10579,2871,122868,152422,2246,132757,170265,625,48623,82904
10578,419,"250,000+",229387,372,"250,000+",246460,47,0,94257
10577,841,188685,326943,724,195625,339374,117,0,239124
10576,1808,199559,315237,1602,206908,338055,206,0,133051
10573,12676,91935,139027,9549,102717,156415,3127,44026,74113
10570,4060,156774,198979,3266,181250,228061,794,55833,76645
10567,6473,130442,164871,5320,140567,181344,1153,58523,82135
10566,9679,66067,83892,5876,81495,101890,3803,35689,50970
10562,11688,91901,122801,8049,105770,134730,3639,64495,89058
10560,1692,147632,177313,1218,184151,215602,474,53276,74537
10553,3507,76704,98814,2341,100703,117435,1166,35000,47360
10552,9095,78399,102401,5138,99567,134551,3957,39816,58538
10550,14488,43234,64046,8040,65497,79587,6448,30437,39107
10549,5921,106961,173220,3811,150721,223276,2110,52205,76527
10548,1360,88784,118367,941,128169,146480,419,51068,49626
10547,2735,123438,137879,1990,132414,148187,745,0,107718
10546,373,204583,267357,352,216111,276553,21,0,102433
10545,0,0,0,0,0,0,0,0,0
10543,7272,109907,182293,5331,140490,213025,1941,62608,88967
10541,9086,113833,136810,7279,126602,154049,1807,49250,59814
10538,5861,193085,291256,4384,241875,352917,1477,85631,103607
10537,879,99757,107796,751,108349,107817,128,48281,53568
10536,3544,183793,246529,2940,218802,273402,604,82935,109298
10535,105,142050,159535,105,142050,159535,0,0,0
10533,2393,163859,238039,1848,210588,280765,545,53728,73799
10532,1744,116750,144280,1293,145521,175115,451,27281,55172
10530,5899,99092,141248,3450,158029,182587,2449,66694,80675
10528,4678,125922,207418,3428,144853,248308,1250,67989,89640
10527,278,196458,197365,249,199479,212351,29,66397,68693
10526,708,193482,273431,577,249345,316985,131,53348,80082
10524,1428,121691,148292,1136,127065,157253,292,83864,105802
10523,3083,103903,130024,2205,106913,141820,878,77400,93409
10522,3672,145000,196619,2724,165313,227156,948,56250,104070
10520,4994,113175,157593,3271,166779,198761,1723,63080,78536
10519,83,158565,160840,83,158565,160840,0,0,0
10518,381,139112,235456,273,201198,287289,108,0,104436
10517,163,97375,113150,120,113750,127938,43,52375,56126
10516,2193,113494,151301,1463,140924,180353,730,62143,89441
10514,4190,"250,000+",328379,3688,"250,000+",352204,502,96250,147667
10512,9460,94985,120572,6434,118468,142625,3026,53668,70249
10511,769,111313,142140,595,114750,152084,174,65750,105322
10510,3664,177143,271732,3027,198194,307640,637,34323,100770
10509,7070,108372,130893,5476,119748,144340,1594,49118,80034
10507,2140,79471,161886,1692,80000,185071,448,0,69984
10506,1920,186000,326962,1417,"250,000+",383209,503,151107,163484
10505,520,112143,211354,413,163068,255895,107,24107,39433
10504,2755,214414,327734,2278,232241,363711,477,75781,154494
10503,67,0,176757,21,0,0,46,0,204750
10502,1897,199904,238206,1549,249489,271646,348,76591,83130
10501,424,"250,000+",224137,324,"250,000+",247441,100,0,140462
10475,18653,53819,63862,10990,66083,74101,7663,36244,45032
10474,3506,28419,43048,2519,30470,44716,987,16706,26951
10473,21940,47856,66325,14667,55852,73634,7273,28028,42590
10472,22221,36038,53992,15768,42237,59879,6453,16103,32298
10471,8714,93657,137185,4823,114201,180202,3891,65042,80515
10470,6096,64643,84976,3558,81010,99759,2538,48269,59321
10469,22886,67190,85371,17128,75789,95243,5758,28125,41663
10468,26917,37777,50877,17754,43708,55827,9163,20047,35428
10467,37713,40639,55988,22853,48322,63717,14860,27500,39234
10466,25009,58405,77651,17729,70105,87143,7280,29096,42934
10465,16122,74889,94444,10758,94520,108487,5364,31658,57390
10464,1874,101935,121430,1196,117083,135362,678,55263,69959
10463,29490,60397,87212,16462,70483,104094,13028,44214,62849
10462,28981,57266,70330,18383,64524,78912,10598,40508,49617
10461,19122,60802,79026,12394,71387,90919,6728,40279,50448
10460,20212,28831,49926,13423,36170,56033,6789,16340,32579
10459,17058,31896,47731,11072,38075,53993,5986,15890,30644
10458,28705,37886,49919,19026,42488,53701,9679,20917,34071
10457,24333,32378,48599,16015,40574,52824,8318,16603,36110
10456,31449,31645,46124,20463,38474,50958,10986,15287,30208
10455,14826,29439,44051,9756,32384,50154,5070,15975,29287
10454,13573,23337,41202,8145,32614,44674,5428,12340,31243
10453,27401,31778,44957,18455,36769,48754,8946,16208,31695
10452,27018,31351,40997,17431,37269,46745,9587,17141,26995
10451,20229,32598,50993,11392,39628,60187,8837,21884,35581
10314,31363,90306,109918,23336,110007,125237,8027,41563,58088
10312,21107,96785,118146,16649,111471,130947,4458,46064,62971
10311,0,0,0,0,0,0,0,0,0
10310,8678,86895,101813,6423,102892,114433,2255,47188,58495
10309,11750,102730,126007,9013,120963,139762,2737,50197,70703
10308,10245,110478,121935,8278,124250,133995,1967,44321,56738
10307,5068,108808,135651,3904,121967,154133,1164,44857,68710
10306,19704,83309,104057,14503,99704,118694,5201,40060,56356
10305,15379,77136,99302,10606,97116,113493,4773,43238,56419
10304,14928,64394,98456,10491,81398,115794,4437,38368,50709
10303,8490,70315,88661,6630,80281,94169,1860,49135,57890
10302,5982,72394,88283,4220,97755,106539,1762,26719,42082
10301,14466,70065,99556,8973,87407,120536,5493,42292,59386
10282,2499,"250,000+",393072,1635,"250,000+",377296,864,"250,000+",397401
10280,4524,170385,251759,2106,206667,305067,2418,131844,204098
10279,40,0,0,0,0,0,40,0,0
10278,0,0,0,0,0,0,0,0,0
10271,0,0,0,0,0,0,0,0,0
10199,0,0,0,0,0,0,0,0,0
10177,0,0,0,0,0,0,0,0,0
10174,0,0,0,0,0,0,0,0,0
10173,0,0,0,0,0,0,0,0,0
10172,0,0,0,0,0,0,0,0,0
10171,0,0,0,0,0,0,0,0,0
10170,0,0,0,0,0,0,0,0,0
10169,0,0,0,0,0,0,0,0,0
10168,0,0,0,0,0,0,0,0,0
10167,0,0,0,0,0,0,0,0,0
10165,0,0,0,0,0,0,0,0,0
10162,622,96555,147342,390,0,167307,232,102955,113780
10154,0,0,0,0,0,0,0,0,0
10153,0,0,0,0,0,0,0,0,0
10152,0,0,0,0,0,0,0,0,0
10128,29698,117926,206466,13515,184922,295939,16183,87377,130758
10119,0,0,0,0,0,0,0,0,0
10115,0,0,0,0,0,0,0,0,0
10112,0,0,0,0,0,0,0,0,0
10111,0,0,0,0,0,0,0,0,0
10110,0,0,0,0,0,0,0,0,0
10103,0,0,0,0,0,0,0,0,0
10075,12075,123854,241307,5264,148750,288623,6811,92476,199567
10069,3106,130556,232218,1757,151005,274801,1349,0,176163
10065,15708,153002,264139,6518,249461,379807,9190,119755,177605
10044,5047,112658,150655,2735,139272,177657,2312,95250,118205
10040,16100,53199,72654,9211,64375,83327,6889,39948,54275
10039,11490,41363,60694,6157,40125,57569,5333,41925,62325
10038,10800,95640,155311,4735,94174,168092,6065,87481,143080
10037,9797,50686,69346,3947,57520,73335,5850,40086,66372
10036,17437,97720,139050,4708,131630,191955,12729,95263,118812
10035,14740,28408,58682,6473,41163,72573,8267,15947,43260
10034,15774,63556,78544,9032,63608,82791,6742,53452,67446
10033,19689,66902,85288,11633,70861,91332,8056,56389,69655
10032,21814,53690,75308,10190,56750,87967,11624,43956,58704
10031,21863,55721,81495,10914,55013,85168,10949,51957,74171
10030,12817,45555,77671,6052,55077,92473,6765,33132,61467
10029,31485,33801,71046,16356,37079,85089,15129,26179,53876
10028,24974,131013,225593,10680,236888,357185,14294,96364,127204
10027,23835,57010,95040,11788,62627,111338,12047,49483,75762
10026,15362,64716,109506,7731,78646,132250,7631,49065,83224
10025,40188,99067,176758,19242,136396,242105,20946,70662,113931
10024,28850,137126,267771,14111,228250,392314,14739,94761,143457
10023,33770,137347,226093,13670,212500,327632,20100,103707,156936
10022,17977,138661,257537,7414,"250,000+",387084,10563,102386,165858
10021,22084,130968,237726,10198,241572,374330,11886,85044,120183
10020,0,0,0,0,0,0,0,0,0
10019,27340,101651,177809,8366,182763,293375,18974,77233,126109
10018,4321,136360,187702,1457,208894,251035,2864,118550,155347
10017,9858,130417,184005,3038,201667,300843,6820,99414,131657
10016,29005,124647,181643,8281,208517,292622,20724,102323,135567
10014,17139,136154,217624,4931,223083,349165,12208,114630,163594
10013,12294,130675,294915,6280,181888,362702,6014,102967,223046
10012,12574,110490,180973,3928,152500,248168,8646,94079,149244
10011,28775,136208,210553,8504,218085,332295,20271,107659,156441
10010,16499,139188,214151,6706,206823,313086,9793,97251,145806
10009,29356,68220,108017,10367,83188,139620,18989,64391,88952
10007,2940,"250,000+",409624,1633,"250,000+",542302,1307,169567,243852
10006,1811,185268,226459,736,246167,300137,1075,157668,176015
10005,4649,184681,218441,1260,"250,000+",316427,3389,174408,181456
10004,1822,204949,325028,787,207272,409237,1035,159482,260162
10003,25158,129981,211756,7623,205083,334039,17535,98435,157919
10002,33790,35607,70204,16656,37313,72428,17134,31832,67190
10001,13311,96787,166167,4112,134134,240214,9199,86899,132472
8904,6034,83980,110890,3459,111377,132619,2575,62328,80059
8902,14640,97914,121684,10546,113240,141687,4094,56509,68616
8901,15546,43930,64527,8972,48452,69259,6574,33163,52823
8890,9,0,0,9,0,0,0,0,0
8889,4428,110194,151935,2962,148750,194101,1466,55738,64524
8887,546,99464,113271,319,99673,115600,227,88542,109225
8886,2504,125288,132672,2119,136956,145041,385,49712,61376
8884,3150,85703,97243,2267,109698,119527,883,30990,39205
8882,5883,77183,93674,4058,91929,110305,1825,41411,51702
8880,1646,86667,97795,1136,93100,109409,510,54074,68611
8879,9086,76007,93435,6397,87415,103927,2689,50694,63401
8876,8479,103678,131487,5479,119382,143318,3000,60633,105084
8873,20785,92063,117076,13620,111599,136761,7165,59529,77253
8872,7541,75499,91490,5141,90177,108626,2400,41470,53447
8869,3005,82471,116775,1910,97121,120276,1095,54882,109342
8867,1876,151940,171460,1659,161406,182491,217,72708,72145
8865,12227,69154,81925,7632,85980,96432,4595,40596,53624
8863,4245,101206,112841,3155,112546,122448,1090,58438,80033
8861,17576,54771,69262,13231,53005,70189,4345,35818,51573
8859,8362,90140,107477,5737,104985,120159,2625,59645,75852
8858,35,0,0,35,0,0,0,0,0
8857,15326,92255,114264,10489,120050,136993,4837,50894,62325
8854,15899,106498,121948,12227,122202,135053,3672,52583,70046
8853,1885,185208,186262,1407,195110,206771,478,63472,125478
8852,6639,104227,135465,4876,115192,153100,1763,82521,84175
8850,2983,109531,124763,2266,125882,137428,717,60801,72365
8848,3215,113813,138892,2576,121750,152145,639,66134,76762
8846,4909,84216,103919,3729,92430,115281,1180,49779,64153
8844,14039,140391,165522,10801,168460,188939,3238,67066,81564
8840,5957,129066,162636,4517,151438,187943,1440,63897,80224
8837,6404,87672,107464,4428,104395,124149,1976,55461,65868
8836,1357,174441,267633,1127,200223,299272,230,0,112601
8835,4007,72615,86645,2524,94444,104763,1483,31750,50210
8833,3293,126858,178274,2473,156103,202639,820,62857,90381
8832,966,68049,66650,748,65694,63865,218,62500,63595
8831,21941,95707,126857,14480,134119,157248,7461,44187,63071
8830,6304,101793,118334,4847,118706,133050,1457,44583,64626
8829,1401,96654,108043,1026,111638,119978,375,70469,67518
8828,915,94116,98022,607,102188,109711,308,55000,71785
8827,1624,108657,137873,1220,125357,162713,404,44000,56298
8826,2042,110730,127571,1380,139100,152736,662,62321,75112
8825,1670,105000,135291,1163,127054,164636,507,44063,65946
8824,4152,154069,173865,3646,166413,185522,506,55698,86885
8823,3454,91528,113099,2188,121574,127111,1266,59884,87737
8822,10847,113352,149988,8167,146135,170446,2680,62944,85687
8821,142,71923,103541,132,75417,98978,10,0,0
8820,12535,131216,159442,10674,147959,173883,1861,55233,72484
8817,15071,92298,107950,11329,103335,117155,3742,55390,75926
8816,16129,123003,149977,12764,146991,170916,3365,50398,65793
8812,4551,103528,139142,3366,118245,148260,1185,67610,108300
8810,2855,128807,151887,2596,143696,159428,259,70129,68147
8809,2069,106935,139734,1318,145000,173883,751,69145,77491
8808,77,75795,62121,33,0,0,44,48125,51984
8807,12996,136314,155555,9884,161100,178524,3112,55530,77164
8805,4176,75058,104005,2967,77948,107576,1209,55295,88398
8804,1067,95313,120438,743,125469,142718,324,0,64515
8802,1482,119052,147658,1252,130000,156187,230,56389,86659
8801,2563,141203,188785,1832,195345,234949,731,63750,71282
8759,19639,42810,62051,8771,72817,85361,10868,26475,42845
8758,3491,78018,100948,2561,88101,111247,930,38581,49543
8757,17031,46274,66947,8704,64961,84405,8327,28741,46941
8755,10224,70419,100547,6250,97486,122374,3974,34394,62070
8753,24019,84533,103940,16136,107111,121293,7883,45229,64240
8752,1248,60700,105065,578,92500,151467,670,51134,63711
8751,2047,57238,85770,1023,80707,103957,1024,45208,67463
8750,1358,127333,201919,966,164706,240462,392,70648,104934
8742,10085,100394,129230,6781,112468,147362,3304,69400,88431
8741,1019,110903,119592,797,117771,131266,222,52639,69041
8740,680,53947,66285,345,58068,70737,335,41488,61607
8738,694,120000,205039,495,146691,215378,199,68558,176582
8736,5188,135946,167153,3701,162083,193528,1487,49527,99869
8735,2220,69200,108795,1269,115720,146907,951,41730,57691
8734,3082,99357,117936,2348,102023,130168,734,51850,67683
8733,1017,70378,81035,750,72350,88000,267,34188,49048
8732,655,92434,111445,378,117692,133522,277,71458,76858
8731,7963,81650,100942,5234,100462,116507,2729,49370,68522
8730,1690,148788,178465,1270,171964,192290,420,51989,136661
8724,16716,77882,104006,10721,105499,127594,5995,44314,57898
8723,12933,84484,98394,8423,102392,116513,4510,49201,59920
8722,3992,81658,99389,3094,87125,100887,898,51859,86916
8721,7706,92387,112308,5537,107521,122642,2169,52254,76822
8720,270,131983,147109,217,160375,167362,53,0,64189
8701,24079,52530,77633,18113,57343,81015,5966,31720,60186
8691,6336,137347,155354,4470,168125,190841,1866,57598,67317
8690,6749,103350,118863,4933,119042,136525,1816,54056,67384
8648,11678,108772,131019,7477,126769,159432,4201,67863,79002
8641,1140,75543,84116,974,76727,84046,166,61286,82973
8640,1065,85296,87042,858,90365,89312,207,59125,74280
8638,8081,57064,72035,4618,71418,88075,3463,35492,47592
8629,4087,72258,98954,3255,71492,74860,832,42000,49143
8628,4133,83208,99491,2137,121953,123434,1996,61235,72172
8620,3945,97250,112862,2820,119800,130673,1125,44934,58261
8619,9031,83589,99047,6003,100231,112566,3028,54804,69433
8618,12788,38591,61518,6904,62419,80151,5884,23789,37204
8611,9289,39958,57559,5615,51551,65789,3674,24156,40546
8610,11024,71388,83007,7429,79911,92426,3595,48444,54828
8609,4216,39467,100678,2460,45000,140037,1756,23019,31673
8608,481,16991,35446,180,0,62778,301,11058,18903
8562,1747,71926,88226,1299,85329,102014,448,39853,44418
8561,172,0,105660,154,0,111085,18,0,0
8560,1545,108668,143882,1050,133125,176108,495,37356,56832
8559,2166,133580,193799,1569,155224,230062,597,67574,96927
8558,2549,206287,241894,2056,241071,286113,493,46250,55848
8555,288,110625,119889,243,114554,129876,45,51250,65960
8554,1625,89886,108043,1012,106000,119427,613,55574,85664
8553,234,111346,186856,159,125417,214211,75,68365,101685
8551,1979,141536,181795,1594,159853,203924,385,61250,87056
8550,6620,191208,235100,5506,207962,262159,1114,67500,99171
8542,1500,87826,131903,722,111023,163241,778,81419,102554
8540,18143,154859,206413,13140,191000,247670,5003,58003,84694
8536,7742,113609,151724,5230,146469,186167,2512,79600,79612
8535,1564,185750,232801,1356,198707,255931,208,0,75956
8534,4781,133818,170536,3496,159227,199905,1285,55383,84550
8533,2597,93341,113903,1873,121103,129921,724,32065,69994
8530,2958,108963,161712,1800,132963,166071,1158,81250,153508
8528,50,0,164944,32,0,0,18,0,0
8527,20187,98606,111308,15254,112050,126715,4933,44019,58266
8525,1872,127885,159197,1382,150726,179547,490,82938,98193
8520,9280,100288,123113,7057,116526,140933,2223,39375,56645
8518,2206,83819,100867,1454,97022,116060,752,48106,62889
8515,1675,149967,167421,1532,152321,170935,143,56106,85673
8514,2023,103427,173513,1287,165545,217241,736,58447,96357
8512,4264,113116,144370,3090,128280,173307,1174,41638,61334
8511,472,77708,96511,352,107188,111463,120,0,49848
8510,1898,167037,203598,1684,180431,221519,214,48800,61363
8505,6729,95776,116164,4537,112199,130567,2192,68564,82129
8502,3654,201984,238226,3264,222619,254595,390,86875,97957
8501,2405,115521,149685,1968,142786,166869,437,50673,69950
8406,4655,55681,84107,2614,74590,109202,2041,35804,50569
8403,475,110972,205944,314,150227,245848,161,49688,126024
8402,2877,101354,141796,1846,132500,179650,1031,49736,73499
8401,15775,29526,48100,8396,36066,56579,7379,20927,35850
8361,6392,85335,100733,4636,99598,115996,1756,38995,54424
8360,15066,52826,67262,10165,58544,76409,4901,31588,42269
8353,135,59931,82816,100,80500,93080,35,58281,48591
8352,219,0,66613,184,0,72303,35,0,0
8350,182,0,105443,142,167759,119973,40,63462,48123
8349,809,50363,58492,576,59286,64661,233,35764,38959
8348,53,84934,96579,53,84934,96579,0,0,0
8346,252,82746,69412,195,83422,78464,57,0,38442
8345,283,54886,64729,175,75034,84190,108,19000,32550
8344,1761,64306,84433,1094,82976,97766,667,49017,62204
8343,1587,101573,121555,1275,123250,138023,312,34375,45999
8341,915,0,96351,633,105592,122870,282,21136,30117
8340,485,61140,75500,318,75583,91313,167,33719,36746
8332,14107,62027,95359,9236,70912,108448,4871,33389,64523
8330,10681,70571,91978,6981,89944,106541,3700,40859,60312
8329,141,69125,63133,116,69500,67708,25,0,0
8328,657,66094,71187,492,75571,73768,165,58365,61347
8327,192,68816,237640,120,0,348393,72,0,51849
8326,482,61415,79542,349,84107,90697,133,33854,38747
8324,128,73621,108223,117,0,111183,11,0,0
8323,200,79750,100662,148,96250,112687,52,53750,58475
8322,3433,89570,103003,2783,96648,106412,650,41310,80900
8321,71,28036,38268,23,34107,57561,48,22188,29025
8320,0,0,0,0,0,0,0,0,0
8319,420,99868,108230,361,113188,116319,59,0,49392
8318,4724,74052,94814,3405,101815,109852,1319,38977,51408
8317,642,84432,95577,436,102561,111395,206,67756,61608
8316,68,0,41121,29,0,0,39,31397,34033
8314,146,133269,98656,131,134712,107479,15,0,0
8312,2971,85250,99096,2233,103613,117338,738,37035,39613
8311,585,60563,70992,398,77857,72750,187,20139,52347
8310,665,44639,56313,423,60563,66202,242,34628,38206
8302,13622,50481,70553,9267,61585,79160,4355,27298,45596
8270,3111,74776,86001,2234,93220,98852,877,27037,46096
8260,6251,55551,91516,3795,72758,117127,2456,37075,48448
8251,4555,60191,79265,3269,66472,84108,1286,41923,50018
8248,20,0,0,11,0,0,9,0,0
8247,506,113333,167108,321,164688,207727,185,55893,94563
8246,32,0,0,32,0,0,0,0,0
8244,4460,62241,80816,2855,77299,92769,1605,36550,56934
8243,1105,76875,113789,713,107153,139716,392,45917,66179
8242,1340,79250,87172,785,80634,105321,555,67230,59415
8241,442,140357,187261,360,155000,214251,82,50278,68770
8240,0,0,0,0,0,0,0,0,0
8234,14263,81448,98608,10751,96323,109770,3512,42613,59262
8232,6232,42009,61975,4298,46667,66265,1934,21708,41710
8230,1966,95444,125441,1574,111500,139428,392,55227,59206
8226,5203,87060,121130,3072,112857,149719,2131,44190,79559
8225,2903,84018,115782,2105,103410,135441,798,48167,59380
8224,142,84500,109780,113,112639,118738,29,0,73714
8223,1875,83750,104074,1420,109500,116965,455,38125,52538
8221,2523,116058,161127,1919,136767,186959,604,44918,75716
8217,0,0,0,0,0,0,0,0,0
8215,5163,71497,93994,3643,79856,97461,1520,41576,71902
8212,93,71902,95076,40,94000,126073,53,70489,71683
8210,6614,75880,92326,4600,88547,106918,2014,43900,53657
8205,10208,72004,88828,6594,84506,102706,3614,48817,61024
8204,7461,71695,91117,4894,90207,111514,2567,31149,49539
8203,4151,75329,104376,2525,98114,129486,1626,36786,58768
8202,812,110769,182563,555,135822,222046,257,80117,95067
8201,3752,62269,95363,2869,65795,103820,883,47188,63131
8110,5868,66371,76001,4488,73549,85639,1380,25556,36268
8109,8359,68755,80315,5842,77791,90816,2517,40928,50152
8108,7951,94851,111237,4536,120187,134695,3415,55979,78558
8107,5476,60842,82368,3197,80810,103180,2279,33814,49255
8106,3878,82500,95764,2335,104158,115808,1543,42201,56745
8105,8366,34722,49563,6055,37783,52945,2311,15544,29741
8104,8832,26784,40288,5783,28475,45419,3049,16230,25070
8103,4932,27342,43492,2723,30903,47660,2209,21102,36467
8102,2687,22212,33142,1596,22888,39754,1091,20685,21173
8098,3428,95357,120294,2332,121587,145657,1096,46111,60927
8097,1146,93269,105143,864,98571,112687,282,51765,68644
8096,13638,78399,96742,8769,100313,114743,4869,44962,59192
8095,7,0,0,7,0,0,0,0,0
8094,15072,82420,100348,10159,108297,120738,4913,40947,51137
8093,3753,59328,84736,2053,81311,113869,1700,32043,46291
8092,1275,71518,96126,889,91691,116550,386,32143,45512
8091,2068,75985,98450,1382,84200,114825,686,32359,55254
8090,2911,98701,109317,2313,104644,117441,598,64611,72668
8089,1486,81850,101558,1157,97656,114587,329,31094,43626
8088,9440,87216,107378,6563,103933,127595,2877,41994,57417
8087,10617,66765,82939,7093,76160,92177,3524,46899,62201
8086,3197,71875,89720,1831,92989,105949,1366,46875,65915
8085,6911,121645,136129,5684,130123,143364,1227,73239,85133
8084,2724,78309,98047,1897,105703,120391,827,37284,43157
8083,3935,74798,89647,2837,86821,101620,1098,41094,52527
8081,16793,87407,104760,12763,103203,116320,4030,52993,59394
8080,13425,107566,127108,10309,121186,143798,3116,53506,64367
8079,4018,42077,67275,2444,60750,82313,1574,24620,41181
8078,3123,71495,83081,1998,88214,95745,1125,49635,54358
8077,6837,113281,129392,5348,124714,141559,1489,71563,78871
8075,11098,75938,95800,7587,91614,109540,3511,46997,60537
8074,0,0,0,0,0,0,0,0,0
8073,40,0,181395,40,126563,121955,0,0,0
8072,107,73882,83536,60,137900,116360,47,0,41632
8071,3684,81448,92980,2425,105366,112876,1259,39474,52382
8070,5129,67906,81492,3117,85099,102098,2012,33704,45816
8069,4763,51964,61786,2731,63586,70984,2032,31250,47760
8068,2838,62091,81927,1847,78958,99060,991,44442,46932
8067,582,93889,103439,444,105500,113827,138,49722,63086
8066,3839,50477,71851,1890,73380,98896,1949,33726,42687
8065,2761,73212,88124,1795,75931,91671,966,61063,69028
8064,22,0,0,6,0,0,16,0,0
8063,1055,65720,85243,804,70893,92052,251,40972,47104
8062,5467,140250,163201,4400,159911,182475,1067,52375,69873
8061,893,152083,151096,791,164018,158027,102,84444,97348
8060,9088,93377,109619,6303,107321,129078,2785,51020,59690
8059,2153,81168,86007,1347,90286,99147,806,48511,51314
8057,7215,155780,216990,5700,178977,252614,1515,51162,76230
8056,1539,145039,161309,1359,154453,172748,180,48594,56979
8055,9895,132732,158477,7959,149341,177956,1936,59528,76561
8054,17494,97536,128800,11393,116369,151344,6101,62109,83611
8053,18109,99454,124618,11954,125566,149444,6155,58545,73501
8052,8332,64666,78331,4348,80726,94594,3984,48047,57737
8051,4104,87986,113785,2697,96815,135567,1407,58897,60201
8050,10190,88826,107802,7069,100496,122464,3121,58097,69198
8049,2063,69508,76219,1149,78944,84237,914,56611,59743
8048,4735,106581,130724,3306,138824,155131,1429,47452,72731
8046,10784,79653,91810,8300,86341,97595,2484,49831,58245
8045,1162,69333,84315,676,99337,119270,486,19643,32321
8043,11035,100075,148353,7627,131052,186308,3408,46161,61352
8042,112,141146,139729,34,0,156494,78,0,0
8041,320,122125,143833,240,149348,176842,80,23125,44805
8039,44,0,68791,31,0,50777,13,0,0
8038,92,0,67098,47,101065,100864,45,26442,31831
8037,8453,73031,89784,5662,86408,102420,2791,37382,59728
8036,2313,109523,151497,1889,117301,170488,424,53750,54084
8035,3199,96250,119009,2073,124948,146922,1126,53214,65326
8034,7233,95248,114885,4776,108393,134959,2457,60238,73241
8033,6003,128134,178029,4173,167431,224616,1830,48986,68654
8031,4491,60041,71368,2839,65986,80031,1652,40678,49504
8030,5162,57866,66120,3246,71944,78790,1916,26071,37845
8029,2050,74348,79567,1288,92800,99780,762,24731,44548
8028,6696,75189,87171,4443,87455,99106,2253,46910,62044
8027,1895,76648,86819,1323,86940,98926,572,44583,52003
8026,757,83073,98086,588,95682,108113,169,55625,61986
8023,128,32197,54159,79,0,61756,49,40234,41912
8022,3729,97008,131602,2586,130391,164449,1143,42102,53431
8021,18973,55474,70557,10453,72930,90009,8520,34903,43164
8020,1208,0,89164,1059,0,93079,149,0,61342
8019,451,127917,132277,364,148333,142971,87,57361,86548
8016,12742,77442,101712,8504,96490,122812,4238,45169,56058
8015,7173,67565,87002,4929,80864,98077,2244,47643,49338
8014,124,105208,109147,124,105208,104028,0,0,0
8012,14625,79948,95210,9844,94686,110889,4781,49550,56818
8011,0,0,0,0,0,0,0,0,0
8010,4244,64071,87626,2738,91311,101330,1506,43339,58773
8009,4882,87704,96518,3280,97459,111131,1602,38013,60634
8008,3356,91483,142268,2180,111694,167577,1176,51389,94410
8007,2106,79125,82498,1248,99121,104702,858,33047,49902
8006,189,75972,94113,137,112708,117036,52,27083,33719
8005,9660,78389,94030,7112,87196,103851,2548,44848,64337
8004,4072,86607,107889,2900,103188,119856,1172,58849,75532
8003,10884,132441,162489,8846,152968,179829,2038,51809,83466
8002,8684,85291,109609,5604,101207,128088,3080,46102,73168
8001,281,73398,94498,193,114408,115129,88,0,49250
7981,3701,120870,143787,2447,140868,173436,1254,64545,84256
7980,899,124590,158822,712,132075,188270,187,0,46696
7979,171,134236,139268,148,137568,138881,23,0,0
7977,206,88421,144723,190,89474,152469,16,46000,52731
7976,253,89784,143896,208,93523,156665,45,0,0
7974,4511,152154,203215,3400,184303,236909,1111,81188,93386
7970,40,0,0,40,0,0,0,0,0
7961,0,0,0,0,0,0,0,0,0
7960,17712,136250,189226,11296,169583,227815,6416,86447,118130
7950,7468,128121,149739,4781,155806,176627,2687,84427,96270
7946,1133,153583,218397,976,188553,236765,157,54821,102157
7945,3240,191071,265627,2584,223333,309641,656,84659,90043
7940,5755,157577,216297,3933,190273,269047,1822,77754,98876
7939,43,43365,36514,0,0,0,43,43365,36514
7936,3765,127977,155638,3075,138505,167914,690,69286,96834
7935,106,191750,336178,76,"250,000+",426730,30,0,106777
7934,497,157750,225765,383,172250,261842,114,27000,74479
7933,989,150404,183242,762,166827,207416,227,57891,74230
7932,4228,120550,151840,2597,152958,198642,1631,46318,76324
7931,1047,137472,283465,866,154167,306097,181,0,172773
7930,2896,164186,206563,2347,176250,221420,549,0,137561
7928,6304,201123,284554,4801,"250,000+",338028,1503,73125,105514
7927,1720,129000,149852,1154,133261,157559,566,126719,134140
7926,20,0,0,9,0,0,11,0,0
7924,2505,161989,246828,2029,186928,280894,476,66176,82803
7922,4101,178563,236191,3510,205086,257905,591,74375,104378
7921,3870,114924,151661,1664,156832,206765,2206,89444,109835
7920,9811,151954,219603,7190,205310,260186,2621,74395,107327
7901,8409,142909,243821,5993,214156,304515,2416,77045,91022
7885,3947,82301,103889,2636,84754,108705,1311,71528,81645
7882,5769,81566,103959,3730,111576,124928,2039,52710,63099
7881,4,0,0,4,0,0,0,0,0
7880,64,123462,121338,48,0,0,16,0,0
7878,244,95147,110376,159,89120,117670,85,96544,96733
7876,3307,140994,157323,2807,148923,167420,500,75625,84464
7874,3021,100546,113754,2421,114375,121051,600,70461,75347
7871,7167,137658,163995,5730,154848,183181,1437,72454,83553
7870,8,0,0,8,0,0,0,0,0
7869,9024,145532,178821,7008,183304,206886,2016,66272,77591
7866,8324,115263,137400,5981,137549,161076,2343,53431,72733
7865,651,133490,124641,593,135128,119502,58,133229,122607
7863,1482,83879,100056,1080,93269,107260,402,41250,68605
7860,9801,92085,121143,6804,114672,143757,2997,47567,62353
7857,1638,71250,90196,779,94531,100760,859,45688,74218
7856,1837,96444,121100,1037,111959,153454,800,75120,79161
7853,4272,166276,191896,3669,186157,208285,603,69896,87460
7852,1577,92750,112261,1056,111667,133595,521,50673,64149
7851,62,89015,97105,48,89167,109840,14,0,53436
7850,2429,89395,108406,1980,94455,118460,449,46186,58471
7849,3630,101538,119197,2665,125536,140451,965,51801,60010
7848,1635,89934,129194,1218,115769,149393,417,50972,67899
7847,848,68580,91273,594,68608,97996,254,68333,75548
7846,12,86875,90542,12,86875,90542,0,0,0
7843,4341,94836,111616,3120,108778,126362,1221,60592,65317
7842,31,0,134555,31,101094,110639,0,0,0
7840,11603,93527,113503,7663,116452,134242,3940,49432,66736
7838,1237,98646,123049,882,115000,143057,355,64766,70977
7836,4117,122861,154974,2999,143615,176438,1118,76643,84506
7834,6820,143481,164831,4918,165698,195383,1902,68067,84017
7833,59,51445,89949,31,0,105061,28,0,0
7832,1249,96932,124804,995,107699,133863,254,49938,89220
7830,2721,134750,155640,2350,153413,167805,371,50043,73155
7828,5992,79943,112598,4160,91953,128926,1832,55690,65827
7827,1696,79828,93456,1008,92419,115784,688,41410,60628
7826,2236,93462,113794,1649,106031,127209,587,50707,72640
7825,3420,102823,117553,2637,114450,132857,783,55199,61656
7823,3704,66543,78207,2203,85524,97412,1501,28642,47864
7822,344,84677,102950,312,84274,98501,32,0,0
7821,3434,113352,127804,2466,120625,139888,968,69375,91660
7820,0,0,0,0,0,0,0,0,0
7803,1269,95516,117315,932,95473,113648,337,62625,96648
7801,8472,70287,90305,6137,74591,102376,2335,32736,46594
7764,2692,102037,126578,1834,136471,150941,858,38320,72515
7762,3964,84800,134949,2004,133571,181326,1960,56293,87038
7760,2960,177255,314832,2220,231875,382615,740,69565,107304
7758,1609,83250,115877,1218,99306,130976,391,27470,59393
7757,2258,105038,136979,1542,146563,172356,716,57400,57721
7756,1871,64290,118324,854,83333,176399,1017,55213,66772
7755,2033,101354,131765,1619,114676,146492,414,41667,60172
7753,16009,80078,98718,8792,105161,123824,7217,55602,64424
7751,6595,149223,182960,5328,169615,196723,1267,95787,122407
7750,1485,111415,187320,951,159375,244505,534,56979,85479
7748,9584,123130,153753,7518,137394,169202,2066,60697,91937
7747,12235,109489,128359,8437,124169,150395,3798,58929,76192
7746,5808,166725,205665,5116,186536,222332,692,56750,79789
7740,12153,62224,80808,7527,66100,86543,4626,43978,63583
7739,2064,202875,268528,1668,205625,296460,396,0,141214
7738,2223,156164,179332,1890,166217,200151,333,26723,40270
7737,1422,114597,135565,1073,136683,152419,349,60529,76635
7735,7567,83466,98555,4899,112048,120186,2668,54324,56227
7734,4844,76747,88845,3359,88569,101822,1485,33858,48968
7733,5975,141115,207324,4845,173517,238676,1130,42992,68797
7732,2688,76316,111129,1158,138226,162882,1530,65223,65333
7731,12737,115403,128279,10308,125274,136795,2429,51276,81824
7730,6260,104186,116778,4444,125404,136376,1816,41500,65466
7728,20180,93395,126807,13959,131231,154169,6221,41815,60967
7727,2255,87253,119398,1736,113000,136921,519,48785,58903
7726,15792,127460,158517,11887,161107,187846,3905,45186,66378
7724,8733,86953,118053,5335,116310,145801,3398,57917,70713
7723,284,66500,153902,166,111250,234363,118,19545,40711
7722,3451,175114,227846,2904,197786,232085,547,52293,202915
7721,1258,103438,116102,719,116276,136913,539,68583,85599
7720,1934,78452,125402,804,74904,171857,1130,85938,91308
7719,8742,95709,121490,5211,118527,145079,3531,63281,81361
7718,2471,138750,143717,1914,138382,149676,557,101042,116738
7717,876,89615,153047,440,119821,224364,436,64038,80916
7716,3593,102446,136075,2030,110833,166840,1563,61813,90009
7712,16623,75025,107405,9267,106356,134337,7356,45747,71032
7711,574,105455,188648,392,161528,226056,182,61500,103407
7704,1887,184201,278441,1551,201016,283408,336,122008,251805
7703,46,0,0,33,0,0,13,0,0
7702,1374,142870,196357,1127,159922,220649,247,60729,83706
7701,10559,95419,141420,6118,122500,160119,4441,56583,112777
7677,1890,197632,229801,1629,203452,247581,261,63938,115727
7676,3334,141000,171224,2583,151188,189356,751,65573,103919
7675,9697,146866,182843,7460,164577,207562,2237,69954,95472
7670,4670,180601,240978,3989,205972,264846,681,87404,95503
7666,13164,113934,152341,9961,143819,179673,3203,47083,60490
7663,5184,107511,113316,3590,118973,129121,1594,51938,68806
7662,2139,87171,125337,1455,126339,148747,684,52432,70797
7661,4119,128231,169764,3324,166875,194546,795,46356,66092
7660,4795,81908,104878,3214,104659,122273,1581,46287,64396
7657,3865,79696,110113,2937,97210,120361,928,43143,66171
7656,3315,143147,164821,2410,183071,202310,905,43015,63439
7652,8334,130273,153500,6658,141619,172589,1676,48868,76980
7650,7291,79063,99747,5568,89375,108618,1723,36964,59489
7649,2672,144474,184068,2197,180066,206940,475,71927,74843
7648,1945,131563,159043,1448,156471,194980,497,29375,46191
7647,1806,105326,154443,1543,115054,168187,263,45703,61786
7646,5886,94821,124029,4281,124155,144845,1605,49458,66041
7645,2902,156042,184907,2446,157153,193774,456,39091,115276
7644,8825,64249,93061,5883,75606,106997,2942,48958,57701
7643,4106,69224,92164,2864,83673,97265,1242,47262,76208
7642,3454,155742,172766,2842,175541,193003,612,54000,75000
7641,1084,181500,215436,970,199750,228305,114,73833,101487
7640,1746,135750,198710,1446,163750,228094,300,0,51653
7632,1906,158042,242530,1631,172969,263780,275,0,116044
7631,11064,86485,140046,7709,96467,150033,3355,67892,111539
7630,2639,129289,148307,2270,140326,162190,369,32235,57818
7628,6558,107172,130672,4804,119213,149820,1754,52625,76262
7627,1672,153558,239096,1437,169361,261519,235,69875,92751
7626,2917,141706,183753,2412,159274,202573,505,0,93864
7624,2632,143947,193718,2258,166934,211568,374,60167,79086
7621,9037,102724,116073,6672,115333,131909,2365,54974,64515
7620,518,161346,282821,442,163529,304337,76,0,153270
7608,36,0,64097,20,0,85490,16,0,37356
7607,3717,98511,124982,2570,120735,137948,1147,43281,94409
7606,803,85703,102516,666,95417,106490,137,44821,63783
7605,3344,96468,142178,2423,121793,168925,921,37533,68374
7604,4250,95784,119522,3025,106717,138606,1225,41211,67678
7603,2883,99107,108858,2180,95833,113212,703,60362,66711
7601,19537,71079,87605,9865,76563,97547,9672,57736,73540
7524,4196,42601,66514,3292,44581,71527,904,16821,34206
7522,6396,39974,52814,5063,39258,51413,1333,25552,34922
7514,6080,48921,58861,4340,49398,60942,1740,42000,45086
7513,3138,53043,69493,2733,52699,69057,405,38159,45330
7512,3692,96750,122166,2966,103731,128838,726,53636,90209
7508,7478,80364,106833,5967,90179,117596,1511,36354,54636
7506,7138,103586,124893,5016,118095,145827,2122,56775,67604
7505,1111,16821,26817,536,19355,31842,575,11726,19120
7504,3779,60636,75585,3003,65128,80431,776,43725,47573
7503,5476,52286,72279,3805,62738,82121,1671,34297,40195
7502,4412,50871,70751,3672,56079,75064,740,28574,36962
7501,11039,35396,50891,7224,43986,57663,3815,17109,32692
7495,0,0,0,0,0,0,0,0,0
7481,5808,162095,226921,4619,198365,263808,1189,60184,80414
7480,6018,95714,114955,4224,121250,135299,1794,50109,64555
7470,18670,127680,157096,13697,153741,183038,4973,60846,80626
7465,2585,96757,121845,1764,118333,145724,821,66058,69579
7463,3399,127574,143420,2754,142731,158134,645,59659,78722
7462,2649,81741,101555,1645,95020,117386,1004,63333,72614
7461,6782,89356,99378,4839,102453,113919,1943,45511,59825
7460,1288,107115,123559,832,145278,143435,456,85970,78367
7458,3867,197898,289329,3200,211596,314451,667,108271,148980
7457,1853,112688,120657,1063,130625,148267,790,76429,82899
7456,4232,123206,143230,3502,141818,154206,730,61694,87555
7452,3593,178607,223283,3138,206688,246030,455,42022,61217
7450,8441,179958,248848,6719,221378,282735,1722,102941,112085
7446,5346,155846,186841,4102,177409,211088,1244,79107,101858
7444,4814,95500,119295,2621,130766,158310,2193,40625,71194
7442,4216,98348,117435,2964,115109,126547,1252,90213,91775
7440,1583,148185,155142,1307,164083,175062,276,0,48260
7439,801,89536,105887,632,96083,101395,169,66042,108627
7438,4579,121161,129401,3076,134524,157663,1503,60640,70040
7436,4248,140074,157374,3629,151417,169183,619,63813,78154
7435,1144,121721,163274,979,124242,175326,165,53988,89798
7432,2885,121607,144936,1920,141581,162252,965,64083,107180
7430,9788,101405,146566,6448,129387,175541,3340,57413,87394
7424,10559,90903,119417,6924,109611,133615,3635,74529,88184
7423,1438,230682,271848,1190,234297,285141,248,127708,208064
7422,2188,96813,123511,1706,108186,136040,482,73300,73341
7421,2831,110560,135790,2115,126302,147903,716,74342,98106
7420,1888,84636,92256,1158,104722,107191,730,54511,65319
7419,3699,83665,101812,2473,102235,120980,1226,44242,59935
7418,926,170859,169953,669,159679,173329,257,171040,152233
7417,3839,178794,253362,3204,212308,285518,635,0,85086
7416,2543,78072,88183,1350,90915,100629,1193,60365,68944
7410,11488,129965,155712,8964,154100,176600,2524,71474,76122
7407,6933,75779,91742,5120,87206,101736,1813,43854,58821
7405,6703,117077,151725,5032,139318,176665,1671,68672,73384
7403,2897,97674,117650,2017,111907,132718,880,69345,82788
7401,2235,157958,246173,1911,183102,278603,324,18877,40081
7311,301,210625,282874,205,"250,000+",349966,96,156300,139604
7310,6019,149927,174697,2706,183571,214396,3313,121365,140900
7307,15628,66795,87750,9476,77420,96418,6152,50268,69050
7306,20026,62734,79879,12111,69086,85173,7915,44603,67810
7305,23147,61704,87444,15131,71333,93764,8016,44161,69287
7304,15476,52903,77259,10962,58569,85333,4514,30773,50411
7302,23261,144172,183174,10742,191622,237617,12519,114034,134562
7208,11417,50861,70746,7525,55789,81215,3892,34820,45239
7206,8040,46275,60591,6235,43942,60671,1805,24969,39787
7205,7162,78779,98748,5403,91280,106234,1759,42040,65061
7204,5042,80842,98524,3552,87844,110892,1490,54434,61168
7203,7445,65307,83425,5190,68778,89759,2255,40625,59118
7202,13284,52825,67836,9512,62533,73929,3772,36282,42833
7201,8976,49203,61957,6390,51408,64662,2586,27332,39845
7114,3537,24004,42899,1659,47946,62792,1878,13520,25011
7112,9911,36289,55344,5421,47240,65977,4490,30209,39253
7111,20636,44898,59247,11389,54075,69033,9247,32626,42695
7110,11138,97955,123732,7528,128109,148005,3610,64662,69669
7109,12819,73384,90033,8942,83167,98851,3877,48153,58675
7108,9658,26758,43638,5595,31589,49273,4063,20667,31547
7107,13574,37418,51794,8277,50379,63169,5297,21133,28838
7106,11944,40989,58329,8108,48316,63554,3836,30229,42058
7105,17353,45222,60167,12016,46198,60667,5337,35857,52024
7104,18429,40957,57172,11024,51326,65941,7405,27107,39898
7103,12192,34117,48431,7055,43999,57178,5137,18336,31982
7102,5721,28990,49705,1953,46409,73572,3768,17550,36165
7095,7319,94004,103968,5480,105613,115990,1839,50603,63551
7094,7672,125142,138865,5379,139873,155743,2293,71140,89970
7093,23585,64130,84666,15521,62495,85624,8064,54159,74206
7092,2544,124000,161711,1975,171640,188396,569,41732,68327
7090,10177,158491,230689,7818,202474,272856,2359,58672,87789
7088,1114,67604,82191,644,82000,101749,470,45929,55019
7087,25550,49439,69508,16844,53090,73560,8706,34208,52800
7086,6905,100328,143819,3463,138750,175028,3442,86422,110696
7083,19268,97246,115585,14358,107822,127161,4910,60062,75846
7082,1979,91063,147269,1289,145546,190825,690,48932,61580
7081,6797,123212,140489,4998,145024,162675,1799,53453,74307
7080,8198,108244,118940,6634,125298,130994,1564,51136,62763
7079,5201,150469,208149,3596,183492,262045,1605,47629,80370
7078,4186,"250,000+",413088,3810,"250,000+",434671,376,119792,182911
7077,984,95505,102022,715,95953,102881,269,59298,69520
7076,8584,139349,175344,6540,162250,203639,2044,55061,83329
7075,3408,119840,136053,2593,146233,153535,815,69175,77149
7074,836,72000,86451,649,80813,92965,187,38958,56212
7073,4319,76777,92821,2646,97548,109144,1673,40352,60817
7072,2318,103720,116305,1571,122004,130631,747,64821,76556
7071,9043,90181,107299,6174,102537,124993,2869,56468,65896
7070,6835,106817,130170,4819,118893,146245,2016,59417,79480
7069,2117,138808,185636,1638,157987,207917,479,50821,102203
7068,2237,142776,172176,1837,160685,189641,400,66172,91970
7067,6026,108125,123027,4792,121691,135944,1234,61611,67221
7066,6043,106764,131915,4026,132099,158605,2017,66672,76928
7065,11621,77393,98129,7526,94247,117328,4095,47336,57976
7064,1283,106544,106581,1081,119052,114132,202,60427,58656
7063,3902,65320,90461,3044,68929,95136,858,49310,63122
7062,3994,80521,95471,2905,88287,102071,1089,44196,64960
7060,15315,61953,78826,10327,73449,86814,4988,34304,53023
7059,5298,160921,247154,4490,184348,269174,808,73966,109960
7058,2114,153500,164149,1719,162865,173031,395,0,102209
7057,4781,72389,93070,2962,85014,109350,1819,58563,63454
7055,19837,44832,63776,15080,44003,66642,4757,24411,38233
7054,11222,98178,123532,7707,117057,147770,3515,62645,68258
7052,16804,103956,136267,12064,124372,157347,4740,47177,75706
7050,11831,43568,58147,7211,44808,63441,4620,30443,42486
7047,21992,66669,86953,14990,77655,97093,7002,40044,56176
7046,1385,225069,300627,1254,249423,317502,131,0,127207
7045,3549,155565,201678,2802,184718,235355,747,46973,75326
7044,5349,133496,171171,3583,167564,215735,1766,57299,76885
7043,4057,211094,278263,3335,243854,311722,722,101316,111728
7042,10054,114074,164593,6227,141942,194380,3827,73668,111157
7041,2537,160469,213215,1855,218893,258489,682,66905,88582
7040,8110,149182,190383,6205,189223,219956,1905,63322,85650
7039,10280,168120,224785,8453,202672,252095,1827,72695,93210
7036,15503,73885,86389,11096,85238,96417,4407,42539,53315
7035,3850,100248,108673,2630,115156,122857,1220,64702,73726
7034,3750,80370,99062,2443,97078,117344,1307,56141,63076
7033,2727,95590,100247,2048,102183,100970,679,73341,83223
7032,13698,73514,87737,10381,77179,93026,3317,47332,61807
7031,6376,87589,109184,4499,98860,123664,1877,61100,71740
7030,24983,153438,196772,11181,200132,250868,13802,122266,151080
7029,8262,66521,88823,5251,65718,92559,3011,61985,75428
7028,2441,210068,271764,2163,222713,293905,278,71324,96264
7027,1782,90732,113025,1134,116724,130850,648,66818,76373
7026,11670,64236,85469,8421,70906,92400,3249,41880,59131
7024,17396,88457,116328,9954,112464,141772,7442,61150,78942
7023,2604,171023,187945,2166,193092,208296,438,76951,84228
7022,5395,58072,83693,3468,58911,93411,1927,31458,56667
7021,693,215521,305285,551,248393,353203,142,78929,119304
7020,6046,130267,159313,3563,150915,175548,2483,102739,132909
7018,10720,49464,62821,5824,58210,75787,4896,30072,43707
7017,13722,53367,65485,8010,63046,71190,5712,39554,51915
7016,9079,132539,165377,6474,170705,198543,2605,56151,80482
7014,1788,98526,120034,1213,98942,116973,575,89654,125669
7013,10335,99886,119202,6893,119621,136274,3442,55281,80789
7012,4896,89153,104991,3350,107019,122378,1546,56196,66111
7011,12662,62353,82218,9633,75454,88376,3029,26642,51328
7010,10592,83989,113016,6877,91464,118921,3715,58973,95842
7009,4525,146432,166075,3241,168750,199185,1284,54545,78413
7008,8036,76276,84817,5692,80000,93350,2344,52109,58954
7006,9573,130723,173476,6952,154649,198651,2621,64386,98814
7005,5488,104531,138199,3721,129132,163870,1767,54816,79695
7004,2854,95969,133078,2198,120348,151447,656,67613,69324
7003,18732,82114,105513,11992,99882,123848,6740,56742,68736
7002,24784,69511,88541,16243,80661,100116,8541,44489,60438
7001,5145,72203,87666,3468,82500,101987,1677,35461,53880
6907,3229,81275,116385,2112,117500,140284,1117,41563,67259
6906,3476,94271,111450,2578,100568,119838,898,61935,77901
6905,7488,122238,158246,4903,152845,188198,2585,77147,98691
6903,5068,196964,271501,4311,213819,292698,757,75114,138346
6902,27532,83227,121148,16451,86349,132412,11081,68219,97517
6901,4065,68306,105017,1299,90017,134639,2766,55548,90912
6897,5955,204473,277581,4924,232868,310549,1031,71083,111648
6896,3401,135829,196317,2638,161713,226813,763,69609,89488
6890,1679,192443,281565,1224,238125,332264,455,140964,144174
6883,3531,207863,298440,2927,221932,316907,604,109750,199775
6880,10127,217546,322742,7761,"250,000+",373253,2366,82105,148170
6878,2583,"250,000+",362426,2100,"250,000+",388764,483,111750,236998
6877,9250,152760,223052,7137,185313,255390,2113,67346,95354
6870,2712,217778,307142,2050,"250,000+",369571,662,80949,113228
6856,0,0,0,0,0,0,0,0,0
6855,3553,73542,114687,2174,90947,138539,1379,45143,72555
6854,10682,74597,110667,7571,73348,110678,3111,68720,104963
6853,1472,220988,342549,1022,"250,000+",417140,450,60781,172404
6851,10792,93516,129875,6730,121064,156249,4062,62318,81335
6850,7862,101305,140163,4978,118143,164303,2884,74562,96293
6840,6855,200203,335805,5273,"250,000+",397080,1582,84000,128349
6831,5133,205360,341889,4171,219613,377783,962,83162,175596
6830,9438,128377,277546,6302,172143,330671,3136,72963,166324
6825,7294,114464,148198,5410,140733,172678,1884,54813,69342
6824,12173,148231,216226,8962,180278,257353,3211,76656,98223
6820,6945,243750,404109,5793,"250,000+",460023,1152,62857,120137
6812,4693,114583,149471,3865,127658,161114,828,59643,92555
6811,11554,94030,120309,8100,106143,133491,3454,62234,86565
6810,19473,63814,81004,11855,70848,91925,7618,46888,59695
6807,2611,137132,224559,1988,193452,268857,623,68036,80014
6804,6268,114833,148560,4913,128676,166916,1355,63910,78243
6801,7221,94647,116259,5008,117793,134162,2213,43258,68143
6798,4533,100850,129311,2844,112911,159505,1689,67750,76259
6796,480,92212,171434,332,121250,211201,148,68250,82139
6795,5435,72917,105504,3708,104615,123614,1727,45292,61027
6794,396,58553,105074,240,103750,141772,156,43661,48617
6793,523,126125,222470,307,174375,273240,216,67222,140272
6791,2038,110652,129835,1678,120300,137970,360,59800,83953
6790,14344,60841,77184,8773,79814,91487,5571,38367,52374
6787,3072,70674,93551,1978,92950,115435,1094,39025,49535
6786,4076,76250,92995,2524,102071,111430,1552,40208,60432
6785,240,68125,126944,154,46316,159404,86,82596,68817
6784,1605,117474,200958,1081,123542,228607,524,81615,138648
6783,958,107500,160475,534,149375,195064,424,71250,116913
6782,785,98417,101909,510,106757,123753,275,33090,59795
6779,3555,67284,91334,2194,84444,117042,1361,31775,46784
6778,589,74375,100926,417,117698,118235,172,41091,53213
6777,628,114167,172571,398,126087,199518,230,100625,125941
6776,9856,92418,115317,7203,107773,131814,2653,55344,67695
6770,11917,77605,91040,8129,91089,101602,3788,41831,60874
6763,773,80469,110867,490,104265,139295,283,50365,57417
6762,2889,120697,140656,2055,139013,170602,834,39808,60993
6759,2354,95147,125921,1550,116635,154822,804,43667,67645
6758,118,141136,142231,97,140795,140548,21,160536,150005
6757,1037,78697,136727,569,101287,190019,468,53542,70805
6756,968,118452,165466,743,149135,193037,225,54297,64583
6755,321,108516,116847,276,99939,121253,45,0,58958
6754,694,98750,145549,557,108861,154690,137,44375,106142
6752,730,130270,179892,527,131446,176349,203,89297,186152
6751,1342,92237,117347,908,125278,148957,434,31765,43783
6750,472,83167,106783,242,121625,159287,230,26667,51541
6716,6405,96014,108477,4372,113636,131471,2033,40231,55179
6712,3314,107188,118295,2530,124798,135432,784,48516,61460
6710,3403,42514,57968,1946,49951,68842,1457,22566,37450
6708,11453,56658,73786,7266,70814,86299,4187,39288,48551
6706,5151,48174,59373,3456,52378,64398,1695,34173,44378
6705,10469,48417,59632,5737,63414,69879,4732,31958,45377
6704,9868,42218,59936,6441,50111,61465,3427,27460,52422
6702,1779,11663,17928,378,14257,20063,1401,10750,17352
6615,7301,69355,90414,4888,73947,95932,2413,59870,74350
6614,12686,90623,106866,8736,112074,124928,3950,50603,62322
6612,2702,168654,212119,2249,200411,231049,453,66935,104454
6611,11942,129583,153155,9883,143523,167565,2059,49242,79266
6610,8801,47083,63009,5399,57029,73299,3402,33409,39800
6608,4700,37541,60229,3156,42285,72713,1544,16154,29991
6607,2842,44236,49835,2107,45368,51815,735,23144,35140
6606,16421,58541,74199,11220,64008,80166,5201,42935,54768
6605,8968,46764,68418,5297,48319,77563,3671,37014,50908
6604,9903,31787,54428,5090,45977,68174,4813,21556,37700
6525,2935,169155,205541,2460,174464,217169,475,93594,122459
6524,1860,151034,211576,1581,154566,227745,279,75139,107156
6519,5145,34886,58791,3420,38981,55140,1725,22312,58480
6518,6476,82321,103915,3833,110492,130508,2643,47708,61783
6517,5683,85343,116673,3518,104904,140321,2165,46732,72612
6516,19729,64255,78871,12564,75394,91250,7165,41988,53706
6515,6327,55373,83095,3538,73427,94591,2789,43407,65978
6514,9976,73962,88818,6110,94486,104094,3866,54781,62109
6513,15135,42149,56379,8465,49771,63748,6670,31123,44009
6512,11032,64017,83145,6682,83284,98249,4350,46200,55776
6511,20397,46842,73931,9472,53522,96243,10925,34601,51704
6510,1578,73438,108246,367,162063,190916,1211,54153,83109
6498,3491,73631,115795,1967,125758,166720,1524,43929,47831
6492,18375,83054,99611,11485,107059,123017,6890,47040,57998
6489,12538,104923,123823,9153,123851,143383,3385,46637,64054
6488,8019,102128,132278,5201,135366,166147,2818,42274,65987
6484,16516,98873,119386,11109,119036,143780,5407,48807,66087
6483,6297,80396,102851,4023,103945,126703,2274,39556,54992
6482,4186,119967,156182,3240,148833,173020,946,44118,86224
6481,651,73568,90767,301,130821,138586,350,0,49168
6480,3674,97754,120752,2574,121903,142563,1100,47353,62798
6479,4255,94092,112313,2960,115870,133555,1295,50114,55825
6478,4987,106089,127908,3776,112778,140019,1211,70693,89617
6477,5013,129489,155623,4029,146417,172962,984,60750,80007
6475,4218,86802,129250,2717,118060,161890,1501,54153,67660
6473,9287,105576,128260,6652,122391,144008,2635,54095,84747
6472,2514,95455,135768,1991,118482,151187,523,66297,75370
6471,3089,100304,122575,1970,129787,149724,1119,41635,73029
6470,5748,126821,154917,4387,144638,172435,1361,52902,87287
6469,1251,92768,111776,901,107928,134427,350,40735,50546
6468,6653,121847,147619,5150,141831,169098,1503,46838,70550
6467,169,114198,138718,155,113937,128519,14,0,0
6461,5658,110779,128099,4155,128625,147506,1503,54354,70362
6460,16702,90653,121519,9989,113821,146295,6713,58216,82181
6457,19876,62022,87657,10421,85807,114566,9455,42506,55093
6456,122,96000,127594,65,116406,129877,57,0,124993
6455,1191,91384,110999,881,115917,124642,310,75357,70710
6451,10075,58357,76780,6098,74914,92449,3977,40863,47954
6450,15139,58464,76869,8477,78802,93490,6662,46371,52575
6447,2289,113547,140471,1880,130950,152021,409,73016,74691
6444,81,95893,120315,81,95893,120315,0,0,0
6443,6789,119777,162157,5062,143000,190991,1727,52956,73653
6442,927,105917,115231,519,107083,130821,408,97813,95139
6441,2066,106120,126831,1662,112289,141238,404,68333,66118
6438,901,136023,141502,676,150625,165406,225,0,68706
6437,8482,108243,160026,6351,124365,181044,2131,55375,92569
6426,1587,118558,158418,1087,171250,202719,500,48000,60492
6424,4812,95553,112598,3469,113617,130748,1343,45096,54149
6423,2298,96463,124977,1710,104340,131717,588,79625,77652
6422,2932,130635,155510,2262,134712,176668,670,55593,76484
6420,1654,104750,131748,1275,114531,147081,379,66851,78680
6419,2353,104462,129921,1801,133516,151470,552,39479,54898
6418,5794,58365,74613,3296,92446,96835,2498,32684,44173
6417,1987,80495,104669,1246,110179,127541,741,52046,66208
6416,5706,89562,112248,3524,110152,123386,2182,63472,89027
6415,6407,107664,120248,4774,123340,134947,1633,46908,69866
6414,48,201607,192835,33,203194,247718,15,0,0
6413,5293,90427,111214,3638,110563,130584,1655,41114,61751
6412,1724,87717,98289,1034,108649,123738,690,44067,57060
6410,10231,122416,150167,7311,150140,176914,2920,56494,78651
6409,393,68480,94770,156,64250,88206,237,72050,99090
6405,12656,80151,108578,7418,105737,134374,5238,55480,69831
6403,2644,83841,98404,1709,112750,120318,935,26983,55781
6401,8137,53805,68058,4902,72005,82195,3235,32865,42770
6390,24,46250,113454,18,48125,129867,6,0,0
6389,0,0,0,0,0,0,0,0,0
6387,176,92153,87962,128,83200,75752,48,0,0
6385,6533,90342,104517,4297,108341,125019,2236,46250,59517
6384,1134,78500,89393,828,91500,97385,306,64167,65694
6382,3873,78984,98334,2831,91861,112805,1042,45086,50838
6380,1176,43197,61087,625,79063,78867,551,29886,34657
6379,3960,77609,109350,2706,98315,129151,1254,40929,53770
6378,2703,101332,141832,1744,118529,170190,959,61627,87036
6377,1116,86250,84509,921,93450,92047,195,32750,45629
6376,89,0,97629,63,0,117648,26,0,0
6375,1410,92232,110298,1026,96750,118395,384,73500,86581
6374,3273,66999,80201,2110,77371,93926,1163,37796,45807
6373,89,0,85067,51,0,74378,38,122935,94213
6371,4061,106052,193063,2842,140714,243329,1219,44583,63767
6370,2717,90816,102118,2025,101835,111586,692,0,69782
6365,1808,87885,101133,1339,97473,110209,469,47578,69207
6360,15179,58409,76599,9463,67482,89870,5716,37633,47156
6359,2192,61682,88349,1461,82750,103930,731,45234,50806
6357,4649,82940,109272,2842,106394,129332,1807,53018,75616
6355,5465,107481,128155,3676,129868,147954,1789,66741,85814
6354,2143,65247,74135,1641,71386,76781,502,41096,52391
6353,125,0,38596,51,0,0,74,0,0
6351,7041,66723,84277,4663,84311,98289,2378,48571,52664
6350,26,0,46869,13,0,0,13,0,0
6340,12639,65169,81245,7498,66095,92550,5141,53663,60361
6339,3447,91941,113326,2233,104564,133903,1214,62842,71325
6336,37,203646,174651,37,203646,174651,0,0,0
6335,2195,96862,108273,1578,120132,121445,617,56797,70116
6334,950,89722,100305,705,94375,105290,245,65625,74284
6333,2712,123000,138736,1968,145319,159540,744,52308,81551
6332,114,0,70139,72,108214,91472,42,0,0
6331,2121,86178,100687,1518,92421,115984,603,60822,60960
6330,1267,76131,96632,854,96500,113675,413,57891,55213
6320,11001,47482,63880,5880,53960,73789,5121,38531,48726
6282,421,75625,127671,339,91955,145057,82,58600,55795
6281,2900,95926,115297,2123,110053,139271,777,34806,47103
6280,1277,63403,73199,693,60865,77494,584,61118,57679
6279,2692,73264,85640,1338,111111,122865,1354,41036,47144
6278,1865,85817,119092,1236,133400,149763,629,41103,53126
6277,1554,87696,95295,1002,91167,106315,552,0,74053
6269,12,0,0,12,0,0,0,0,0
6268,3606,35732,78429,1228,130000,137723,2378,22259,46504
6266,203,54241,67597,113,69886,82088,90,49167,45972
6264,64,77813,87706,40,79688,95380,24,0,0
6263,114,0,102899,70,93176,123550,44,0,65373
6262,388,48611,63735,227,70156,76174,161,39131,43724
6260,3959,64496,78724,2406,77227,98239,1553,29682,42384
6259,1782,93022,119471,1165,113309,152163,617,44464,57447
6256,876,55379,69538,562,70122,84512,314,44394,42738
6255,1845,69985,85156,1151,93750,95307,694,44274,59904
6254,702,91875,110647,511,116875,133292,191,35625,49545
6250,1999,74115,110501,1322,113219,148998,677,0,31025
6249,2921,97422,114121,2072,108710,128197,849,60755,75070
6248,2249,116424,143706,1697,136012,167608,552,49932,67476
6247,1043,77250,94575,711,90417,107880,332,55000,61597
6243,95,0,91794,37,0,0,58,0,0
6242,482,84271,99891,376,105000,113619,106,39643,44727
6241,2438,70718,80595,1640,80776,93195,798,33481,48617
6239,4637,61047,75455,2887,85956,90952,1750,31699,47934
6238,4743,93862,121741,3738,118775,136618,1005,55304,63530
6237,2370,104524,118206,1968,105625,122482,402,79103,83434
6235,972,85536,90734,701,93984,100664,271,42361,54897
6234,2819,76526,99516,2328,86250,100497,491,23304,72232
6232,1203,99449,113779,895,109851,129584,308,63145,64467
6231,1354,137885,148592,1065,139241,156526,289,88750,99699
6226,6852,35738,48742,3576,46212,60903,3276,22271,33274
6160,0,0,0,0,0,0,0,0,0
6120,4963,23388,35095,3187,28236,39104,1776,16888,21822
6119,6304,93722,120003,3230,115226,153997,3074,56496,83026
6118,10104,69301,83286,6763,81151,91491,3341,38858,62589
6117,5663,142036,185763,3866,181484,233332,1797,59214,81607
6114,9864,43071,54629,6376,45927,58495,3488,27011,38206
6112,7481,36448,53785,4747,46895,65375,2734,21150,29354
6111,12581,82721,96371,8169,95406,106303,4412,62500,73964
6110,5298,70326,84291,3170,92573,101983,2128,32308,54319
6109,10929,90881,109841,7191,113340,132221,3738,47970,64047
6108,8778,52092,69005,5639,62658,77608,3139,32403,44182
6107,7805,134925,170642,5525,161198,197774,2280,65319,100526
6106,14634,37391,51958,8219,44609,60931,6415,22083,35184
6105,9891,32915,62418,3167,52083,92421,6724,28637,46518
6103,1276,87717,116706,236,125227,194927,1040,83963,98956
6098,5413,66494,82204,3146,97407,102367,2267,35768,49036
6096,5398,72090,93950,3512,92917,107628,1886,45000,66772
6095,11073,92001,106308,7474,105804,121591,3599,50585,71080
6093,1252,120865,152561,961,130987,162181,291,92868,117923
6092,1585,162563,211782,1316,188077,232758,269,0,102604
6091,56,63214,64105,39,64107,72026,17,0,45935
6090,324,180278,184729,253,206950,220159,71,0,58479
6089,1291,114063,173065,799,166181,225992,492,74500,83153
6088,2407,61584,73581,1033,75125,92948,1374,59679,59019
6085,2813,98424,129477,1968,135125,159651,845,34219,55372
6084,5460,118367,154757,4313,142883,172542,1147,65608,74212
6082,16897,83232,94021,10780,97572,107771,6117,49157,64037
6081,664,73400,88655,380,83281,106049,284,53625,63948
6078,3873,109503,149121,2979,135879,170536,894,56000,66308
6076,5103,82601,93849,3283,100137,111564,1820,41182,55629
6074,9753,119972,140807,7321,139269,162914,2432,48221,68730
6073,2227,145243,171275,1696,162714,196614,531,66823,85798
6071,3436,106228,136082,2626,122311,154486,810,62778,73188
6070,5857,126868,173262,4097,155866,212342,1760,51958,80837
6069,1214,97976,149190,598,113897,202471,616,68056,95563
6068,652,61250,151677,323,129219,239170,329,44448,65779
6067,8677,85123,108675,5533,102760,120310,3144,61888,84925
6066,12949,67492,85993,7482,89344,103517,5467,46409,59007
6065,323,100984,102185,229,101672,107982,94,83333,86557
6063,1130,109781,119627,978,112766,126612,152,47237,59916
6062,8187,70012,86778,4306,89975,108747,3881,47475,59842
6061,102,0,112037,87,0,122267,15,0,0
6060,887,143672,174967,846,154808,180649,41,49940,57722
6059,0,0,0,0,0,0,0,0,0
6058,701,75804,103727,461,103558,127800,240,33587,50528
6057,2364,108594,155060,1697,122066,148823,667,64063,169436
6053,12636,53678,69490,7415,63408,75779,5221,42057,56075
6052,3198,69709,86917,2013,91976,105511,1185,36427,49256
6051,11879,36859,48056,7042,46186,55850,4837,26537,32457
6043,1835,112622,128451,1357,133029,146728,478,56607,74845
6042,9550,80120,94435,5759,89241,103286,3791,66901,77474
6040,14388,66734,85631,8626,79059,99874,5762,44810,59907
6039,728,77194,118242,416,108750,138873,312,52742,79909
6037,7559,106882,128569,5632,124948,143556,1927,49641,81385
6035,3214,98733,126295,2264,123654,145501,950,42207,71786
6033,11723,117511,145648,7637,143262,180048,4086,56250,78717
6032,7456,97500,136792,4762,125938,167187,2694,52586,79582
6031,596,68750,122126,408,83654,135448,188,46875,84916
6029,6844,89645,116865,4282,124951,146659,2562,55227,63294
6027,574,97763,118446,392,105357,140883,182,53750,64737
6026,1939,107566,112553,1384,107083,123541,555,42216,67981
6024,117,82917,82791,53,79702,96611,64,0,71345
6023,683,73173,83319,437,86098,94173,246,31239,49823
6022,40,0,0,40,0,0,0,0,0
6021,146,99375,110743,78,105000,111637,68,88846,109718
6020,0,0,0,0,0,0,0,0,0
6019,4198,89178,124536,2800,116467,147451,1398,46730,72943
6018,1199,62560,89951,608,106143,117743,591,27723,56433
6016,2581,102739,106935,1834,114952,115438,747,75536,78529
6013,3442,129783,153489,2766,139375,168609,676,68600,83035
6010,24408,68485,87097,15237,85562,104933,9171,43562,52738
6002,8620,79134,102991,5271,96730,119294,3349,47313,74261
6001,7278,122241,187080,5152,152931,230032,2126,44538,79685
5907,67,44688,54137,40,60625,67365,27,35250,34541
5906,567,48854,60385,402,51724,68350,165,23875,33478
5905,435,64028,88653,308,72583,97638,127,47625,63360
5904,80,29000,36954,30,0,39420,50,27500,25732
5903,372,49000,65633,216,54000,77146,156,38250,49005
5902,86,38333,47647,57,65313,59314,29,10972,11683
5901,9,0,0,9,0,0,0,0,0
5875,261,106705,78523,200,112824,85496,61,37083,55661
5874,217,52083,72987,172,56250,78103,45,27250,36069
5873,334,75833,82686,192,101048,100693,142,50000,58337
5872,400,41000,52762,251,48958,59749,149,25809,38218
5871,565,53350,66519,385,61518,78532,180,26500,36967
5868,98,98750,96943,85,109750,102686,13,0,44662
5867,316,49000,61270,209,70625,81998,107,13958,18450
5866,286,65385,68074,198,75500,74551,88,40000,48274
5862,218,61250,65996,115,83615,94055,103,0,34668
5860,1148,46042,56274,738,51429,61772,410,29730,40104
5859,749,63594,75050,484,78438,87077,265,40156,47867
5858,194,32031,50376,117,56250,69579,77,18897,21197
5857,1193,65426,77304,834,80179,88185,359,37768,48337
5855,2992,55833,70151,1683,73028,89531,1309,27327,42581
5853,282,61250,87701,213,79625,94425,69,45625,65691
5851,2467,56160,82028,1549,73009,100254,918,26780,45975
5850,57,0,0,57,0,0,0,0,0
5847,375,46007,59944,262,45568,65106,113,27250,40104
5846,593,39647,48816,376,53300,58802,217,26492,30864
5845,555,59375,67356,446,63438,72224,109,26477,41414
5843,944,50625,61679,612,58844,71656,332,42348,42861
5842,181,60938,80933,128,68125,87964,53,34821,53981
5841,200,49808,60024,81,52917,66360,119,49712,55709
5839,290,70417,73957,232,75167,81979,58,22000,35214
5837,167,33250,42329,120,45469,47661,47,17054,23913
5836,533,80202,90147,345,93479,103741,188,36667,62357
5833,73,77969,73067,53,81094,85072,20,37500,41260
5832,495,45417,71498,268,73235,99914,227,36187,36254
5830,560,55417,58610,327,71528,75676,233,22176,32578
5829,822,51477,72353,567,62875,82849,255,18375,40105
5828,870,60104,85356,517,89250,103350,353,25221,58329
5827,116,62045,72689,86,73056,76127,30,0,62833
5826,366,62083,71928,231,66042,80327,135,35795,52963
5825,41,45208,59002,33,46875,66485,8,0,0
5824,483,50972,61274,319,70536,71818,164,30000,33193
5822,633,36058,47119,270,52917,58541,363,23125,33922
5821,482,54091,96595,347,61477,113820,135,38125,48516
5820,207,51964,56058,123,59306,67634,84,24063,37745
5819,3909,44299,61212,2328,56538,70217,1581,28644,41398
5778,339,59861,69514,188,70000,82990,151,0,46223
5777,1430,56920,70450,932,71429,83063,498,37778,43439
5776,305,50625,68470,214,55833,78550,91,31576,38049
5775,265,29268,55643,197,29406,59342,68,25769,36965
5774,433,67083,73580,303,85045,85941,130,33750,41748
5773,996,64423,75265,692,81250,85081,304,29667,41087
5772,319,68250,97842,192,97115,128321,127,42625,51434
5770,439,64236,92166,302,76429,98188,137,39135,65857
5769,466,80833,101287,315,93750,103782,151,36607,53385
5767,621,58393,79397,276,59643,77071,345,46875,80434
5766,231,82604,139449,127,130208,194924,104,51944,71707
5765,694,66364,78334,433,75592,94537,261,47688,49059
5764,1171,57875,68334,684,62935,81212,487,34938,48273
5763,1160,57242,78152,816,76667,90149,344,35259,43610
5762,179,56250,67939,105,74904,84683,74,40714,40670
5761,409,47250,78952,218,81250,115515,191,22350,35357
5760,379,58472,73373,279,75096,84667,100,36176,41615
5759,651,54020,74512,413,68839,94870,238,30952,33268
5758,289,70625,76959,181,78194,82423,108,39444,67064
5757,302,58958,74898,236,66750,83467,66,28958,34382
5753,3635,70215,90204,2040,95819,119307,1595,39926,51640
5751,310,66250,103207,157,90096,140885,153,46875,62902
5748,228,61449,81644,109,73594,92568,119,60754,58597
5747,153,48958,65201,84,74375,82660,69,0,41446
5744,217,62240,64082,129,86250,79900,88,0,40713
5743,1495,58321,72049,974,68333,83933,521,34034,42472
5742,259,69904,93871,178,90500,115880,81,34063,38865
5740,22,0,0,0,0,0,22,0,0
5739,547,52708,69827,363,60938,80232,184,24500,42072
5738,493,77813,97213,359,89750,102511,134,56563,82825
5737,347,76083,99571,236,89545,115770,111,48036,61321
5736,209,62560,101211,165,64345,107977,44,55833,59961
5735,1479,46328,59250,687,85063,82459,792,27813,37835
5734,550,54712,71977,287,76645,89403,263,40785,49908
5733,2632,57722,72623,1586,82132,94363,1046,27028,35885
5732,441,44625,64669,270,0,77075,171,0,45081
5730,91,65208,86295,75,67292,76313,16,20417,128663
5701,9381,51591,68380,4822,76190,90868,4559,30899,42944
5682,508,64907,82818,330,84722,99699,178,39318,50062
5681,164,79444,78850,127,89375,89639,37,36750,41819
5680,839,66510,79469,560,75625,87827,279,45774,56033
5679,1296,82348,84067,853,99901,102238,443,35750,43321
5678,52,51000,49504,47,0,0,5,0,0
5677,890,97171,128678,687,117083,148332,203,54531,62166
5676,2033,74875,86781,1299,82614,100388,734,42270,54705
5675,545,58993,64072,373,58160,67171,172,45000,50281
5674,662,60750,104667,446,71250,128750,216,48152,47355
5673,1214,80182,102609,670,111855,140785,544,30482,53077
5672,2342,70577,121435,1190,121053,179754,1152,43355,60138
5669,355,62083,68619,251,65481,70513,104,60625,63408
5667,849,48480,69426,500,62500,81791,349,36726,48001
5664,46,0,0,0,0,0,46,0,0
5663,2273,72513,78121,1358,81575,91668,915,49440,55950
5661,2626,55882,87876,1609,64002,102388,1017,40417,59941
5660,677,92958,108408,457,106442,124121,220,60435,73380
5658,587,57007,82818,426,65313,91689,161,0,54651
5657,34,0,58232,9,0,0,25,21125,33988
5656,1360,50000,65515,781,71853,82881,579,23401,36885
5655,1181,70019,108907,749,74273,123229,432,43704,51070
5654,471,42417,63009,286,48514,51420,185,32161,69881
5653,268,48542,70521,158,49583,66575,110,46111,73235
5652,253,49479,57172,181,68239,64381,72,42692,39047
5651,597,66544,79340,394,89375,95067,203,31750,45541
5650,442,61406,84246,310,61875,86481,132,55556,73584
5649,214,55000,64304,95,75417,76337,119,51557,54697
5648,188,86667,110822,95,93750,107503,93,64583,103597
5647,476,60722,63244,313,61808,71593,163,43203,44983
5641,7503,58483,68494,4351,74240,82398,3152,32966,44531
5640,104,92500,82098,85,99875,90692,19,0,33653
5602,5650,66971,85101,2942,91552,110333,2708,48462,55328
5495,4309,86508,113637,2895,104732,130457,1414,48495,69022
5494,633,100083,114104,518,102857,120691,115,58438,80560
5492,332,78750,82646,230,82266,96468,102,42589,48266
5491,2437,71782,81786,1614,81081,90605,823,37721,54814
5489,1332,97143,110496,982,104833,121425,350,62784,75860
5488,2851,64949,82593,2154,73186,91021,697,42008,52866
5487,591,62981,79102,391,83229,91290,200,36429,47010
5486,637,101758,129050,478,116818,147487,159,42250,69469
5485,32,63167,58116,32,63167,58116,0,0,0
5483,568,59400,74731,303,87625,90175,265,58030,50728
5482,3274,91914,127769,2129,123188,148394,1145,51174,88978
5481,0,0,0,0,0,0,0,0,0
5478,6077,60757,75419,3720,83715,92799,2357,37326,43685
5477,1969,99228,107168,1173,115583,128372,796,60455,73292
5476,1264,48415,60020,755,63882,79194,509,17025,28660
5474,474,79500,97194,287,118542,123158,187,41919,55533
5473,574,83182,113397,364,124397,143033,210,46250,59793
5472,703,78438,99440,487,95750,106971,216,40833,75211
5471,386,27123,43081,170,66458,64206,216,26020,26455
5468,5187,90131,103614,4117,96035,112797,1070,46667,57524
5465,2049,96458,117516,1542,105769,127859,507,61343,80674
5464,1161,76250,88979,791,81875,100409,370,55000,57758
5463,194,57917,69859,117,71908,83449,77,30625,46931
5462,751,87784,101684,496,98654,116988,255,52917,66133
5461,2049,96815,117367,1250,109400,130556,799,53750,94488
5459,827,59856,60551,560,66848,67259,267,38153,38541
5458,877,90250,101860,592,98611,112489,285,50662,79176
5457,714,87667,82348,450,96094,94359,264,60917,58440
5456,465,105536,146845,338,136458,175649,127,59485,63536
5455,471,95852,102093,332,99500,118055,139,27212,47450
5454,1985,79518,87824,1401,90889,97422,584,52616,58497
5452,9228,86447,104877,6044,108596,123289,3184,47102,65430
5450,1814,65208,81887,1357,80091,93092,457,21063,39564
5448,390,61538,90257,261,94107,115899,129,27383,34495
5447,34,44750,54247,18,70833,61928,16,0,0
5446,6669,79172,94406,3850,90763,115949,2819,47928,59759
5445,1595,106614,148823,1150,134438,175426,445,0,75523
5444,554,67500,85212,408,86944,93390,146,50833,59196
5443,2914,68155,79941,1728,91167,95735,1186,39766,55014
5442,170,74375,72842,122,75469,76443,48,50000,44923
5441,357,68375,82034,219,74063,93767,138,55921,57742
5440,778,59545,74884,550,83214,89240,228,30071,36163
5439,0,0,0,0,0,0,0,0,0
5408,3896,71467,87521,2128,89563,107681,1768,42071,62376
5405,161,0,7753,0,0,0,161,0,7753
5404,3342,56236,70149,1283,71250,85527,2059,47760,60568
5403,8508,75633,100665,4655,96765,132934,3853,45925,58959
5401,12325,52297,76116,4088,89754,114064,8237,38483,55610
5363,973,56225,68934,468,71944,92577,505,36719,46031
5362,55,57917,66216,42,66250,72421,13,50694,38492
5361,403,68309,75615,308,75000,85769,95,27083,38689
5360,95,64276,98412,70,78750,111497,25,41339,61772
5359,217,68438,80997,155,77361,90190,62,52727,49471
5358,71,54688,80545,46,0,90641,25,0,53600
5356,291,49453,80817,112,92955,137354,179,40313,45442
5355,277,60391,80086,198,73056,87156,79,32875,62094
5354,889,75179,101712,505,90250,106107,384,53333,91698
5353,502,75341,111306,329,103393,146633,173,37083,37435
5352,378,73750,88512,275,92375,101988,103,52697,51237
5350,289,58750,66996,161,71875,76354,128,36667,48974
5346,2066,59307,86313,1185,72171,92028,881,41250,77791
5345,902,56029,68877,525,72757,78718,377,37656,49063
5343,394,55750,69498,195,67813,85822,199,47361,50317
5342,205,38828,52770,112,47143,63772,93,24250,34576
5341,243,0,50544,193,0,51217,50,44722,47948
5340,335,58750,74049,219,68125,75882,116,53077,69328
5301,7634,44342,68215,3797,66776,88867,3837,31292,46292
5262,811,101635,135217,714,112344,146395,97,0,52709
5261,882,62143,82154,550,75724,100697,332,32396,48380
5260,186,66667,70519,149,76932,76799,37,0,45230
5257,833,60815,81147,562,78548,97328,271,30391,39127
5255,1984,74609,99298,1091,97477,138551,893,29161,50308
5254,72,101667,151697,34,"250,000+",228268,38,100238,83184
5253,227,37292,74442,126,98333,116532,101,13417,21934
5252,122,78750,93671,90,83125,97460,32,76875,77084
5251,477,60625,87850,274,92083,112345,203,33867,54788
5250,1400,63571,89434,968,70357,98866,432,43176,55426
5201,5979,49035,67055,3335,68283,85653,2644,29323,37321
5161,266,88409,110172,180,107083,122892,86,57917,77688
5158,452,69000,72977,278,86216,87297,174,0,49772
5156,4215,48734,58604,2199,71115,74763,2016,26103,40300
5155,354,50446,77339,169,76023,102241,185,24398,39376
5154,255,110625,104549,190,172600,127705,65,27750,36865
5153,236,45000,85079,161,54583,107222,75,36250,36728
5152,181,94375,114881,140,104500,130979,41,0,59912
5151,574,67500,78302,402,68947,86205,172,64779,59826
5150,338,55932,50922,180,56310,58848,158,38281,41894
5149,888,49808,73203,488,63500,82967,400,36538,59330
5148,534,70405,101618,322,103750,127324,212,45472,59315
5146,242,73750,88923,173,77946,102094,69,33125,54484
5143,1844,62583,78936,1174,101579,106276,670,16171,28975
5142,237,59464,95180,150,89375,120229,87,26518,46147
5141,84,50781,49131,64,47000,48142,20,15833,19695
5101,1955,59560,61425,911,66425,71261,1044,38750,50499
5091,1604,81023,98554,1033,104712,122178,571,46161,52775
5089,1876,45484,64489,1047,65231,82089,829,31875,41112
5086,249,65982,68289,174,57000,66270,75,38438,51769
5084,24,0,104392,24,0,104392,0,0,0
5083,86,0,73637,41,71719,127359,45,14241,23913
5081,185,48403,54728,128,46250,57348,57,18542,31072
5079,355,60515,72750,210,70833,79164,145,58606,58935
5077,519,53750,81849,316,74643,84912,203,43542,73111
5076,138,47955,67344,105,65313,69022,33,31563,45300
5075,405,76438,86871,280,86711,96916,125,54922,64370
5072,256,96429,109321,215,100532,117128,41,46442,66793
5071,77,95893,85879,65,102969,94578,12,0,0
5070,232,98929,124352,155,118021,154999,77,42125,61318
5069,243,97625,89154,193,119125,98476,50,45833,47406
5068,1342,62195,83115,820,86829,100796,522,38684,53391
5067,90,148333,137651,58,162500,152945,32,0,109931
5065,421,60063,77537,262,72917,95698,159,34276,45332
5062,216,58750,73083,130,70000,83647,86,19722,54263
5061,582,67500,76262,308,71667,83011,274,60588,64943
5060,1989,55901,69445,1199,74573,85507,790,40149,43673
5059,232,0,170594,108,85638,269391,124,44468,81099
5058,159,67750,93576,121,76484,96013,38,22273,85818
5056,198,63750,83376,130,84375,107462,68,31786,37331
5055,1264,115345,151538,905,130804,180513,359,41528,69457
5053,109,114306,113326,95,114583,120820,14,0,48829
5052,133,64122,79135,55,64120,92495,78,64125,69714
5051,656,57604,73796,387,67452,93876,269,27171,35916
5050,61,42179,51595,42,47656,54283,19,0,0
5048,1256,67267,89829,873,83663,107998,383,48523,46719
5046,465,60817,67835,300,73100,80022,165,28958,41968
5045,975,51590,69560,541,72768,88613,434,43088,44468
5043,477,67212,90655,330,74375,102263,147,60787,59197
5042,203,58750,72680,143,67679,80129,60,26250,38282
5041,128,74300,82711,92,71250,73837,36,0,0
5040,270,87500,87943,163,78047,75793,107,93177,92868
5039,616,57500,70386,366,65000,81888,250,33295,42604
5038,517,53839,63821,329,57083,74140,188,32292,40886
5037,331,93750,107448,241,116518,118822,90,66250,74830
5036,521,60048,97935,361,61042,115496,160,42500,44454
5035,302,53750,73021,198,82000,81397,104,21691,54856
5034,104,63889,72263,65,74583,98902,39,27969,27864
5033,1063,68510,73140,663,83821,87088,400,38261,43146
5032,1158,63205,87070,706,75833,106311,452,50208,54321
5031,44,72167,105591,35,80625,127023,9,0,0
5001,4396,63213,78051,2408,84915,103199,1988,32697,43841
4992,30,0,0,30,0,0,0,0,0
4989,1902,66139,79260,1335,72159,87956,567,46413,49068
4988,705,38359,54458,371,48594,62981,334,20096,39972
4987,461,44531,56826,328,54167,65123,133,17401,27560
4986,653,50120,60550,478,52500,66617,175,20917,31909
4985,48,0,83021,33,115438,87285,15,24750,33433
4984,288,45536,54489,208,45848,60422,80,34500,36680
4983,719,36383,70049,447,62969,88873,272,24583,35598
4982,267,35114,53820,131,53229,64215,136,26250,43807
4981,1272,61050,79342,779,72813,89832,493,50329,59648
4979,367,50688,61709,216,56154,69927,151,36875,42613
4978,364,86304,88338,285,93036,94290,79,0,65534
4976,4339,46415,56979,2754,61389,68337,1585,27621,34923
4975,14,0,0,14,0,0,0,0,0
4974,1339,38920,55177,658,65357,72727,681,23238,32903
4973,538,70893,79874,366,79583,89137,172,32292,56905
4971,768,40000,69679,513,65579,91291,255,16995,25741
4970,728,60375,74104,504,71172,91306,224,33750,35395
4969,471,45625,59476,332,52000,66605,139,29875,39107
4967,1604,49118,50641,971,51688,58900,633,14058,31041
4966,752,38750,53154,405,49338,64135,347,30994,38037
4965,799,52656,60384,538,72685,69550,261,19904,32411
4964,77,102188,85199,52,121500,107606,25,36932,38592
4963,3149,68583,80883,2263,92828,97508,886,22201,33417
4962,76,0,88354,66,0,48564,10,0,0
4961,392,37100,56561,238,47250,71458,154,31429,32808
4958,738,51635,58157,495,54986,71762,243,30024,28388
4957,1673,49201,76139,1111,55250,90511,562,30862,44850
4956,294,51833,72602,194,59167,68358,100,31250,75968
4955,579,57375,70344,445,70799,82137,134,24500,26275
4953,1432,53429,63786,912,60389,76802,520,20250,36263
4952,857,56250,66774,619,69402,75551,238,27500,40417
4951,484,59643,69237,272,53462,71697,212,64833,65529
4950,2050,44466,56818,1304,55385,72448,746,20608,25907
4949,350,58846,63519,248,68333,72246,102,29375,40422
4947,827,66838,97834,484,93750,136443,343,26875,41251
4945,540,49063,55465,308,50500,67240,232,27763,37926
4944,28,0,0,28,0,0,0,0,0
4943,810,26944,50167,419,51875,69851,391,23441,28661
4942,566,33900,44056,376,42500,50957,190,23333,30252
4941,753,55901,63158,475,57946,70548,278,41806,42921
4940,0,0,0,0,0,0,0,0,0
4939,417,39844,53532,263,59688,66421,154,17895,30689
4938,3978,47530,69215,1888,62131,96947,2090,31264,41452
4937,2875,48180,54926,1559,68819,69475,1316,23370,34333
4936,91,60938,65043,61,0,77195,30,19107,40333
4933,28,0,0,0,0,0,28,0,0
4932,523,54583,72100,367,59250,80777,156,40000,45368
4930,1831,45429,55175,1211,60208,65754,620,25917,32840
4929,348,39750,57706,241,49375,68336,107,21250,31379
4928,905,46348,59615,562,71011,76244,343,25885,32082
4927,1468,61224,69925,1001,78281,86188,467,0,31183
4926,113,0,0,113,0,0,0,0,0
4925,19,85625,97826,19,85625,97826,0,0,0
4924,910,51786,62162,681,56741,69161,229,21490,27960
4923,237,44688,56347,151,62917,71464,86,19286,26726
4922,445,43750,53908,266,47045,57267,179,25750,45985
4921,683,42563,55957,454,48542,65699,229,28403,34324
4920,841,31719,42314,365,56875,61657,476,30284,26772
4918,149,96615,98764,66,82931,70923,83,96094,101620
4917,1129,76899,113428,903,84297,128371,226,43750,52596
4915,4176,59178,73975,2738,68462,87714,1438,25446,39722
4912,291,33281,38682,154,45000,48579,137,13625,23664
4911,816,37059,52950,441,48393,64137,375,28050,37902
4910,838,51848,63927,567,53807,68059,271,38713,45768
4901,11431,44095,65344,6350,59892,84046,5081,26426,38925
4864,1497,63781,69724,1090,71371,71448,407,50413,57049
4863,461,100078,113810,270,119583,142203,191,34861,67694
4862,1659,54280,62894,1064,69032,76963,595,21618,34914
4861,1417,53020,55110,827,57125,64384,590,38438,39604
4860,747,41597,68291,565,51781,77412,182,28000,35279
4859,347,52554,64452,216,58188,69904,131,40677,55460
4858,569,70938,87992,387,74920,105658,182,33000,49801
4856,1290,80192,101300,973,85583,113739,317,42028,52720
4855,221,138924,151042,191,0,163164,30,36000,36903
4854,704,70075,84748,385,74792,102832,319,55938,61874
4853,193,74375,97382,132,71875,92045,61,75625,101703
4852,43,118750,113302,30,104318,106873,13,0,111346
4851,39,44375,68433,29,0,87297,10,25000,0
4849,1617,65828,86775,1114,81618,104055,503,35417,45751
4848,331,61875,86684,186,73750,117303,145,0,43185
4847,645,72013,97724,500,79167,108345,145,43750,48943
4843,2315,72055,88619,1139,98295,118356,1176,50824,57004
4841,3586,46895,60113,1586,68095,78579,2000,32348,43344
4787,212,35000,48318,172,48409,54132,40,21154,21173
4786,769,40365,50028,532,50625,59987,237,18942,24327
4785,953,29926,46726,455,43672,58760,498,20000,34425
4783,183,37750,57389,117,45938,67684,66,26250,36127
4781,223,43438,53396,152,44375,59361,71,0,30186
4780,313,42083,54525,201,64028,66981,112,16596,28906
4779,159,49583,61608,114,0,71060,45,0,33418
4777,152,35714,39811,98,46364,45918,54,17500,26857
4776,367,39688,56246,276,46000,60502,91,26964,34071
4774,360,21538,38412,154,45313,51669,206,16698,26761
4773,259,53229,57588,198,55625,61280,61,0,45603
4772,388,52321,66685,291,60250,72708,97,22679,38623
4769,4243,43410,56194,2374,58205,68937,1869,25744,38215
4768,192,41875,60410,127,47708,66365,65,35417,48066
4766,168,43929,75488,110,54750,99358,58,30833,28772
4765,470,35625,47211,224,47500,63876,246,24853,29139
4764,18,36250,37861,9,53750,49700,9,26563,26022
4763,332,39267,43438,242,39946,46895,90,20000,26243
4762,230,39800,58145,160,48750,67273,70,33000,31596
4761,199,45536,69183,132,63462,73783,67,27321,60121
4760,302,43750,61237,150,62059,65964,152,30000,56226
4758,471,51302,56875,311,58036,67277,160,28611,33933
4757,1192,60625,68285,835,66683,78987,357,21793,33679
4756,1555,35558,50250,887,59647,73147,668,16951,19846
4750,798,37109,49433,545,38828,50951,253,0,43860
4747,579,43125,57754,391,52813,70289,188,20357,31684
4746,199,29750,42076,105,44375,52454,94,21563,29812
4745,407,42708,51514,299,53802,58841,108,27500,30768
4743,1842,49764,81786,1134,62500,80039,708,32262,75766
4742,1319,40730,67947,943,71285,81613,376,17632,33675
4741,4,0,0,0,0,0,4,0,0
4740,603,41506,59229,361,67250,79413,242,22596,27401
4739,295,37969,52669,162,58750,71106,133,18854,27121
4736,4347,45331,60384,2530,60435,75891,1817,22386,37975
4735,232,44167,55543,127,51250,77866,105,20938,28543
4734,371,65057,81984,285,70673,94365,86,31250,37783
4733,145,47936,55664,94,48895,55654,51,28819,55684
4732,761,38317,43683,370,45909,56817,391,21042,28987
4730,3976,47063,64453,2482,64476,82826,1494,21699,31465
4694,999,50489,61760,680,58158,68063,319,38542,44424
4693,213,46750,60446,104,79688,87750,109,25139,34394
4691,183,46157,65947,131,47083,76350,52,30000,35263
4686,64,50625,52988,52,52500,59275,12,0,22817
4685,339,52005,76562,158,87000,104182,181,51094,52451
4684,852,68929,105342,503,89750,118949,349,37656,82195
4683,43,128942,126298,16,0,0,27,102292,102037
4681,516,54800,68511,266,81818,88941,250,33056,39647
4680,528,51667,64853,324,61346,77779,204,24000,40266
4679,647,51971,71959,403,67014,91386,244,25208,30207
4677,116,68625,75832,60,70000,86760,56,68289,63163
4676,578,65160,73657,343,66587,96204,235,0,40019
4675,74,0,97243,34,138500,188853,40,0,0
4674,161,56058,53424,108,62083,64513,53,7448,24511
4673,64,20333,34258,42,21607,38762,22,18250,25655
4671,238,59583,87160,193,62279,99013,45,23558,31064
4669,70,51094,87597,47,0,121066,23,16042,19204
4668,626,33571,51348,390,50341,62979,236,14375,24333
4667,543,46875,60210,361,49250,67379,182,39286,42943
4666,548,49808,58411,376,58250,64801,172,27250,39915
4664,474,52045,66345,346,60074,66506,128,29896,48271
4662,200,0,121768,112,129083,139629,88,40714,99035
4660,496,80000,121041,306,125833,140986,190,44000,88919
4658,580,52143,63228,361,63125,71523,219,25625,44336
4657,157,50750,69957,94,85833,89685,63,41250,40257
4655,392,49130,62220,293,57188,72377,99,0,29272
4654,1341,42019,60647,797,61625,78009,544,18571,29831
4653,287,48403,55907,159,68047,69463,128,35577,34898
4652,837,40977,62273,500,57750,84394,337,19115,27389
4650,183,118583,193233,125,175563,255626,58,0,58766
4649,544,51471,53621,275,62813,62936,269,27056,39562
4648,269,42604,50330,184,43438,53368,85,34464,35374
4646,40,61184,69930,27,61635,81833,13,0,45215
4645,19,0,81516,10,0,133460,9,0,0
4644,0,0,0,0,0,0,0,0,0
4643,351,58984,66717,237,58516,61414,114,68125,77685
4642,62,88750,107965,41,101328,146673,21,0,32390
4640,979,60788,82371,579,76331,87823,400,39028,70139
4637,109,49583,59961,78,64167,72699,31,22250,23816
4635,4,0,35500,3,0,0,1,0,0
4634,821,54076,60076,555,58517,64527,266,30179,47311
4631,645,40179,59975,361,71827,85523,284,18529,25769
4630,560,45278,66094,400,50147,67927,160,23750,56346
4629,0,0,0,0,0,0,0,0,0
4628,235,48125,57224,165,66719,71979,70,16667,22446
4627,688,47197,66209,401,75231,84343,287,23125,38924
4626,246,51250,60940,159,86250,81191,87,15341,23015
4625,32,52500,106688,14,0,148186,18,46429,74417
4624,76,49833,57393,65,64375,63462,11,0,0
4623,377,49485,59464,218,62500,68377,159,28977,41410
4622,461,39375,51191,285,47019,61046,176,19022,32027
4619,1666,34844,48173,970,58333,63625,696,16354,21985
4617,358,60000,88378,214,76389,106691,144,41071,59676
4616,323,50625,64211,175,76250,91202,148,27115,31015
4614,1267,43768,69697,741,60439,87013,526,41250,43907
4613,45,82292,110802,45,82292,110802,0,0,0
4612,233,77639,104036,200,81429,113488,33,0,42767
4611,183,50804,63517,127,52054,72191,56,0,43207
4609,2408,68274,80585,1366,98389,107232,1042,19353,40636
4607,515,62014,97826,366,72021,123165,149,29375,29754
4606,589,37250,49910,389,52292,58083,200,25978,32912
4605,6175,61797,78906,3698,76000,95457,2477,38115,50779
4579,1293,63597,75147,923,70069,81284,370,58065,56944
4578,2052,61406,71421,1337,75496,80435,715,40683,47952
4576,290,53906,81776,148,93750,115426,142,33000,46704
4575,38,145833,225758,29,0,279772,9,0,0
4574,630,49889,96069,420,58125,120465,210,35000,44442
4573,175,77583,105167,133,83750,117429,42,75000,59774
4572,2590,42644,61638,1268,77930,88782,1322,24027,31792
4571,343,46468,77283,162,26653,97664,181,46638,54386
4570,0,0,0,0,0,0,0,0,0
4568,275,47348,89090,120,111786,134893,155,45990,50352
4564,237,60313,95450,147,0,121937,90,28750,42249
4563,655,57784,75642,435,71420,89100,220,36964,44684
4562,1090,81885,101847,735,107907,122602,355,34205,48257
4558,96,64306,78027,55,64931,99496,41,0,49227
4556,590,69063,89289,376,88333,110915,214,41250,49781
4555,703,73849,87181,531,83375,99415,172,30000,44349
4554,333,71369,80591,202,77222,94399,131,47625,59300
4553,722,82667,102434,493,122682,131149,229,28875,40057
4551,291,57159,72961,210,62500,79011,81,0,54854
4548,462,69412,80526,286,84211,97010,176,50000,52859
4547,503,72083,87434,344,81250,102777,159,34583,49155
4544,481,0,79939,228,133023,131333,253,0,33623
4543,1004,48241,66115,548,65357,85634,456,30435,39991
4541,26,55625,64735,15,0,0,11,0,0
4539,642,68667,85175,506,79200,89749,136,54597,68156
4538,924,53836,73013,492,69375,102662,432,26855,36043
4537,694,68938,106606,515,73942,102520,179,39609,116542
4535,299,71979,89294,217,80536,93899,82,36563,66960
4530,5015,59079,75617,2976,80833,88057,2039,39415,54372
4497,164,23500,46165,92,47500,63341,72,18125,23717
4496,1614,75000,80774,1266,77155,86797,348,26170,44683
4495,171,37625,51561,85,44375,49948,86,31711,51015
4493,777,53083,70238,573,59018,80054,204,30250,36464
4492,36,56250,47944,24,62500,54542,12,18750,33600
4491,82,52857,61104,59,75625,73380,23,21250,29613
4490,98,66875,88468,72,62500,94119,26,86500,70277
4489,138,0,58104,57,85804,77570,81,20240,44405
4488,503,53250,64606,318,65893,72285,185,41250,47226
4487,399,37989,44327,265,52757,51669,134,11346,25257
4485,63,51250,64613,38,67000,79818,25,36458,37320
4481,208,58047,71124,162,58828,75946,46,31250,50341
4479,654,43816,54280,421,55329,66151,233,27404,32148
4478,153,32813,56554,97,0,70588,56,0,32243
4476,466,46944,70439,270,65625,89589,196,35938,40069
4475,227,47639,56005,163,57031,60017,64,21250,44836
4474,1519,73401,90490,1060,88981,107056,459,26719,49880
4473,3220,46563,72888,1364,97833,111992,1856,31125,43547
4472,903,65288,78727,620,87788,95450,283,32443,41640
4471,273,25521,52232,171,43194,65518,102,11667,27642
4469,0,0,0,0,0,0,0,0,0
4468,3965,42112,62879,2256,56250,74015,1709,30022,45800
4464,224,45000,66090,136,55313,53568,88,21591,80431
4463,1321,44922,49307,757,48063,58535,564,31333,35150
4462,2338,42883,60279,1397,58191,67158,941,25362,48657
4461,1205,53428,60735,827,55469,67253,378,22500,36765
4460,627,33558,47832,437,45163,53851,190,23333,33860
4459,368,43438,51697,227,53977,53704,141,24028,41256
4457,2780,40667,48536,1640,50648,59565,1140,18750,30329
4456,1197,66597,76490,868,82833,80778,329,42688,62293
4455,274,40000,54908,208,51667,64440,66,18125,22485
4454,11,18750,21182,11,18750,21182,0,0,0
4453,321,33482,48231,199,45469,56168,122,21667,25894
4451,137,29464,40840,58,65000,61424,79,25179,24284
4450,599,57083,60703,377,63651,65944,222,36667,45216
4449,510,45833,57877,336,50417,62162,174,34500,40366
4448,571,47933,48917,407,58114,56628,164,20469,25243
4444,3501,85823,108440,2485,100727,129630,1016,36966,52746
4443,912,38241,49158,556,49118,57432,356,18750,29622
4442,32,43500,50316,19,0,0,13,0,54838
4441,759,50329,62797,496,53333,73683,263,23257,31750
4438,534,62647,62029,245,66354,71610,289,54414,52306
4435,474,54038,61070,343,67596,67198,131,0,41343
4434,419,59458,67386,329,55536,63809,90,50625,57146
4431,22,0,0,13,0,0,9,0,0
4430,778,44167,52008,447,57404,60317,331,22458,32400
4429,2040,68491,96878,1317,75982,114424,723,35539,54572
4428,1272,57941,73690,929,61771,78350,343,34323,50405
4427,1103,47171,63825,727,72969,76403,376,28750,39406
4426,1901,37172,56530,1099,54085,79923,802,18194,22629
4424,374,40137,42014,257,41631,49112,117,20982,24204
4422,454,56667,75716,334,64286,87128,120,31667,39716
4421,308,65147,94405,230,66618,96191,78,41364,88549
4419,1183,81496,78269,927,83854,82913,256,40735,50765
4418,676,40938,49459,433,49279,59346,243,22891,30990
4417,198,31724,40954,89,43750,53316,109,27750,30005
4416,2331,49011,55985,1417,55496,68138,914,29325,34507
4415,139,37422,52159,69,0,74484,70,25000,30153
4414,543,42303,58204,371,62566,71032,172,17000,27421
4413,83,51563,47583,30,65000,61520,53,0,39692
4412,3891,48450,66000,2007,68319,87572,1884,29389,35843
4411,655,66875,70806,474,85714,78718,181,40250,45139
4410,467,62212,69553,331,85230,77550,136,40250,46494
4408,83,60469,73934,40,101250,98020,43,42292,51526
4406,291,47031,59671,201,49620,69772,90,23250,29591
4401,18801,54550,72733,10471,72377,92682,8330,32139,45144
4364,2539,70954,73042,1529,77477,88638,1010,40519,46740
4363,1014,55417,69073,755,57899,68342,259,38188,62744
4360,207,60625,66685,153,75461,74827,54,31000,42569
4359,137,103750,75154,83,105450,87983,54,0,55435
4358,1644,72810,85789,1029,74635,83880,615,43669,82145
4357,1583,51208,58531,888,62299,68943,695,34150,42671
4355,977,86156,104859,699,92708,112640,278,57000,74424
4354,636,73281,95733,444,81136,84594,192,32917,111330
4353,879,60362,70395,546,73269,80138,333,43750,50693
4352,633,59844,73999,422,64286,78040,211,33875,58481
4351,1037,73438,98142,761,90662,113001,276,39429,52778
4350,1470,76500,85902,1012,92982,98556,458,33229,54607
4349,520,48409,60079,381,56397,69942,139,26083,29386
4348,1135,61654,69957,796,65000,72995,339,42750,53873
4347,1114,56989,78074,560,68750,101454,554,39688,54440
4346,818,45625,63382,462,58929,67440,356,24417,38591
4345,4459,59461,81012,2991,78539,95183,1468,29877,46703
4344,1327,62891,77167,711,86418,86475,616,39896,45291
4343,0,0,0,0,0,0,0,0,0
4342,803,59625,63709,576,58250,66069,227,27250,45706
4330,12060,44609,61913,6223,70513,81204,5837,30448,39154
4294,1499,49023,65202,1010,56172,77200,489,23818,35460
4292,399,46033,60221,301,48854,65477,98,36250,41888
4290,624,58409,69714,414,80208,85232,210,36500,38391
4289,743,51382,57844,573,54965,65468,170,12311,21632
4287,1489,67470,70674,1144,75441,75727,345,40234,50161
4286,0,0,0,0,0,0,0,0,0
4285,206,53281,57965,140,55000,60628,66,28750,52315
4284,420,57115,69912,260,73333,91063,160,27000,31667
4282,2420,72446,84293,1840,83810,93250,580,34542,49768
4281,1902,57799,61672,1210,59870,75572,692,29324,32181
4280,2917,66406,82184,1983,79439,93118,934,45242,54193
4276,2343,41946,57496,1332,51311,67431,1011,31592,40866
4275,264,39286,63625,143,50313,68920,121,0,57262
4274,2345,70625,84833,1375,69306,86230,970,68185,73304
4271,0,0,0,0,0,0,0,0,0
4270,2310,56563,68824,1775,64375,73327,535,25774,46683
4268,1963,48774,67211,1350,64111,79384,613,27221,33471
4267,19,0,41705,15,58250,52153,4,0,0
4265,367,58125,85283,248,59500,104129,119,38355,46007
4263,757,61250,79239,616,66579,83651,141,45813,47608
4261,177,28438,62592,71,76250,115659,106,14745,26865
4260,2041,74150,88569,1545,91547,94449,496,49603,63092
4259,1487,66354,69668,938,82250,84300,549,23542,42591
4258,988,90917,112039,789,95104,119262,199,51806,65019
4257,1105,38750,48768,692,48989,55390,413,24007,36437
4256,1111,58944,68456,800,61844,76349,311,0,44985
4255,312,48125,60391,136,71389,78457,176,30833,44136
4254,1464,39085,40003,707,50677,52382,757,18568,26905
4253,832,69808,79103,517,81250,87278,315,40855,63521
4252,1876,60382,68015,1253,72198,77696,623,41016,45319
4250,1841,59170,71780,1208,71923,82995,633,39635,45913
4240,15844,42969,57894,8413,62215,72753,7431,24522,37325
4239,1856,65316,72511,1315,76335,81781,541,38125,41031
4238,474,75536,75715,369,76920,80260,105,44306,49921
4237,139,0,159985,45,0,404511,94,0,41884
4236,1696,81000,105234,1241,104470,122969,455,29097,53676
4234,30,0,0,30,0,0,0,0,0
4231,82,40625,49490,49,44688,62910,33,16458,24939
4228,0,0,0,0,0,0,0,0,0
4227,30,0,28547,26,26250,30354,4,0,0
4226,77,34375,46345,45,51875,62991,32,21600,22938
4224,1012,46181,58551,589,57546,66568,423,30064,45239
4222,1675,78625,93991,1229,89432,107813,446,42449,52551
4221,339,45313,59924,205,65313,75312,134,33750,31242
4220,1184,73636,82188,770,79808,90085,414,49853,60110
4219,561,53795,64526,366,66250,74912,195,24125,36869
4217,1511,41083,60714,881,42554,62486,630,38250,54904
4216,205,44750,52289,146,53750,59889,59,28750,33481
4210,10140,51504,72769,5785,71166,90758,4355,32830,44818
4110,541,208355,273659,423,235417,320394,118,0,106125
4109,51,35288,61033,22,0,86145,29,35673,41983
4108,406,85667,114959,269,89464,130600,137,45938,81109
4107,3722,127329,151652,2662,142396,179635,1060,61563,77880
4106,11360,66925,86693,6226,88416,104523,5134,48074,59672
4105,4700,120062,166220,3436,140323,193967,1264,55167,85615
4103,12791,72033,90413,6779,97917,112151,6012,48581,61537
4102,7610,67324,83532,3458,87246,110569,4152,47025,59645
4101,9903,46309,67522,2566,66765,107144,7337,41771,52942
4097,1427,93967,118907,1009,120245,138806,418,52262,63496
4096,3247,88295,133259,2222,107917,163293,1025,49632,60906
4095,616,42361,61581,332,64306,89139,284,0,24324
4093,3257,67443,92336,2148,86985,106159,1109,36424,62807
4092,8386,71183,80058,4616,80643,94879,3770,49936,58991
4091,324,65417,78925,231,85625,96087,93,24821,33622
4090,4525,66946,93537,3109,82011,99726,1416,32088,77284
4088,545,53036,68463,375,63750,77039,170,39167,43860
4087,949,80764,82834,734,81745,90725,215,62560,55893
4086,3864,74227,82807,2485,86394,96519,1379,52598,55133
4085,953,82898,90990,789,108525,97720,164,63333,52664
4084,2598,72119,84723,1801,86853,94894,797,36382,53988
4083,1978,67059,82258,1061,74632,95165,917,51607,64977
4079,1900,75931,102059,1225,102260,126731,675,53224,54558
4076,1082,71875,75385,860,72467,76680,222,58000,65543
4074,8376,103495,127807,5980,122700,146635,2396,56368,77663
4073,6775,55404,69167,4042,71441,77084,2733,32260,51179
4072,8341,71755,91370,5325,85645,103372,3016,51023,65771
4071,2214,72443,99335,1680,81932,104533,534,58900,76573
4069,562,90556,108086,444,98864,115331,118,54643,62828
4068,523,40461,48402,329,43438,51820,194,28125,39682
4066,369,105223,106357,213,165174,127302,156,0,77759
4064,4862,55750,71748,2024,83681,92657,2838,32907,56675
4063,285,38281,69180,111,0,122190,174,24514,35363
4062,7103,83046,95540,5035,91095,104082,2068,50210,64647
4061,976,71596,75855,735,69028,77004,241,0,58177
4057,50,0,0,0,0,0,50,0,0
4056,102,86250,84490,74,85179,80058,28,122941,96207
4055,1940,54387,65496,1040,70833,82849,900,33487,38767
4051,525,56528,78405,289,85430,101280,236,31518,49069
4050,117,76875,105637,71,108194,138272,46,28750,52000
4049,1475,65709,79798,1191,67055,83635,284,43958,57710
4048,1186,62946,68102,774,83229,83080,412,29259,37690
4047,706,54853,65861,463,70156,77317,243,0,42613
4046,3222,80189,92887,2135,93401,112681,1087,43208,49105
4043,5019,86170,108571,3471,89851,128872,1548,45031,58339
4042,2027,71678,80143,1419,85382,88612,608,39181,59283
4041,614,47321,61395,377,53417,67960,237,41103,47696
4040,1571,49183,61416,836,72500,79516,735,24616,35566
4039,3388,82027,99167,2249,95256,111764,1139,42366,70993
4038,6058,88958,105822,4319,107759,124067,1739,47705,57642
4037,1338,51389,64153,865,64783,75712,473,23750,36159
4032,3415,89484,113274,2674,105000,120757,741,47880,81184
4030,741,91771,113099,531,100799,113876,210,0,104252
4029,800,59706,82094,484,85655,108262,316,35000,40117
4027,2259,76411,82609,1780,80700,87865,479,42684,50212
4024,216,56857,66867,135,57179,76476,81,47841,41810
4022,406,64706,85532,296,67115,95634,110,37273,50622
4021,2379,111631,138373,1839,127039,155000,540,80323,77899
4020,618,58365,70561,378,59583,80750,240,27037,50947
4019,35,93558,96903,5,0,0,30,93077,86883
4017,276,50833,84625,141,82917,129270,135,25139,37304
4015,1888,50625,61149,895,87725,85147,993,19672,35463
4011,8295,66699,90656,4738,91311,111940,3557,41744,59164
4010,641,45461,57968,422,51938,67822,219,30764,38095
4009,2429,59505,70683,1517,66927,74190,912,35714,57981
4008,1228,98250,92330,1043,110203,99139,185,29813,41923
4006,77,0,120030,29,"250,000+",194541,48,0,75010
4005,10125,57318,74556,5753,74213,89874,4372,40393,49224
4003,113,89097,74379,88,89500,75999,25,88594,68676
4002,2925,55554,73311,2060,63317,81678,865,44934,49397
4001,1106,54194,77531,793,55563,85199,313,36597,50755
3911,30,0,0,30,0,0,0,0,0
3910,228,77440,121073,139,0,155712,89,75685,65969
3909,4293,98577,118857,2703,119450,137963,1590,50849,85135
3908,2835,86074,107992,2125,97745,117627,710,39103,75569
3907,608,69231,88240,342,93793,111549,266,40417,53627
3906,1887,65030,88641,1231,83574,91093,656,35833,83059
3905,918,93750,104837,500,117206,132173,418,0,70284
3904,3997,61510,84983,2110,98452,111251,1887,34341,55266
3903,2777,78528,93231,2066,83846,106210,711,48021,48665
3902,763,105321,208335,527,124191,268263,236,50139,74514
3901,3349,71362,79736,2174,84586,94063,1175,28250,48603
3894,3021,67481,90502,2022,94444,110241,999,30953,49502
3890,19,0,0,19,0,0,0,0,0
3887,661,74464,89651,509,87292,100342,152,43667,50309
3886,775,62847,71813,452,68555,88790,323,0,48055
3885,2869,126382,160379,2257,135250,182151,612,46786,77931
3884,1341,110972,120671,1159,116884,129822,182,51833,57568
3883,93,65938,63227,79,66335,71005,14,0,0
3882,583,76953,87028,460,80417,87941,123,36719,50115
3878,5272,67293,73287,3283,76406,85851,1989,43947,47783
3875,352,82727,102699,282,81458,109955,70,83295,69246
3874,3973,76315,109769,2571,92022,124043,1402,37203,51998
3873,2200,115667,113730,1757,122852,118386,443,68882,82714
3872,1571,91159,92905,1190,92045,98376,381,0,75056
3871,124,0,167170,40,0,234250,84,0,135229
3870,2180,109143,184550,1534,135781,219012,646,73026,100344
3869,1010,71134,88928,682,88594,105612,328,40577,49821
3868,2305,57263,74823,1412,64623,86732,893,33085,52368
3867,9298,67115,82000,5862,75980,96842,3436,29930,52240
3865,3311,85263,100141,2126,101176,116462,1185,60585,64914
3864,769,53815,111854,515,59226,140603,254,41136,37479
3862,1916,104324,146712,1338,132917,176650,578,47500,63968
3861,1883,97438,119726,1324,121889,141691,559,63585,64800
3860,2027,61514,70894,967,75164,95901,1060,0,44639
3858,1763,121959,126783,1333,121969,129846,430,76719,105651
3857,4066,76731,93678,2170,95313,113081,1896,52551,69560
3856,617,166397,196404,548,170000,187857,69,127083,221116
3855,1015,79896,97712,774,108438,111295,241,51553,50198
3854,418,167500,251185,247,"250,000+",266044,171,79219,229501
3853,329,82216,95820,270,95000,105355,59,0,52188
3852,153,0,81471,142,0,82855,11,0,0
3851,1560,75735,90450,1050,105855,107494,510,40313,50847
3850,114,88000,84368,77,100288,103308,37,0,44951
3849,586,83611,112443,457,78750,120650,129,33472,36049
3848,2747,75430,105257,1586,117813,147457,1161,31503,41572
3847,229,83651,187543,92,76071,63054,137,0,271142
3846,492,64000,90789,266,65921,93452,226,62188,87654
3845,726,59423,84203,273,92969,89621,453,48622,80937
3844,826,140625,178577,645,146750,188230,181,83917,133794
3842,6963,81639,118119,4203,100169,147098,2760,58452,71173
3841,2746,90893,116020,1833,113552,126663,913,67404,82713
3840,1566,119556,148596,1061,127938,157930,505,88352,126178
3839,1548,76378,82351,983,87566,91655,565,59153,62362
3838,523,63650,122037,348,79904,150408,175,49028,65619
3837,726,86000,90311,452,94907,105020,274,67308,66045
3836,572,61071,76760,388,69167,82669,184,48958,61296
3835,2815,63676,76222,1959,77357,86642,856,39514,48452
3833,8997,88010,128209,5514,132027,171564,3483,42198,55753
3832,158,52273,95344,85,73438,124288,73,34135,60095
3830,792,56369,76689,324,72406,108903,468,41742,54187
3827,1131,104866,121714,855,128542,133627,276,48654,80627
3826,883,73860,96813,555,81875,108515,328,44306,68622
3825,3335,99067,118538,2533,124588,137214,802,29758,55073
3824,3206,83289,113665,1713,139831,165437,1493,31823,50242
3823,677,147311,157287,601,155795,164371,76,0,75559
3820,13897,74946,97684,7892,97518,118337,6005,49209,67774
3819,1708,90732,107549,1346,114583,117860,362,40329,56097
3818,1685,60337,74250,1059,76047,83898,626,26081,52807
3817,426,64894,80724,293,81123,109839,133,12401,11361
3816,511,61726,82433,317,70469,82591,194,42803,75481
3814,1042,38095,53361,634,59444,71277,408,18583,25520
3813,1700,51811,72979,892,63730,80779,808,29973,63328
3812,355,35982,69790,81,89018,189922,274,35179,34277
3811,2838,112009,136120,2059,123750,154110,779,53722,87327
3810,717,98858,146067,574,120726,170257,143,0,43041
3809,1370,90833,100767,1178,92361,109582,192,29000,44075
3801,10520,80994,115049,5326,113571,145788,5194,63345,81144
3785,819,47178,64164,531,71473,75436,288,33286,38385
3784,1725,63977,86122,942,74632,108873,783,37988,53186
3782,1051,88194,109601,795,96108,125178,256,48710,56816
3781,896,89224,122748,714,99167,134045,182,39474,78428
3780,250,73808,81947,128,120125,103070,122,73227,59784
3779,310,83750,114472,224,92500,125929,86,56944,76170
3777,498,75833,113685,283,89659,121011,215,53482,103367
3774,761,50191,63860,377,54205,83956,384,27333,40781
3773,3087,66858,80510,1901,80560,89342,1186,56974,62274
3771,340,71379,84056,247,76875,95683,93,22292,46118
3770,103,103750,95469,93,104250,100462,10,0,0
3768,650,128000,184852,496,139444,208817,154,71667,98610
3766,4140,78210,95297,2242,92902,113667,1898,61284,71799
3765,202,67188,91772,138,68782,115986,64,37708,39564
3755,2713,97147,169631,1355,203194,259598,1358,0,77479
3754,13,0,0,13,0,0,0,0,0
3753,1151,121779,134160,903,141116,147669,248,50804,74564
3752,319,54688,69283,204,70000,80512,115,44375,46588
3751,285,34226,65174,108,104000,117121,177,32786,25240
3750,315,168467,163429,281,167807,154240,34,112778,86091
3748,2221,88702,114267,1578,96439,121514,643,60230,93660
3746,65,89750,116363,57,107188,125500,8,61667,51263
3745,743,75552,83543,374,97500,115806,369,55781,50368
3743,5603,47127,59439,3167,59753,70246,2436,30980,39289
3741,1625,73807,92635,1053,89057,96097,572,42344,76019
3740,319,65893,83339,226,78750,96332,93,32083,48039
3609,265,97228,93725,166,115169,124273,99,0,41549
3608,1353,69036,92217,766,95794,118731,587,41250,54752
3607,127,75417,97333,95,85417,107254,32,56250,57356
3605,355,73594,75633,213,83828,89977,142,33125,47415
3604,63,161141,120944,26,0,0,37,0,0
3603,2252,57522,60700,1544,60913,68676,708,27109,33675
3602,1011,55313,82339,612,67292,104562,399,28859,45658
3601,163,68558,70993,123,74107,79760,40,39000,37730
3598,1423,51687,62466,858,62917,77017,565,30865,36470
3597,190,45690,44909,115,46509,49845,75,21406,27559
3595,392,60417,73271,238,88611,92693,154,43443,42731
3593,189,78542,93096,107,102604,109674,82,62500,70937
3592,581,54154,66081,334,73000,87492,247,37898,36481
3590,451,42948,48524,324,43875,51246,127,24219,33810
3588,687,61406,70018,496,65000,72630,191,44155,55225
3586,251,103250,189682,204,119063,218616,47,32917,56774
3585,1020,58929,73034,660,67969,87987,360,35000,42895
3584,1518,60774,76522,908,85347,93625,610,37083,48967
3583,487,56155,70421,268,63125,79034,219,54063,53499
3582,900,42885,54960,584,55658,61605,316,29265,36991
3581,1628,58245,77674,963,82961,102300,665,39053,40471
3580,580,91500,107782,403,109375,124097,177,55208,69248
3579,184,53125,59922,124,63000,67348,60,27500,44575
3576,1360,46071,71845,749,61250,91315,611,35230,43601
3575,6,0,0,3,0,0,3,0,0
3574,1146,56406,66864,703,71750,78912,443,28162,44841
3570,3998,39091,51084,2374,58000,64519,1624,21754,25798
3561,2858,45073,87814,1546,65904,126656,1312,34395,39807
3470,1856,62611,70794,1099,70764,80511,757,42474,52435
3467,850,93500,98790,675,97131,108126,175,41771,58638
3466,698,93177,98803,643,94609,105434,55,0,21287
3465,729,52107,72132,470,76667,82925,259,26989,46244
3464,382,76563,92293,261,90938,107234,121,32463,52071
3462,645,73727,108779,437,95938,138681,208,31058,41050
3461,1817,80729,92777,1324,95114,107675,493,47009,48645
3458,3165,95029,122325,1902,104561,142452,1263,57926,80384
3457,277,90208,115441,205,96146,120679,72,56250,96442
3456,328,87000,86006,242,101439,97657,86,43750,51306
3455,1000,69000,102994,604,96250,102481,396,34076,101252
3452,2276,62747,83021,1282,87714,97694,994,50526,63742
3451,1615,59961,72733,1181,63839,79937,434,46250,49197
3450,374,83879,123641,283,98594,140679,91,53125,66619
3449,798,70833,97088,472,93457,118979,326,49432,65393
3448,285,71635,79805,204,76375,87624,81,55125,54325
3447,1009,68785,83075,609,83359,90280,400,45625,67009
3446,2725,69180,73286,1708,87794,88663,1017,30481,43253
3445,286,83333,89129,194,83333,100379,92,44000,54251
3444,652,85543,104044,495,86847,114686,157,34464,67304
3443,125,69308,95946,112,69018,98449,13,0,0
3442,695,62802,79736,397,72180,96385,298,47647,56362
3441,66,31071,35008,32,35000,32094,34,31071,32571
3440,1109,71012,93566,755,85625,102989,354,53333,60690
3431,10045,57100,76342,5173,77634,98749,4872,34618,49881
3307,2179,75493,85934,1670,76732,91456,509,50022,57072
3304,2738,124904,147526,2362,129750,158650,376,54545,73796
3303,6437,75250,83638,4092,88061,96680,2345,44859,54049
3301,13565,69673,93081,8094,89898,118339,5471,36736,51614
3293,57,0,128039,29,87813,88224,28,231389,169275
3291,24,0,0,24,0,0,0,0,0
3290,1950,82802,115266,1450,96117,129463,500,59708,63250
3287,667,95938,120250,450,104444,145207,217,39688,66018
3285,1020,74722,80788,721,83365,88462,299,60568,58526
3284,318,92188,89947,262,91250,93933,56,29688,47116
3282,403,77917,89765,316,95726,95183,87,41625,61431
3281,3279,95775,105052,2499,110850,122566,780,34388,48321
3280,466,73929,83703,373,77083,91046,93,38068,48331
3279,270,45882,70439,163,54107,86166,107,36250,44421
3278,1244,68810,87366,839,87688,102141,405,27679,49062
3276,3393,57355,73024,2169,69292,87825,1224,34873,42273
3275,4477,79110,87205,3138,86379,98891,1339,44543,50547
3273,110,137778,120638,94,128750,122074,16,0,0
3269,1115,70550,98088,762,102424,118144,353,33388,51897
3268,587,83967,88973,405,99226,108331,182,0,38880
3266,794,60104,75239,467,73155,85926,327,39938,57023
3264,2510,57775,67959,1492,59921,81424,1018,29041,47063
3263,1778,57351,69106,1035,84263,88414,743,31708,40013
3262,501,58689,81979,300,84500,98124,201,55917,53183
3261,1697,93672,101376,1309,115086,107302,388,44250,74323
3260,411,106719,117190,349,109479,122722,62,48500,81006
3259,233,69388,92484,117,73661,110062,116,68977,74753
3258,1041,98542,104290,819,103977,107828,222,75588,86450
3257,1520,78108,115464,903,117679,152345,617,36250,59988
3256,932,67879,78916,655,75779,87433,277,44946,57812
3255,797,97991,118572,568,105227,138872,229,45625,67451
3254,1809,74983,117612,1323,85417,137694,486,55417,58726
3253,3089,54592,87128,1777,91792,115754,1312,29289,45172
3251,542,52619,63287,366,54762,67175,176,29048,34328
3249,3016,92048,121972,1957,112800,155739,1059,48813,55188
3246,7075,55494,73931,4229,75400,89974,2846,35750,47393
3245,814,80238,96568,486,99844,118345,328,55556,61609
3244,2831,81739,99548,1980,88378,114386,851,50219,58557
3243,334,81613,91291,210,87500,107493,124,59167,58303
3242,1828,83538,90389,1142,113750,115611,686,29156,45614
3241,366,74286,102196,257,76964,113840,109,43125,70099
3240,512,66176,81500,337,73681,95577,175,39948,48989
3238,47,38125,41898,17,0,63429,30,38194,29697
3237,743,78750,91234,586,80761,96513,157,46806,62796
3235,3969,58014,69149,2423,70191,83025,1546,29528,42636
3234,1721,96840,107956,1290,108696,125416,431,41458,49666
3233,151,110508,134011,151,110508,134011,0,0,0
3231,103,81875,81828,81,88542,101190,22,0,0
3230,620,58462,76426,429,75764,91572,191,36648,40590
3229,2214,92667,126781,1761,103717,142865,453,57633,62423
3227,608,156500,184403,312,105000,135091,296,0,235564
3226,412,90217,102968,323,104904,115373,89,56250,57188
3225,1343,76250,89594,1035,83393,98471,308,49524,47695
3224,918,99000,115056,666,113750,132574,252,44000,53059
3223,1302,72059,83537,726,103026,102186,576,41865,55915
3222,2284,66367,73512,1534,81886,88170,750,31330,41372
3221,845,74107,113466,542,100938,146162,303,36827,49519
3220,3104,61515,84763,2193,86550,91644,911,35159,61223
3218,433,78818,75678,294,84222,84032,139,24810,48937
3217,921,47440,59720,530,59219,58013,391,35724,61582
3216,901,74826,93715,637,91063,105860,264,44839,54134
3215,111,76750,116806,71,122813,150059,40,0,57783
3110,7912,135374,163986,6478,157514,185698,1434,53159,58255
3109,4008,82926,96404,2661,105947,110073,1347,54657,65125
3106,5130,82230,111796,3526,100403,127446,1604,50294,67089
3104,13903,68492,89136,7362,92865,113166,6541,46907,59328
3103,14797,57681,73014,8425,61477,81400,6372,47813,55838
3102,13977,56592,68425,7260,70965,79534,6717,36815,51315
3101,1689,49266,80355,542,118030,115305,1147,40806,63387
3087,5024,154032,176225,4245,158358,186403,779,64583,99929
3086,1679,76436,96164,972,100921,122050,707,42358,59092
3084,506,81250,100460,295,118542,130262,211,45139,54526
3082,621,94803,117788,484,110250,128039,137,66250,74492
3079,11885,90673,114814,8290,109832,133967,3595,41422,66600
3077,4102,76327,86811,2782,82375,96408,1320,54444,59568
3076,4755,108223,125934,3835,120667,137179,920,62045,68461
3071,1855,82668,102088,1376,83993,101368,479,74563,96206
3070,2104,135048,141791,1575,129191,151102,529,135151,109780
3064,6128,69957,90097,3506,90550,113632,2622,41746,52848
3063,6775,90053,104206,4160,106948,120081,2615,56833,74973
3062,11695,88272,112011,7371,105561,130257,4324,58958,76878
3060,11848,53169,75496,6475,71777,91311,5373,34840,50694
3057,929,125037,148017,781,134750,158369,148,76500,87090
3055,6434,74214,91201,4193,94295,106816,2241,39994,59601
3054,9956,108276,119368,7273,118977,135459,2683,57489,71523
3053,9433,111958,127830,7357,126432,141173,2076,53049,69395
3052,3020,113000,126119,2467,118535,135244,553,60764,73184
3051,9396,110156,122926,6863,119405,136759,2533,52782,73644
3049,2959,131745,174778,2317,143425,200784,642,53214,76250
3048,1501,86875,91682,1029,96758,104600,472,42222,59172
3047,669,86625,116918,508,96056,132454,161,48750,58659
3046,1003,130298,141778,841,134522,149073,162,43125,91718
3045,5181,95904,110754,3727,109148,126585,1454,55918,63271
3044,1679,111984,112215,1359,115853,115872,320,74712,91494
3043,619,103813,129425,485,106750,138847,134,68214,84413
3042,2730,86117,98537,2092,102931,110147,638,50577,51230
3038,12844,78114,97088,8992,93495,109960,3852,50064,58794
3037,1616,110741,128536,1274,112006,135287,342,77917,93373
3036,1744,133214,142404,1518,132292,145353,226,89063,105950
3034,1515,100196,117062,1093,116250,136708,422,42841,64215
3033,1738,142033,162222,1533,150820,174463,205,55150,58394
3032,1924,110217,134790,1635,113963,135388,289,87019,91671
3031,4339,136221,166046,3375,156914,188564,964,67419,85328
2921,4622,105927,118855,3526,120045,137236,1096,32833,58539
2920,14009,68041,82148,8207,86265,98549,5802,35089,55676
2919,11517,68955,82901,6970,94573,102075,4547,42533,49086
2917,4729,84923,96247,2803,104685,120334,1926,41190,58639
2916,3758,86500,109045,2395,105982,133407,1363,48750,62877
2915,7150,73041,81747,3992,96633,105742,3158,31573,49686
2914,9073,49697,72487,5123,67656,94124,3950,25524,41626
2912,0,0,0,0,0,0,0,0,0
2911,6639,66948,76331,3766,77500,88440,2873,51053,53823
2910,8516,72960,84951,5633,78216,94830,2883,47051,59457
2909,14507,43872,56483,8616,53012,63842,5891,31026,41998
2908,13431,56338,72225,8069,64261,75933,5362,40918,61304
2907,10081,40212,50069,6987,41223,52388,3094,28419,40134
2906,11218,83358,131988,4905,138840,198615,6313,59045,77864
2905,9509,43700,69602,5615,62156,86490,3894,21152,41133
2904,11804,49146,69562,6414,68683,86125,5390,30437,44845
2903,4826,46372,91542,1006,91719,142129,3820,38519,78221
2898,500,67679,71256,347,85703,83854,153,45663,42683
2896,4634,84787,102577,3193,113004,124872,1441,30707,47991
2895,16515,44310,60734,9497,55818,72934,7018,27722,39476
2894,265,72642,75231,76,134615,136220,189,51549,50706
2893,13359,60813,73801,7159,73862,89061,6200,43106,53129
2892,1899,111250,130653,1614,109063,125516,285,49057,66932
2891,9805,78007,98096,6041,103502,122905,3764,41178,56292
2889,11454,75622,91614,7448,89085,106786,4006,41587,55486
2888,8156,74282,92752,4948,89767,109638,3208,36621,62788
2886,12725,71887,86849,7103,89927,107826,5622,40362,57538
2885,4992,64182,82155,2808,97500,108241,2184,33112,43703
2882,5956,79630,119285,3452,122940,164145,2504,27264,56567
2881,914,101311,114045,624,111750,125929,290,49333,87082
2879,8914,93262,112904,6084,111857,129795,2830,45763,72482
2878,6452,83710,103025,4520,99670,121175,1932,46682,57060
2876,307,0,44281,106,80857,58557,201,0,36753
2875,179,107434,119818,108,185389,154284,71,0,0
2874,2463,127563,144921,1579,147054,172929,884,68462,92550
2873,43,146250,146505,43,146250,146505,0,0,0
2872,101,41985,52099,39,0,70572,62,0,40479
2871,7193,100019,136715,4896,127664,168672,2297,45098,67545
2865,6625,97111,116797,4520,115750,143187,2105,49577,58003
2864,13203,97296,112041,9403,110862,130311,3800,33100,58963
2863,6086,34689,45737,4315,36928,47739,1771,18363,34390
2861,9952,68700,80789,6312,79133,91321,3640,44417,56873
2860,18025,46577,61518,10936,58858,72170,7089,29246,40094
2859,2687,96308,95942,1916,106109,108084,771,56734,61759
2858,190,91625,110541,190,91625,110541,0,0,0
2857,3189,90563,108642,2424,101065,121794,765,57159,63414
2852,8851,88193,110651,6196,114773,132984,2655,44021,55977
2842,6773,81499,100423,4352,94074,113627,2421,57210,69007
2841,0,0,0,0,0,0,0,0,0
2840,10116,67944,99201,4988,96071,122552,5128,48176,74170
2839,808,70755,79226,561,75804,86333,247,40880,45050
2838,1255,60313,72037,729,64428,82838,526,43929,50227
2837,1556,105750,181598,1176,121196,206895,380,56829,102643
2836,78,85978,71158,11,0,0,67,0,0
2835,2387,119375,161627,1714,149440,202898,673,46181,55402
2833,407,89077,74322,280,97000,96960,127,20610,22123
2832,1926,84935,109074,1501,108250,121334,425,50110,57468
2831,1322,111462,133497,808,115714,126605,514,110683,122631
2830,2247,100264,102615,1497,105179,119525,750,42118,64219
2828,3145,87409,105923,1945,106399,123542,1200,42474,74663
2827,822,85214,95011,634,87632,102317,188,50357,66546
2826,161,92083,87121,145,102582,91545,16,0,0
2825,1863,96787,112056,1414,108869,125765,449,53594,68144
2822,2022,79242,108738,1487,102173,129649,535,36645,46559
2818,7823,106888,148712,5130,137727,187323,2693,56189,72384
2817,2352,120484,118650,2130,116176,117576,222,0,86478
2816,13394,84533,99650,9288,97315,114966,4106,44167,59481
2815,62,176912,153942,19,0,0,43,0,135309
2814,2974,89795,102293,2108,104662,113162,866,50526,67552
2813,3438,80327,107888,2378,92262,123203,1060,51900,67025
2812,470,122059,124815,405,136875,137271,65,0,35237
2809,8122,73992,101929,4939,99924,127288,3183,44725,60490
2808,910,74359,76231,639,87135,93980,271,21880,28991
2807,400,72500,78416,213,82802,80979,187,58359,71640
2806,5854,125187,186023,4629,147314,214696,1225,53075,70224
2804,780,110048,123417,668,112500,131437,112,0,73696
2802,240,103750,84615,137,107299,110149,103,0,0
2791,229,68750,82839,141,107863,100843,88,0,53992
2790,6421,76134,104708,4701,87766,111262,1720,44932,75659
2780,19649,59663,77553,12540,74496,87891,7109,38029,50173
2779,2267,106515,124084,1744,109408,127904,523,105363,98127
2777,6580,95945,103446,4757,109097,118812,1823,43618,54209
2771,5958,94611,117967,4608,108722,128745,1350,49063,77583
2770,1909,106327,139242,1408,131007,158977,501,79550,74670
2769,4241,118470,131472,3283,130277,145765,958,56468,77970
2767,5458,107297,120194,3935,122731,143349,1523,39375,56728
2766,6843,108435,123875,4880,119459,138932,1963,67516,81926
2764,1412,94844,102111,1090,104500,111301,322,42398,56328
2763,694,93986,120520,397,143897,168739,297,49053,56066
2762,3727,93388,110213,2658,106406,123069,1069,52484,71787
2760,10623,91592,115248,6883,116219,142534,3740,45383,59534
2748,4675,89883,119016,3087,124514,149967,1588,40260,54719
2747,7155,83459,98479,5476,101603,112459,1679,34939,46225
2746,6324,35915,50103,3536,38474,56256,2788,22744,37127
2745,9802,62280,77943,6407,82033,89738,3395,33897,45232
2744,4739,45628,58045,2707,51473,62779,2032,30027,46688
2743,4158,74035,90265,2937,86969,103237,1221,38971,51332
2740,18125,47514,63064,10198,63894,76049,7927,27477,42157
2739,2895,90747,139473,1904,114976,166469,991,54148,85485
2738,1946,85636,130376,1247,102357,150957,699,56830,92469
2726,6159,88587,99536,4543,96779,111313,1616,47179,60783
2725,959,98459,185370,736,99906,220603,223,0,68743
2724,7887,40888,57821,4833,49040,66786,3054,26624,35970
2723,7124,44525,62735,4019,47403,68820,3105,26479,48832
2721,10372,42973,58472,6180,58505,72988,4192,21882,31688
2720,13199,52753,65242,7825,59317,74407,5374,37723,47530
2719,6767,75645,99740,3808,98409,126755,2959,38344,58956
2718,2344,89385,111691,1683,101034,120390,661,82594,85644
2717,1699,105240,122616,1420,109262,128199,279,0,60124
2715,1475,100596,113561,1079,129539,140776,396,30606,39408
2713,22,69167,141141,13,114375,209915,9,0,41800
2703,17491,77107,97454,11441,97495,115902,6050,36431,54169
2702,1673,100268,110853,1211,108935,118250,462,80615,87460
2675,2989,84404,112881,1976,102794,130791,1013,45938,77640
2673,3775,65922,81261,2417,73872,93149,1358,42083,54662
2672,120,0,127829,97,0,147104,23,0,0
2671,475,78266,94589,329,87396,117389,146,47889,43212
2670,710,77500,108312,362,127917,150048,348,44844,64897
2669,53,0,0,53,0,0,0,0,0
2668,1098,96165,121870,662,97387,143706,436,90306,88716
2667,1470,82696,107612,965,103961,130204,505,53580,61982
2666,227,67928,83763,121,0,126240,106,22153,35274
2664,3989,66283,87489,2463,89632,104752,1526,37679,55778
2663,54,0,118606,23,0,0,31,73625,66906
2660,2898,65093,81466,1767,93032,102101,1131,31505,47810
2659,510,54167,102335,229,103281,170095,281,36146,46915
2657,1725,71495,118648,665,89875,142419,1060,57917,103325
2655,1460,88816,140777,966,105513,165561,494,68289,91626
2653,2822,77318,118794,1733,108958,147674,1089,37361,71801
2652,466,75049,98886,114,81250,83280,352,70714,101940
2651,7,0,0,7,0,0,0,0,0
2650,391,82212,147976,284,91563,177460,107,46217,66046
2649,6552,78309,99606,3969,107803,127323,2583,41484,53952
2648,2906,105721,112986,2092,119524,123987,814,71528,77838
2647,68,82900,150222,25,0,0,43,0,0
2646,864,70000,107996,452,97222,152376,412,48167,58780
2645,4197,78823,91955,2734,92857,109816,1463,45384,55792
2644,1525,89236,100806,1047,126328,122222,478,31442,53861
2643,0,0,0,0,0,0,0,0,0
2642,2447,66996,86036,1486,92692,108004,961,37539,50762
2641,117,0,131102,68,168700,190519,49,0,0
2639,1581,47197,70203,888,53152,82611,693,41487,52515
2638,1499,86968,108863,998,92807,116737,501,69219,80654
2637,75,191477,228085,75,191477,222712,0,0,0
2635,1371,64112,90111,925,69763,109564,446,52667,49765
2633,2053,81696,113885,1264,110139,142118,789,45298,66688
2632,4781,98852,115559,3514,115181,123490,1267,65134,84498
2631,4360,82814,105470,2726,107944,127729,1634,44821,66101
2630,750,115833,189678,555,128933,229744,195,61763,69784
2601,6253,56646,74506,3268,70995,91856,2985,35012,48751
2584,0,0,0,0,0,0,0,0,0
2576,1828,64267,99819,1083,85972,128527,745,40825,50042
2575,819,98843,115097,496,117500,151362,323,0,59409
2571,4804,72100,86550,3103,94583,102249,1701,49894,55293
2568,1932,52711,68629,998,58511,85513,934,49226,50385
2564,51,112841,103175,40,114091,116858,11,0,0
2563,4099,98497,123143,2850,120714,147000,1249,58125,66293
2562,1151,104917,122846,853,123646,137640,298,56304,66346
2561,105,146875,147152,63,197596,199238,42,0,0
2559,1596,73011,93272,905,92930,123568,691,32339,49522
2558,968,44767,59350,392,64960,85279,576,33955,41704
2557,1873,90313,127266,1013,106992,161651,860,80208,79433
2556,1078,100543,140568,731,141641,163378,347,67821,92517
2554,3658,112241,160727,2491,116284,175114,1167,59844,102709
2553,96,0,0,0,0,0,96,0,0
2543,378,82857,221781,180,115455,328198,198,65938,125038
2542,306,53108,73596,260,39746,75404,46,0,0
2540,4081,75809,111686,2324,127747,153509,1757,38075,56138
2539,1449,78419,102054,1015,102917,107446,434,60104,87233
2538,1564,80515,81300,1148,81667,89723,416,34038,45359
2537,2518,114737,138083,1807,141953,158659,711,68047,85792
2536,8446,72634,104302,5170,87652,126567,3276,46160,63522
2535,792,98354,172772,582,106071,194889,210,50192,107068
2534,369,141023,218476,308,143019,246251,61,71629,64952
2532,5950,73529,95469,3448,90206,108555,2502,43659,72576
2494,3633,139770,216661,2841,200885,253239,792,45156,79797
2493,3730,206250,308880,3056,"250,000+",353384,674,52885,95599
2492,7132,184688,239712,5877,215571,271273,1255,76641,91495
2482,3812,201548,261461,2802,"250,000+",313477,1010,65968,116704
2481,4495,227898,341106,3896,"250,000+",370461,599,71472,125489
2478,9846,140091,193502,7229,170580,229963,2617,64024,87635
2476,7558,113978,160092,4354,147333,213749,3204,61650,84871
2474,11560,115000,142503,7430,147667,168458,4130,70146,92377
2472,16288,100399,127347,8911,117438,152681,7377,75917,94339
2468,1886,"250,000+",324534,1753,"250,000+",338475,133,83250,137072
2467,6594,150223,208834,4253,200123,269280,2341,81339,96025
2466,3014,118333,170857,2035,151297,208174,979,37957,82524
2465,4400,157449,229039,3151,188973,270149,1249,118750,114037
2464,1352,123098,152670,954,146250,175142,398,68333,90819
2462,527,97344,163191,328,161875,224329,199,50625,55848
2461,2536,171855,203597,2114,202372,225300,422,75833,83950
2460,3717,126185,167466,2635,153050,198751,1082,73929,81279
2459,6173,189589,252054,4897,213664,285318,1276,88984,118389
2458,4836,120385,167635,2990,181591,212596,1846,65761,91925
2457,19,0,0,0,0,0,19,0,0
2453,11502,87922,104896,5569,103693,120561,5933,72980,88943
2452,4965,99747,116529,2527,125099,139899,2438,73056,87031
2451,7278,105536,129740,4258,134167,156925,3020,67788,88614
2446,13277,99383,149530,6073,147182,221640,7204,67301,87321
2445,8675,126094,190159,4467,171453,260094,4208,88281,113458
2421,6861,180943,227852,5313,221188,266771,1548,70000,91642
2420,5095,198110,264130,4158,229924,295982,937,57344,116845
2382,5596,88932,99820,3863,100359,113176,1733,43802,61037
2379,2503,105377,115034,1843,120764,132497,660,50588,61853
2375,4404,102161,128280,2973,128597,153702,1431,48973,66645
2370,6806,80783,93312,4484,103125,111554,2322,45625,54597
2368,11727,87803,105255,8579,95259,114483,3148,54597,72428
2367,993,107734,133798,844,112778,143820,149,0,64061
2366,0,0,0,0,0,0,0,0,0
2364,5234,95197,114011,3687,120949,133208,1547,42943,57395
2360,24412,92757,119795,16720,115425,139187,7692,49540,72497
2359,6643,119827,134281,4923,142825,153790,1720,54476,73301
2357,20,0,0,0,0,0,20,0,0
2356,4514,114177,155300,3279,151587,185151,1235,59250,74423
2351,6081,106001,110883,4357,122725,125417,1724,41149,63478
2347,4091,109297,123622,3218,122083,135677,873,55380,70844
2346,9922,77455,104210,6549,91250,118593,3373,61319,69935
2343,4352,79718,95740,2920,111216,116467,1432,39118,51106
2341,3872,100455,123049,2835,121867,145857,1037,38893,53870
2339,4663,133922,167440,3772,145179,178412,891,47891,109995
2338,2901,97844,109332,2039,105396,126329,862,38750,66903
2333,4899,102669,134594,3851,118818,151868,1048,47143,57429
2332,5800,126889,178657,4436,159184,207248,1364,59615,80828
2330,4609,61374,86593,3002,83707,103456,1607,42614,51351
2324,8367,100747,119998,5857,121523,138797,2510,50326,73034
2322,1634,97353,102493,1077,107434,107009,557,80156,91422
2302,10784,70986,89657,8085,78568,99900,2699,32607,45445
2301,20675,57977,78059,14361,71984,87495,6314,28304,45060
2215,8055,55468,85058,1749,110250,147113,6306,42647,67735
2210,2711,170920,239943,841,210250,273221,1870,141536,224304
2203,24,0,0,0,0,0,24,0,0
2199,914,106250,193135,381,"250,000+",275335,533,77765,134376
2191,3606,89234,100868,2154,106591,119249,1452,60401,69132
2190,7535,87424,109040,4546,127556,130460,2989,63531,73975
2189,6239,75152,93936,4102,93882,109054,2137,45014,59526
2188,7012,93160,102154,4316,108921,121134,2696,57838,70330
2186,8656,141050,183000,6787,173031,207289,1869,39653,83906
2184,13751,101544,125998,9377,130308,147655,4374,61171,72967
2180,9829,103104,123046,6178,135849,151045,3651,60769,72511
2176,11238,114604,138914,7334,148070,163887,3904,55469,90459
2171,7965,85586,112567,4065,106448,133939,3900,66486,88188
2170,7633,85821,101246,3911,90548,114674,3722,72478,81164
2169,25724,76636,92045,13533,95329,107180,12191,57872,72198
2163,473,57989,71193,85,0,57235,388,58587,74251
2155,23819,101266,125819,13008,125332,143947,10811,75707,98774
2152,8061,76996,103864,4289,104087,132543,3772,52409,68334
2151,18571,68199,82932,11561,80563,94710,7010,36744,53792
2150,13158,60305,73388,7592,62985,80267,5566,33774,53033
2149,16107,70627,83774,10992,75847,88770,5115,41519,59302
2148,23367,73399,93786,15080,86006,106462,8287,46740,65519
2145,11490,90491,109757,5807,91250,111238,5683,85790,100835
2144,10939,111549,135332,3850,132270,161492,7089,102054,120407
2143,11363,105193,127194,3794,124545,156811,7569,95276,109359
2142,1943,134575,193473,771,165625,233073,1172,120750,166750
2141,6846,87739,113792,2557,106987,136703,4289,84901,99177
2140,9384,114256,148295,4162,156144,190291,5222,96619,113012
2139,15224,108832,142427,6603,132004,176921,8621,86203,113355
2138,14312,104641,156896,6176,164286,228863,8136,74720,100673
2136,12242,76704,94138,8646,84080,106286,3596,44333,54291
2135,19739,83383,97365,6500,101540,121557,13239,74694,84349
2134,8308,66095,84615,2471,84975,98471,5837,57589,77261
2132,11454,117083,134479,7219,146992,169641,4235,56208,70677
2131,12625,87083,106423,8163,96406,120384,4462,55109,72874
2130,17680,102088,130698,8253,125193,161106,9427,81256,100243
2129,9390,131064,166500,4587,159215,204229,4803,98750,127663
2128,17123,63378,87285,9221,60562,88937,7902,51282,71502
2127,17109,122599,146037,6570,134878,159348,10539,116067,135789
2126,9968,55126,82219,7105,62200,91504,2863,35599,46329
2125,13063,60862,86598,6784,66626,91790,6279,44424,78687
2124,19555,63118,84106,13245,73809,89483,6310,34208,63219
2122,8656,72158,91440,5006,73529,94983,3650,49150,75890
2121,10740,36479,64890,6651,45596,69228,4089,27709,52677
2120,4973,46843,61500,1941,47949,61898,3032,41115,58824
2119,11738,32424,53861,5656,48566,70855,6082,18548,36077
2118,13672,62850,136215,5395,86492,191166,8277,49583,98561
2116,12014,115825,213098,4445,199625,318515,7569,89638,150380
2115,9276,45827,80801,2127,56771,132450,7149,37115,65099
2114,7235,107162,151154,2065,199591,257922,5170,84183,107428
2113,4286,97686,137447,746,130278,229045,3540,93649,118040
2111,3626,52663,138477,1606,50000,183043,2020,53750,103044
2110,1325,111971,283939,636,153843,370904,689,69911,174083
2109,1892,156119,223066,660,"250,000+",317803,1232,128571,172315
2108,2046,152442,256003,707,237292,370812,1339,106982,193832
2093,4290,136563,155111,3163,157011,175756,1127,50060,90027
2090,5374,159776,209050,4281,177253,237740,1093,51875,83480
2081,7068,124528,149206,5264,153162,172852,1804,53568,77278
2072,11052,90201,108995,7836,105938,124725,3216,49390,65346
2071,250,114044,125102,229,113272,113755,21,0,0
2067,6436,144280,196994,5354,161149,220214,1082,72545,71778
2066,7461,127646,177695,5258,156111,207166,2203,63799,100937
2062,12157,90341,115978,7730,111818,135656,4427,59250,79292
2061,3519,162091,192810,2920,180000,215608,599,48309,78104
2056,3116,159914,179735,2579,175598,198690,537,62135,80746
2054,3110,114255,135612,2443,137509,149040,667,67031,79711
2053,4712,139688,163387,3583,156031,187168,1129,56650,83444
2052,4362,174417,232475,3721,201290,261654,641,39340,57857
2050,9992,104209,125477,7025,127461,150931,2967,49384,62380
2048,8925,120694,145497,6607,140694,167098,2318,53294,73687
2047,72,87174,147669,41,0,0,31,0,0
2045,4473,105403,129331,2584,133245,162427,1889,59688,77754
2043,9121,147520,208083,6359,210027,270735,2762,37553,61884
2038,12414,118193,145175,8881,148002,170222,3533,54250,79509
2035,7081,92978,131709,4706,117439,164001,2375,40542,61704
2032,1412,158065,178944,1161,179306,197217,251,86309,94424
2030,2013,"250,000+",379360,1784,"250,000+",408728,229,135063,150148
2026,10491,101730,133320,6464,141534,167545,4027,59596,76354
2025,3231,141036,215898,2319,207375,272666,912,35870,68645
2021,9238,107442,139759,6164,138070,172805,3074,53567,67338
2019,6548,103258,114449,4535,119817,130771,2013,41910,67006
1985,1720,151500,183885,1460,161071,199821,260,67045,69929
1984,1361,142734,178589,999,149181,204581,362,34833,83944
1983,2159,144258,162811,1818,166063,177336,341,40531,69774
1982,2720,115203,142625,2226,131897,158208,494,48846,69639
1970,19025,66495,86897,9762,85306,103718,9263,47546,65816
1969,2269,118851,159756,1898,122929,159980,371,72813,149947
1966,3402,87149,110614,2087,109740,135579,1315,53819,67349
1960,21944,80679,99674,13531,102908,118261,8413,43189,64889
1952,3914,81755,105930,2324,98581,116008,1590,57206,86489
1951,1477,115719,164732,1203,121964,183411,274,68750,78412
1950,7419,110740,144787,4788,139539,168843,2631,73365,97457
1949,3062,145525,189768,2332,146856,208245,730,85819,116422
1945,8126,131293,187953,6050,167250,220347,2076,60769,90059
1944,2128,178250,204482,1499,218618,245835,629,54646,90469
1940,4868,136023,176518,3733,161008,202597,1135,54931,89145
1938,5653,103941,155373,3601,135284,202484,2052,45183,69834
1937,0,0,0,0,0,0,0,0,0
1930,13410,76260,98993,8236,96083,122137,5174,43051,59984
1929,1371,109323,128271,982,122917,141462,389,65903,83969
1923,10652,99269,115627,7023,115659,135841,3629,52726,67524
1922,1163,176250,187605,837,234972,217124,326,41250,99122
1921,2853,179375,232525,2506,195000,250979,347,0,97974
1915,16568,84354,117089,9734,119000,150108,6834,46457,66802
1913,7404,81027,106197,4926,106536,131352,2478,44757,52032
1908,1723,94243,137379,937,136821,186611,786,66667,75144
1907,6157,100927,145173,4341,134185,177278,1816,52292,64596
1906,10207,88348,109091,7273,101310,125859,2934,43738,59631
1905,8338,62623,73396,5480,65928,79402,2858,35184,52683
1904,6215,87639,103340,4675,99727,110846,1540,51064,63502
1902,17594,52834,67583,10826,66114,79156,6768,26094,43004
1901,1079,26403,42348,594,41889,46685,485,13487,37036
1890,8065,173058,237695,5914,221056,285228,2151,64949,102054
1887,7882,133873,150413,6274,147500,167754,1608,61404,73082
1886,8544,149437,165288,7222,161410,181230,1322,46500,70580
1880,10479,104609,134194,7300,130179,154442,3179,62083,81582
1879,4181,114313,143130,3155,142680,169298,1026,46806,54800
1876,11808,105480,120712,8156,126899,143433,3652,51598,64872
1867,9374,131515,147301,7032,163158,174654,2342,52112,62825
1864,5824,123042,162654,4331,143398,185838,1493,58905,90296
1863,3676,112568,121096,2466,122603,139071,1210,61167,68880
1862,3737,107964,115061,2481,122104,129732,1256,64375,73173
1860,2800,79909,101766,1967,105801,117671,833,37311,58255
1854,10061,55461,73000,5508,64480,82723,4553,29439,56955
1852,14020,65445,79918,8034,78227,93892,5986,39943,56459
1851,10812,69548,87939,7065,80836,98561,3747,40709,62768
1850,5367,55837,67098,3786,63325,73866,1581,38059,41101
1845,11226,113916,155181,7733,150339,186351,3493,53852,80605
1844,17610,83532,101885,12931,97293,114000,4679,40768,55930
1843,8838,54283,72787,5980,57353,78751,2858,34792,51169
1841,15384,45486,57975,11266,49063,62482,4118,16473,33587
1840,2330,25077,44025,953,34301,63641,1377,16465,29079
1835,5146,84638,100522,3418,86469,108238,1728,66623,76736
1834,2460,111056,126406,1787,128582,138280,673,65598,87682
1833,3322,122600,140384,2440,138472,156513,882,58438,90574
1832,9299,67016,82398,5777,78556,91734,3522,46103,56980
1830,10167,62318,87149,6312,88250,104955,3855,39261,51478
1827,1155,158523,170821,969,174375,182617,186,51250,67560
1826,11696,92533,103762,8308,105445,116506,3388,45972,66424
1824,9595,123087,142073,7084,146239,163262,2511,62750,78618
1821,11879,116445,123465,9071,123935,131166,2808,71389,91721
1810,12926,153315,194737,9773,186057,228995,3153,63438,80911
1803,10625,121433,148658,7547,145377,176757,3078,51517,74611
1801,15901,92084,114822,10405,108489,130944,5496,63350,80508
1778,4761,192961,237882,4013,222672,265037,748,72241,88047
1776,6301,195073,236123,5435,206033,256849,866,56964,103723
1775,2569,143711,167832,2219,151399,181874,350,58194,69756
1773,2055,156607,258590,1390,246591,320864,665,61691,126946
1772,3289,163438,226378,2592,185962,263199,697,61964,80531
1770,1478,216406,241886,1278,225735,265107,200,50000,87952
1760,14830,115588,151642,9590,156239,186101,5240,59383,81799
1757,11064,86203,99985,7732,100893,116516,3332,42191,52110
1756,2059,126806,147815,1742,150573,161530,317,68173,68540
1754,4285,107891,133920,2861,140353,166931,1424,49058,63757
1752,16044,83469,102669,9961,101700,118498,6083,48368,72231
1749,7813,96038,116166,5275,130117,142150,2538,49295,60067
1748,6468,172683,231252,5271,206901,263438,1197,70744,87478
1747,2073,110582,119906,1508,117000,138056,565,53480,63278
1746,5452,137589,176854,4302,166176,205776,1150,50948,66435
1745,246,125000,175712,140,127500,230401,106,123500,103481
1742,6464,160448,224988,4619,201991,275059,1845,65383,95544
1741,1775,197530,234371,1370,238803,267321,405,0,117994
1740,1777,167708,182013,1426,185714,197705,351,100208,109927
1731,531,105625,115985,512,107083,118164,19,0,57268
1730,5286,133824,179793,3505,176908,213373,1781,78835,112762
1721,7124,118348,142742,4903,145100,161476,2221,73040,93377
1720,8527,138750,169321,6226,171370,199225,2301,59970,82334
1719,2259,126597,155919,1389,190795,206029,870,51212,75916
1718,209,142813,150731,203,143438,152675,6,0,0
1702,14926,67048,91645,8938,81662,107607,5988,49829,62937
1701,13503,116971,142222,9564,142720,165197,3939,53036,82189
1612,1621,116313,144399,1226,141964,162123,395,85257,71073
1611,751,100375,110153,570,114324,123159,181,58631,69198
1610,7715,33326,46829,3304,41974,55045,4411,22807,38109
1609,7816,45679,76762,3479,78558,110536,4337,27009,47244
1608,1881,31504,43272,811,20677,32264,1070,35855,46187
1607,3751,53838,64755,1828,70036,79534,1923,37866,47553
1606,8328,72050,90739,4505,101046,111417,3823,48695,63475
1605,10702,42683,59924,5676,49263,68629,5026,31920,45936
1604,15426,59123,73560,8938,66842,81949,6488,43295,57346
1603,6919,45969,64316,4110,57756,74322,2809,26662,42052
1602,9820,71239,89030,5973,90046,106568,3847,41895,58246
1590,3338,108971,145793,2575,122185,166071,763,60457,73253
1588,3945,80434,100586,2695,104982,118802,1250,42097,59477
1585,1923,63295,83041,1161,88935,103825,762,25500,39197
1583,2614,91696,113576,1671,121801,137879,943,51331,65476
1581,6950,119148,153175,4943,156025,183453,2007,61131,74669
1571,4103,69659,86186,2725,103705,110167,1378,27313,34344
1570,6987,59844,77935,4496,80801,90523,2491,32103,51152
1569,5360,109179,117475,4000,123576,129382,1360,67763,72887
1568,2753,126442,160548,2316,137037,170997,437,71250,99867
1566,2350,105294,116706,1820,109567,128472,530,42112,71734
1564,3143,122810,142987,2363,129675,158942,780,87232,91633
1562,5114,70265,83176,3105,97860,106952,2009,32414,44533
1561,31,0,0,31,0,0,0,0,0
1560,1816,86146,122130,1131,122246,142416,685,54275,87106
1550,6760,52900,68960,4174,63910,79933,2586,32149,45731
1545,13753,108870,136486,10042,131993,157547,3711,54794,77719
1543,2879,124890,128114,2248,133588,141459,631,59340,77277
1542,968,88750,104738,722,110300,119693,246,39042,57301
1541,1267,129097,161710,978,128472,176061,289,89844,101087
1540,4074,85813,98918,2810,120504,118888,1264,32923,49063
1537,954,76859,81346,474,96714,105969,480,51048,56500
1536,2759,102756,112284,1703,121947,144138,1056,45217,59937
1535,1874,73208,93265,1234,85300,110312,640,54500,58128
1534,2347,100819,112009,1747,118533,123509,600,48971,73286
1532,5444,140600,194671,4257,157078,211801,1187,65135,130892
1531,449,90489,99116,338,102500,108882,111,61477,66350
1529,1305,79647,99264,857,94250,114691,448,44408,62321
1527,5147,92556,111725,3663,112409,127221,1484,36083,66624
1525,123,52750,50119,70,0,39871,53,0,0
1524,2363,80649,99396,1600,98558,115990,763,41066,57922
1523,2633,97394,111532,1727,109981,128942,906,70455,77917
1522,1183,104040,107824,806,108365,119972,377,77656,81170
1521,1041,77054,99502,661,91151,122451,380,54615,55386
1520,5893,116107,136199,4339,136559,157548,1554,57623,70329
1519,2605,114226,141840,2000,144630,160862,605,52425,71600
1518,1376,72713,102116,1008,93571,114272,368,33500,53191
1516,3174,117250,121923,2351,127297,132343,823,52455,85537
1515,843,75347,84484,615,80223,88792,228,59375,63607
1510,5864,75455,87954,3360,92295,103338,2504,58883,64965
1507,4861,102531,113344,3672,112206,124406,1189,59712,73023
1506,1368,70610,91487,791,110066,117556,577,43750,51614
1505,1818,106100,138007,1368,124213,157028,450,49500,64623
1504,3767,90665,101684,2437,116156,124443,1330,38633,54988
1503,1291,104432,132710,913,113795,150642,378,51333,83571
1501,6618,83265,102445,4271,105391,123562,2347,42297,59043
1475,3942,81582,90789,2960,101087,104096,982,32500,45496
1474,658,94554,111455,417,143309,132924,241,72396,66965
1473,3067,98555,118072,2227,116587,126392,840,64779,84474
1469,2913,97730,112004,2242,106762,127620,671,51188,53961
1468,1591,82173,113042,1118,103542,135787,473,51615,58132
1467,147,0,192459,104,238571,264190,43,0,0
1464,2578,89247,108424,1730,112974,123561,848,48068,76392
1463,4571,105377,124418,3313,121172,142808,1258,51056,71626
1462,4342,99601,114751,3286,109637,129160,1056,55644,66103
1460,3501,125275,153195,2846,140486,168975,655,53324,76298
1453,17019,63263,85959,10432,86432,103412,6587,42543,54858
1452,1761,100255,108850,1383,109432,118973,378,51019,60305
1451,1486,177422,216743,1258,194032,209266,228,84792,247449
1450,3944,142500,170635,2943,177118,200839,1001,47250,73518
1440,8535,51708,66012,5360,62108,76087,3175,33912,43644
1438,211,100579,99500,157,101829,108132,54,0,0
1436,1207,70662,108172,827,98365,93770,380,39167,134701
1434,286,96500,127034,222,99141,125109,64,52286,111873
1432,3424,99195,115112,2000,135982,147147,1424,56905,65944
1431,1261,97269,116121,916,103370,118716,345,64728,101812
1430,2103,113045,126785,1843,120478,130600,260,77000,73593
1420,15555,54683,70601,9354,62929,79972,6201,43024,52256
1379,379,62813,69958,238,77000,87609,141,28750,39454
1378,315,68839,82315,204,86875,101636,111,35536,43968
1376,2285,41369,57421,1100,68776,73634,1185,25610,40246
1375,1606,54524,70160,735,92917,100189,871,36976,44821
1373,2186,82105,108425,1382,95735,129836,804,58171,68161
1370,1754,61711,77878,915,87386,102410,839,37284,48430
1368,539,86607,93190,397,102112,99951,142,43654,66208
1367,205,69375,79389,135,74750,91509,70,0,53796
1366,472,71818,92669,300,91429,106885,172,46250,65888
1364,3036,53949,67412,1888,75000,82600,1148,29118,40977
1360,1278,75900,97112,929,95491,106863,349,36705,52755
1355,412,69038,89803,325,69725,94129,87,57750,71170
1354,591,68173,86054,400,81731,101396,191,36375,47954
1351,1057,97054,91599,571,98285,105000,486,67647,68749
1350,48,0,68856,23,0,82635,25,30938,56180
1349,461,75417,76806,321,70125,80891,140,72500,61601
1347,76,0,55637,11,0,0,65,0,53768
1346,248,93400,98329,129,81964,115484,119,93125,74461
1344,550,63333,73423,327,88550,86452,223,30486,46439
1343,33,73125,77530,19,97083,97011,14,0,51093
1342,408,103000,101957,305,111114,114871,103,0,40588
1341,776,92500,128037,506,121250,156084,270,53472,69760
1340,740,60313,76761,515,70804,80298,225,49271,59932
1339,601,60438,87386,399,64531,95434,202,39111,64195
1338,50,64667,74606,50,62833,53644,0,0,0
1337,1030,69853,85443,705,78125,95190,325,36550,60721
1331,5269,61949,74967,3469,72901,86252,1800,28204,44729
1330,752,72609,97224,442,95078,121529,310,47059,60561
1301,8248,46931,64478,4140,66077,85348,4108,31471,40842
1270,368,86912,125339,259,100625,135614,109,43750,97950
1267,2411,91917,110092,1394,134219,146668,1017,45365,58988
1266,550,77500,124451,408,91875,147910,142,28750,55354
1264,82,68750,117595,51,79688,162898,31,24250,43061
1262,450,39286,84865,222,67155,137643,228,26875,33476
1260,87,107614,87022,49,121771,120278,38,0,44142
1259,287,78625,106691,184,110833,117155,103,55417,86879
1258,211,74375,118982,150,102500,144703,61,47639,55734
1257,944,64375,108997,500,106000,129041,444,48214,85209
1256,316,47200,67822,214,51875,72818,102,31667,52963
1255,316,77000,101922,219,81042,111282,97,58250,76256
1254,427,96563,164330,312,117500,196514,115,38021,75881
1253,408,88487,104090,231,99896,128690,177,62708,70549
1247,6521,52398,68911,3666,69375,87386,2855,34233,41507
1245,382,109063,155186,249,180536,200800,133,44514,69789
1244,53,50104,54432,36,50000,64528,17,0,0
1243,133,62708,85896,91,79375,106359,42,28571,39869
1242,128,0,78696,111,0,81580,17,0,0
1240,2105,72802,105004,1143,99531,136723,962,38622,64156
1238,2329,77455,91807,1566,98561,106058,763,0,57045
1237,1078,76579,81558,734,81786,95494,344,39625,46238
1236,562,63696,101238,417,69567,121504,145,0,40509
1235,1037,67404,79351,697,79934,89066,340,42583,52557
1230,3500,68690,86109,2010,86132,106312,1490,38624,57126
1229,28,0,97050,21,0,125071,7,0,0
1226,3127,73911,94943,1915,91287,115020,1212,48467,62826
1225,1534,72119,80222,944,89259,94649,590,45000,57138
1224,73,0,154249,60,0,178992,13,0,0
1223,1155,66161,86742,716,84000,111769,439,0,41775
1222,301,58668,66191,204,59620,69738,97,39276,58731
1220,3999,47908,66356,2080,70519,89508,1919,28506,39854
1201,19745,57160,75814,10866,75853,97573,8879,33050,46962
1199,0,0,0,0,0,0,0,0,0
1151,3589,44291,56018,2475,44379,54672,1114,31940,47276
1129,2541,61769,77437,1666,81625,91665,875,39671,46897
1128,1085,67422,78300,753,87650,95228,332,31250,37689
1119,4967,48324,63650,3205,57864,72406,1762,42384,45280
1118,5613,70296,87719,4032,78362,94941,1581,46535,60724
1109,9220,35000,50867,5938,42686,58090,3282,16171,30711
1108,10031,41807,58630,5927,53555,69056,4104,31571,38519
1107,4043,30457,48460,2603,40625,57689,1440,11663,28671
1106,5894,123644,164319,4298,150586,193519,1596,50417,83217
1105,5135,21875,34669,2524,26737,44091,2611,16737,23783
1104,9022,40884,55397,5795,49577,66258,3227,22148,31656
1103,1385,17736,37294,296,31500,57700,1089,14641,31747
1098,573,81875,95399,344,90000,116712,229,50774,59417
1097,32,63750,55669,22,58611,49818,10,0,0
1096,1008,81447,100999,672,100000,112776,336,39063,70404
1095,5296,111487,138040,3953,128110,160611,1343,38359,62559
1094,184,0,52928,115,45069,62843,69,17135,34506
1093,129,97083,168735,85,115313,122164,44,62045,254016
1092,499,60396,86278,262,82917,93052,237,56330,68608
1089,12402,54516,79946,6798,74077,99010,5604,37002,53875
1088,307,42111,56587,143,0,69760,164,57685,44038
1086,0,0,0,0,0,0,0,0,0
1085,15414,74784,93893,10492,92639,109974,4922,43243,55023
1084,71,71875,79780,49,76250,86392,22,0,52145
1083,1050,78252,81302,709,84792,103729,341,23004,34672
1082,4446,58131,67267,2939,69985,76425,1507,38931,44877
1081,765,74375,90610,527,84464,103836,238,49038,53552
1080,843,78576,80452,610,79375,87944,233,47292,53884
1079,232,32963,64587,123,33073,68926,109,0,53036
1077,3869,84896,103111,2792,106852,121242,1077,38706,47284
1075,6993,73601,102535,4170,94236,106433,2823,52313,92075
1074,94,88775,77505,94,56275,55206,0,0,0
1073,2336,104052,122549,1817,121354,143844,519,31815,43960
1072,640,81042,93856,446,91154,104899,194,50313,57284
1071,565,81058,86670,422,91719,95087,143,49583,51411
1070,284,63750,88193,180,73333,86394,104,47500,87088
1069,3578,66920,83700,2158,92265,102667,1420,45270,51204
1068,620,85326,103528,500,87250,110696,120,49000,63717
1066,30,0,0,0,0,0,30,0,0
1063,0,0,0,0,0,0,0,0,0
1062,4082,76959,99412,2547,100175,124879,1535,32396,49772
1060,6682,67356,97371,3265,111902,130743,3417,44977,63103
1057,3603,77156,103164,2494,100362,107369,1109,43015,90339
1056,8310,73516,88252,5916,88480,103331,2394,37245,47523
1054,727,93942,131694,511,100568,138422,216,56500,108692
1053,588,50357,71639,358,52500,79403,230,39265,59445
1050,1025,73839,85088,684,87339,94118,341,46438,59801
1040,15464,42537,61102,9288,51704,71911,6176,31047,41558
1039,599,94256,109940,376,94524,125077,223,60521,68741
1038,1082,85449,101782,727,97813,114080,355,48194,63258
1037,193,83036,107438,129,107279,130689,64,56250,60573
1036,2025,94393,108024,1484,104896,118086,541,50313,70085
1035,2256,86690,132380,1430,112656,164390,826,51541,72487
1034,850,90625,101860,595,106250,114263,255,52171,71898
1033,2584,101886,112557,1937,116602,127563,647,39519,59267
1032,212,81875,84213,125,106250,105986,87,34659,49424
1031,560,45549,69562,372,88194,85335,188,28750,33007
1030,4797,79713,101772,3386,98427,120902,1411,48615,52077
1029,239,92361,98721,133,92875,113032,106,75500,74585
1028,5762,90579,115578,4102,112600,140453,1660,38068,48606
1027,8180,66339,77572,4757,83964,94193,3423,41392,50223
1026,442,71000,77669,236,100556,94000,206,55833,52863
1022,1094,43525,54155,373,55819,62246,721,38171,47166
1020,13109,58909,71422,8315,67092,82134,4794,34136,46702
1013,9246,46007,60179,5362,57302,70690,3884,27855,40542
1012,269,73750,82000,156,85833,98428,113,38750,53968
1011,511,71921,78677,368,71802,84159,143,55750,57098
1010,1494,75577,104869,1032,108750,128144,462,29444,47600
1009,253,72644,66627,123,0,42470,130,84688,89484
1008,453,78988,96822,311,97083,107341,142,72813,66012
1007,5667,94812,110535,4138,110360,122864,1529,51458,72756
1005,1883,80060,101548,1363,108457,119482,520,49026,48899
1003,23,0,0,4,0,0,19,0,0
1002,10182,60540,102003,5073,114866,147615,5109,30441,54796
1001,6871,66088,84237,3974,89728,102845,2897,37294,52311
987,20296,32596,44334,14209,37524,49393,6087,17807,27425
985,12167,27560,34597,8443,33155,38979,3724,15338,20665
983,13143,26385,35453,9023,30059,39165,4120,18480,23757
982,5809,25360,31684,3510,29626,35649,2299,17352,23509
979,8662,33087,55735,3991,44240,67806,4671,26407,43665
976,21565,31729,43023,15370,38367,49048,6195,15788,23434
971,8828,24972,39022,5666,30963,45187,3162,13827,25085
969,14606,47489,78554,10095,57023,90402,4511,26678,48655
968,1820,49500,78673,758,84310,125052,1062,27091,45570
966,5924,48174,74180,3577,63237,93625,2347,26391,42563
965,2694,14279,20869,1588,18543,24800,1106,8218,11365
962,6800,16053,25837,4647,19947,29573,2153,9540,15051
961,11079,29811,43246,7016,37544,51069,4063,18394,27367
960,0,0,0,0,0,0,0,0,0
959,17919,30307,41742,11759,36186,45610,6160,18292,28337
957,14578,27115,34828,10752,31303,38133,3826,15045,23488
956,24307,23859,32795,16467,28844,37463,7840,15263,20368
953,22037,27688,40410,16680,32748,45157,5357,12783,22146
952,2832,16196,20962,1721,17934,21558,1111,10668,15074
951,0,0,0,0,0,0,0,0,0
950,0,0,0,0,0,0,0,0,0
949,26044,27575,36809,17814,31863,40561,8230,16699,23944
936,0,0,0,0,0,0,0,0,0
934,29,0,0,29,0,0,0,0,0
927,6043,36994,60360,3604,56000,79348,2439,22973,31438
926,36288,35681,58379,23773,44369,67759,12515,20962,37639
925,3412,10928,22249,843,22589,36280,2569,9257,17374
924,19540,19023,30749,12008,21691,35419,7532,13347,20580
923,10259,16052,28446,6079,20656,34315,4180,10787,18649
921,13656,19158,29559,7657,24295,33363,5999,14586,22803
920,6947,26153,36424,4053,33631,43906,2894,17260,23943
918,7885,29521,47191,3296,48596,62561,4589,22585,35695
917,8391,15904,29935,4039,22444,40710,4352,11250,18677
915,10772,13125,21809,5910,15527,24606,4862,9901,16728
913,3186,7428,26857,1779,5313,21986,1407,8183,31171
912,2734,27623,42459,1368,31571,48588,1366,20769,35573
911,3757,32290,61116,1703,50625,82092,2054,16900,40831
909,2353,21238,34848,1091,32102,39949,1262,14795,27175
907,8504,38798,77774,3641,55464,111557,4863,31082,50905
906,102,109063,109598,32,0,0,70,156563,131321
901,3047,26204,72799,1495,42047,95829,1552,17304,49940
795,14933,20765,28956,10825,24050,32193,4108,11514,17296
794,8863,19024,25893,6657,21658,28303,2206,11961,13916
791,16480,21833,34863,11147,26828,42625,5333,12210,15578
786,81,38798,47319,81,38798,47319,0,0,0
784,13902,17317,25784,9114,21572,30676,4788,11961,15263
783,10624,16815,24155,7957,19771,26888,2667,9384,13437
782,4906,14152,19555,3291,18466,22803,1615,7952,11200
780,4030,21724,33272,2870,23058,36328,1160,10571,18681
778,14645,35558,53131,10725,40122,57817,3920,14539,36187
777,13313,20718,28971,9625,23158,31231,3688,13625,19913
775,502,24886,34638,266,33587,42215,236,14375,17248
773,6660,21805,28851,4536,25297,31707,2124,15595,20060
772,6633,14963,21195,4536,17942,23702,2097,9384,13460
771,11904,22097,32134,8863,26551,35732,3041,9951,18777
769,13130,18326,27121,8703,23610,31874,4427,11157,14791
767,11687,16828,24365,7739,22240,28939,3948,10434,13975
766,8100,19170,30980,5937,22056,35231,2163,11215,14541
765,2376,14049,20098,1340,17994,23282,1036,11455,14419
757,7368,20000,28288,4761,22953,32072,2607,12034,19316
754,13580,19408,28025,9292,23884,32554,4288,10669,15206
751,7751,17963,24593,5082,21167,27886,2669,10949,15633
745,15782,23975,32650,11353,28428,36249,4429,12458,18814
741,1336,21506,27545,919,27266,30168,417,11443,16014
740,740,9611,15555,491,12688,16681,249,8625,11668
739,11870,20597,29800,8541,24200,33038,3329,13134,18343
738,11672,20808,31235,7787,23880,35517,3885,13006,19914
736,17321,22904,33055,11967,27508,38454,5354,11557,17287
735,4326,19097,30262,2865,22044,32617,1461,13744,23309
731,4265,15781,26040,3090,20174,30260,1175,9375,13056
730,11748,16036,26302,7275,21036,30549,4473,10295,18069
729,16608,22075,35383,11981,26995,40232,4627,12301,17276
728,13430,20131,29230,9848,22399,32091,3582,13477,18630
727,19338,30570,45301,13150,36831,51969,6188,18250,27458
725,30383,22847,35333,20376,28050,39172,10007,14052,24680
723,6120,17197,24468,4048,21275,28718,2072,9831,14161
720,6789,16072,22855,4900,18250,24940,1889,8609,13791
719,8615,18804,28034,6308,22684,32034,2307,9807,15547
718,8211,19220,24831,5639,21135,26246,2572,13996,18920
717,6760,11838,23438,3751,17362,30284,3009,9051,14149
716,11180,17616,33434,7063,21278,34857,4117,11739,30226
715,979,13288,20861,601,16332,26615,378,9849,11714
714,6057,16263,22599,4086,18347,25088,1971,11204,15353
707,3874,20419,25083,2757,24182,28342,1117,15208,16396
705,8750,20271,29484,6122,23497,33397,2628,12111,16874
704,2476,16734,23770,1711,22230,27500,765,10018,12883
703,8597,20188,30057,6330,22685,33950,2267,12097,15452
698,11593,14811,22468,7340,21026,26745,4253,9468,14481
694,16,0,0,16,0,0,0,0,0
693,19633,19970,28541,13551,24392,31956,6082,11820,17439
692,11580,21194,37215,8677,23081,40422,2903,12255,21383
690,2343,17246,28101,1732,17049,28141,611,14405,23433
688,4112,17305,23878,3072,20048,26577,1040,8702,11214
687,9691,21191,28626,7651,22593,30113,2040,10906,13473
685,13881,15861,25278,10139,20149,28712,3742,7286,14085
683,10877,16441,24301,6617,22267,30094,4260,9833,14266
682,11640,14841,31588,6857,21289,40440,4783,9655,17112
680,18449,14825,24223,10860,21681,31513,7589,8316,13158
678,8911,17204,23105,6107,22258,26667,2804,10693,14248
677,5467,20027,30685,3367,28771,35479,2100,10735,20467
676,13523,16014,28119,9756,19448,32203,3767,9881,15456
674,14885,18790,28889,10392,23835,33662,4493,10662,15298
670,2696,14712,20820,1894,22537,24198,802,7473,12594
669,9701,17199,22837,7366,19350,25180,2335,8622,13400
667,8046,14472,21527,5311,16730,22662,2735,11785,15903
664,5064,15740,20365,3900,18370,23116,1164,4783,8360
662,14313,17216,24775,9985,20357,27061,4328,11538,17168
660,6291,19848,29376,4117,24268,34833,2174,12855,18469
659,13914,18998,29974,10255,24405,34454,3659,11393,15659
656,6521,17865,23440,4704,21235,25951,1817,11315,13996
653,3644,10977,16403,2097,13689,19857,1547,7770,10824
652,1401,22771,28656,970,23575,30255,431,14563,18989
650,5092,19368,24709,3781,21243,26967,1311,11915,16414
647,1979,13996,17855,1219,18684,20665,760,10953,12171
646,11860,29757,48929,8458,38238,57829,3402,14805,24853
641,9459,15402,21265,6479,19732,25412,2980,8440,11017
638,5850,17634,25546,4421,20391,27533,1429,10526,15085
637,7032,18430,26717,4754,22161,29980,2278,10920,17880
631,608,11476,19104,370,13300,20843,238,8421,15810
627,11349,18571,27845,8228,22142,31718,3121,9724,16304
624,7312,17161,26146,5417,20024,29178,1895,10915,14873
623,13929,17699,26984,9421,20894,29134,4508,11710,20505
622,2282,15640,23051,1533,17861,26538,749,9524,15043
617,8097,17702,25243,5647,19719,26742,2450,11174,16857
616,3478,18903,26647,2441,21587,31042,1037,10199,12401
612,23327,19402,27574,15576,24863,32685,7751,9868,14869
610,8864,20167,27865,6305,23968,32154,2559,11448,13972
606,1983,14980,18534,1351,16176,20062,632,12000,13292
603,19431,15786,27451,13168,19340,31402,6263,9663,17658
602,12901,16771,26150,9194,21060,29986,3707,10612,15425
601,5555,14398,19353,3912,15721,21705,1643,8336,11577
